date,source,sentence,topic,people (keyword count in url),crops (keyword count in url),homes (keyword count in url),money (keyword count in url),importance (keyword count in url),location
9/14/19,https://www.tribuneindia.com/news/punjab/jalandhar-kapurthala-losses-pegged-at-rs-526-cr/832145.html,"ush({ });  in kapurthala, crop losses have been pegged at rs 160 crore which includes rs 60 crore for bandh repairs and rs 85 lakh for damaged roads and houses, including 1,618 cattle deaths",death,2,58,49,4,113,"jalandhar, kapurthala"
9/12/19,https://www.tribuneindia.com/news/punjab/punjab-govt-centre-team-meet-to-discuss-flood-damage-in-11-districts/831226.html,"initial assessment  6¬†persons died¬† 1,400¬†injured 2,400¬†evacuated 1,530¬†families¬†provided relief rs 506-crore¬†paddy crop damaged ",death,15,25,41,0,81,"amritsar, ferozepur, gurdaspur, jalandhar, kapurthala, ludhiana, moga, pathankot, sbs nagar, tarn taran"
9/3/19,https://www.tribuneindia.com/news/punjab/rs-4-lakh-for-kin-of-victims/826745.html,"our correspondent fazilka, september 2  family members of two persons, including a woman who had died during recent floods in fazilka district, have been compensated by the district administration",death,10,22,20,2,54,fazilka
9/2/19,https://www.tribuneindia.com/news/punjab/power-restored-to-108-villages/826302.html," as many as 25,000 personnel from different departments have been given deadlines to complete the relief, rehabilitation and restoration tasks",death,4,5,17,0,26,jalandhar
8/27/19,https://www.tribuneindia.com/news/punjab/distress-calls-turn-pcr-into-flood-helpline/823214.html,"in his desperate call to the pcr at 6.57 pm on august 23, he said death was lurking around",death,4,8,14,0,26,"jalandhar, kapurthala, ludhiana, sas nagar"
8/26/19,https://www.tribuneindia.com/news/punjab/jitters-post-review/822848.html,time is fast running out for the october 31 deadline and so is minister‚Äôs patience,death,10,5,6,0,21,"amritsar, fazilka, ferozepur, jalandhar, patiala, sas nagar"
8/26/19,https://www.tribuneindia.com/news/punjab/punjab-seeks-rs-1-000-cr-special-aid-from-centre/822847.html,"a person was feared drowned in the sutlej in fazilka while death of 176 cattle heads and damage to 161 houses had been reported from ropar, said officials",death,11,11,42,0,64,"fazilka, ferozepur, jalandhar, kapurthala, ludhiana, patiala, sas nagar, sbs nagar"
8/26/19,https://www.tribuneindia.com/news/punjab/crops-on-6-000-acres-damaged-in-fazilka/822777.html,"ush({ });  appealing to the residents to stay away from gushing floodwaters, he said the administration had recommended compensation for 17-year-old jagjit singh who drowned two days ago in dhandi kadim village",death,5,31,23,1,60,"fazilka, ferozepur, sas nagar"
8/25/19,https://www.tribuneindia.com/news/punjab/100-crop-damage-in-jalandhar-kapurthala-districts-say-farmers/822274.html,"in phillaur, crops died in a day while lohian has been submerged for six days",death,6,106,53,2,167,"jalandhar, kapurthala"
8/24/19,https://www.tribuneindia.com/news/punjab/18-year-old-drowns-in-fazilka-dist-search-begins/821759.html,"18-year-old drowns in fazilka dist, search begins",death,5,4,5,0,14,"bathinda, fazilka"
8/24/19,https://www.tribuneindia.com/news/punjab/18-year-old-drowns-in-fazilka-dist-search-begins/821759.html,"our correspondent fazilka, august 23  an 18-year-old youth allegedly drowned in flood water near dhandi kadim village of jalalabad subdivision in fazilka district on friday afternoon",death,5,4,5,0,14,"bathinda, fazilka"
8/24/19,https://www.tribuneindia.com/news/punjab/18-year-old-drowns-in-fazilka-dist-search-begins/821759.html," the deceased, identified as jagjit singh of dhandi kadim village of jalalabad subdivision in fazilka district, had gone to the fields and drowned in the gushing flood water in the creek of the swollen sutlej around 12.30 pm",death,5,4,5,0,14,"bathinda, fazilka"
8/23/19,https://www.tribuneindia.com/news/punjab/cemeteries-flooded-villagers-cremate-body-along-highway/821302.html,"deepkamal kaur tribune news service gidderpindi, august 22  such has become the plight of flood-hit villages that they are being forced to cremate the dead along a highway as all cemeteries in villages have been inundated",death,15,3,12,0,30,punjab
8/21/19,https://www.tribuneindia.com/news/punjab/flooded-ropar-villages-left-high-and-dry/820215.html," rs 4-lakh ex gratia for toddler‚Äôs kin  the district administration has announced a relief of rs 4 lakh for the parents of a three-year-old girl, sundari, who got drowned in flood water at nurpur bedi",death,9,6,32,0,47,punjab
8/19/19,https://www.tribuneindia.com/news/punjab/capt-amarinder-earmarks-rs-100-cr-for-flood-relief/819785.html,"  captain amarinder also expressed grief over the death of three people due to roof collapse in ludhiana district, the statement said",death,7,5,13,0,25,"ludhiana, sas nagar"
8/19/19,https://www.tribuneindia.com/news/punjab/capt-amarinder-earmarks-rs-100-cr-for-flood-relief/819785.html,"heavy rain and resultant floods have killed some 30 people in the states of¬†punjab, haryana, himachal pradesh and uttarakhand¬†over the past few days",death,7,5,13,0,25,"ludhiana, sas nagar"
8/18/19,https://www.tribuneindia.com/news/punjab/imd-says-rain-will-weaken-in-24-hours/819318.html," incessant rain and strong winds in himachal pradesh caused flood and landslides, killing at least nine people and leading to damage to infrastructure and property over the last two days",death,4,5,5,0,14,punjab
8/18/19,https://www.tribuneindia.com/news/punjab/imd-says-rain-will-weaken-in-24-hours/819318.html,reports said some 38 people have been killed in rain related incidents in uttarakhand,death,4,5,5,0,14,punjab
8/19/19,https://www.tribuneindia.com/news/punjab/flood-threat-rises-in-punjab-haryana-authorities-go-into-huddle/819286.html,"surjit singh (35), his wife baljinder kaur (32) and their son gurpreet singh (9) were killed in the incident on saturday",death,19,8,21,1,49,"fatehgarh sahib, gurdaspur, ludhiana, pathankot, patiala, sas nagar, sbs nagar"
8/17/19,https://www.tribuneindia.com/news/punjab/torrential-rain-lashes-northern-states-alert-sounded-in-punjab/818855.html,"ndrf personnel retrieved the body of a girl who drowned in krishna district, taking the death toll to two in the state",death,17,13,16,0,46,"amritsar, ludhiana, sas nagar"
8/17/19,https://www.tribuneindia.com/news/punjab/torrential-rain-lashes-northern-states-alert-sounded-in-punjab/818855.html," heavy rains also disrupted normal life in jammu, where a 47-year-old man was feared drowned while 15 people were rescued following flash floods in kathua and samba districts",death,17,13,16,0,46,"amritsar, ludhiana, sas nagar"
7/15/19,https://www.tribuneindia.com/news/punjab/visa-free-travel-for-5-000-pilgrims-daily/802215.html,will meet deadlines: mha  october 31:  rs 500-cr passenger terminal complex at dera baba nanak to be completed september 30: four-lane road from gurdaspur-amritsar highway to zero point to be ready november: 550th birth anniversary of guru nanak dev is by when the govt wants infra to be in place ,death,4,0,3,1,8,"amritsar, gurdaspur, sas nagar"
7/5/19,https://www.tribuneindia.com/news/punjab/pak-firm-on-causeway-likely-to-push-deadline/797199.html,"ravi dhaliwal  tribune news service  gurdaspur, july 4  the pakistan government‚Äôs insistence on constructing a causeway, instead of a bridge, on its side as a part of the kartarpur corridor project may indefinitely push back the october 31 deadline to complete the project",death,5,0,2,0,7,gurdaspur
6/23/19,https://www.tribuneindia.com/news/punjab/pak-corridor-road-is-not-all-weather/791587.html,"mukesh ranjan tribune news service new delhi, june 22  while work on the indian side of the much-awaited kartarpur corridor is likely to be completed ahead of the october 31 deadline, officials today indicated the pilgrimage on the pakistan side may see seasonal interruptions given the kind of infrastructure being raised there",death,2,0,3,1,6,gurdaspur
6/14/19,https://www.tribuneindia.com/news/punjab/kin-of-7-martyrs-get-jobs-on-compassionate-grounds/787429.html," while carrying out the sixth sortie, his helicopter crashed and he died",death,5,3,4,0,12,"gurdaspur, moga, pathankot, patiala, sangrur, tarn taran"
6/14/19,https://www.tribuneindia.com/news/punjab/kin-of-7-martyrs-get-jobs-on-compassionate-grounds/787429.html, the remaining six died in the line of duty while deployed in jammu and kashmir,death,5,3,4,0,12,"gurdaspur, moga, pathankot, patiala, sangrur, tarn taran"
6/14/19,https://www.tribuneindia.com/news/punjab/kin-of-7-martyrs-get-jobs-on-compassionate-grounds/787429.html,"he was killed during an operation in j&k‚Äôs kupwara district in september 2018, in which five terrorists were eliminated",death,5,3,4,0,12,"gurdaspur, moga, pathankot, patiala, sangrur, tarn taran"
6/13/19,https://www.tribuneindia.com/news/punjab/punjab-govt-to-give-jobs-to-relatives-of-7-armed-forces-personnel-killed-in-line-of-duty/787411.html,punjab govt to give jobs to relatives of 7 armed forces personnel killed in line of duty,death,13,4,2,0,19,"gurdaspur, moga, pathankot, sangrur"
6/13/19,https://www.tribuneindia.com/news/punjab/punjab-govt-to-give-jobs-to-relatives-of-7-armed-forces-personnel-killed-in-line-of-duty/787411.html,"chandigarh, june 13  the punjab government has decided to give jobs to the dependents of seven armed forces personnel killed in the line of duty, a spokesperson said on thursday",death,13,4,2,0,19,"gurdaspur, moga, pathankot, sangrur"
2/26/19,https://www.tribuneindia.com/news/punjab/refund-rs-37-crore-to-contractors-hc-tells-state/734685.html,justice mahesh grover and justice lalit batra set four-week deadline for the purpose,death,1,1,1,0,3,jalandhar
11/16/18,https://www.tribuneindia.com/news/punjab/two-hc-judges-to-be-sworn-in-today/683811.html, tns motorcyclist diesin road accidentmuktsar: a 40-year-old man died an accident on the jalalabad road here,death,5,2,3,1,11,"sangrur, sri muktsar sahib"
4/16/18,https://www.tribuneindia.com/news/punjab/sewa-joins-admn-to-improve-sanitation/574487.html,ush({ });it is pertinent to mention here that 42 people (22 officially) died in gandhi camp area in 2012 after gastroenteritis broke out,death,7,0,1,0,8,gurdaspur
4/1/18,https://www.tribuneindia.com/news/punjab/three-killed-as-bike-hits-tree/566939.html,"abohar, march 31  three youths were killed when the motorcycle they were riding, while returning to their native pakki tibbi village, hit a roadside tree on the highway, about 8 km from abohar, on friday night",death,7,6,5,0,18,faridkot
4/1/18,https://www.tribuneindia.com/news/punjab/three-killed-as-bike-hits-tree/566939.html,"biker dies in mishap  a farmer, nirmal singh (60) of jhurarkhera village, died and his son amarjit singh (35) was grievously injured as their motorcycle collided with an oil tanker on the city bypass here on saturday afternoon",death,7,6,5,0,18,faridkot
3/15/18,https://www.tribuneindia.com/news/punjab/more-fury-than-fire-image-takes-a-hit/557888.html,"‚Äî capt amarinder singh, handles transport dept  policing all is well, till it goes wrong what‚Äôs done  police busted a gang of alleged khalistan sympathisers¬†suspected to have carried¬†out targeted killings in¬†recent years",death,30,76,15,11,132,"amritsar, bathinda, jalandhar, ludhiana, moga, pathankot, patiala, sas nagar, sbs nagar, tarn taran"
3/2/18,https://www.tribuneindia.com/news/punjab/pulanwala-baba-gifts-another-bridge/552088.html," sarpanch davinder singh, recalling the miseries of villagers, said seven years ago a local girl had died when she could not be taken to hospital in time due to flood in the river",death,17,1,16,1,35,punjab
11/8/17,https://www.tribuneindia.com/news/punjab/govt-all-fogged-up-on-road-safety-measures/494182.html,"in these accidents, 578 persons were killed and more than 600 injured every year",death,4,1,1,0,6,punjab
8/7/17,https://www.tribuneindia.com/news/punjab/how-centre-state-failed-farmers-on-insurance/448344.html,"officially, nearly 20 per cent of the cropped area was damaged in floods that year as compared to 13 per cent and 10 per cent in 2009 (15 dead) and 1988 (200 dead), respectively",death,5,121,20,12,158,"kapurthala, ludhiana"
8/7/17,https://www.tribuneindia.com/news/punjab/how-centre-state-failed-farmers-on-insurance/448344.html,"would the company only settle claims if 40 people died or 40 vehicles were involved in a pile-up? needless to say, that was the end of it, he added",death,5,121,20,12,158,"kapurthala, ludhiana"
7/14/17,https://www.tribuneindia.com/news/punjab/two-gurdaspur-girls-drown-while-attempting-to-click-selfie/436583.html,"ravi dhaliwal       tribune news service gurdaspur, july 14 two young girls from gurdaspur drowned while allegedly attempting to click a selfie from the edge of a bridge on friday morning",death,9,0,3,0,12,gurdaspur
6/28/17,https://www.tribuneindia.com/news/punjab/complaints-flood-panel-probing-excesses-during-akali-bjp-rule/428654.html,"‚Äúwe have decided to accept complaints even after june 30, the deadline for filing complaints,‚Äù said an official",death,3,0,1,0,4,sas nagar
8/25/15,https://www.tribuneindia.com/news/crime/boy-s-death-four-booked/124069.html,boy‚Äôs death: four booked,death,11,4,4,0,19,"amritsar, sas nagar, tarn taran"
8/25/15,https://www.tribuneindia.com/news/crime/boy-s-death-four-booked/124069.html,"abohar 2 killed in mishap  hoshiari lal (21) and sunny (20) died as a truck reportedly hit their motorcycle on sunday, near talwara jheel, in hanumangarh",death,11,4,4,0,19,"amritsar, sas nagar, tarn taran"
6/6/15,https://www.tribuneindia.com/news/community/thick-security-blanket-for-amritsar/90237.html,"   meanwhile, the dal khalsa reiterated its demand for an international probe into the killings of hundreds of sikh pilgrims and loot of manuscripts from sikh reference library during the army operation",death,10,1,6,0,17,"amritsar, barnala, bathinda, faridkot, fazilka, ferozepur, ludhiana, mansa, moga, patiala, sangrur, sri muktsar sahib"
4/15/15,https://www.tribuneindia.com/news/community/june-30-deadline-to-clean-drains-in-areas-prone-to-waterlogging/67499.html,june 30 deadline to clean drains in areas prone to waterlogging,death,3,0,1,0,4,"fazilka, sri muktsar sahib"
4/15/15,https://www.tribuneindia.com/news/community/june-30-deadline-to-clean-drains-in-areas-prone-to-waterlogging/67499.html,"archit watts tribune news service muktsar, april 14 the state irrigation department has set june 30 deadline to clear drains and undertake other anti-flood measures in various districts of the malwa belt, particularly muktsar and fazilka, that are prone to waterlogging during monsoon",death,3,0,1,0,4,"fazilka, sri muktsar sahib"
3/18/15,https://www.tribuneindia.com/news/punjab/punjab-budget-speech-text/55244.html,youth skilling punjab youth 18,death,0,0,0,0,0,punjab
3/18/15,https://www.tribuneindia.com/news/punjab/punjab-budget-speech-text/55244.html," keeping this in view and also the fact that with a significant presence 8 of msme sector, the state will be a crucial partner in the ‚Äòmake in india‚Äô campaign, the state has set up an empowered ‚Äòstate skill development mission‚Äô with three tiers at state, district and block level",death,0,0,0,0,0,punjab
3/18/15,https://www.tribuneindia.com/news/punjab/punjab-budget-speech-text/55244.html," under this mission 22 multi skill development centres, one in each district is proposed to be set up in a phased manner",death,0,0,0,0,0,punjab
3/18/15,https://www.tribuneindia.com/news/punjab/punjab-budget-speech-text/55244.html,"the¬†mission¬†is also in the process of setting up three skill development centres in the health sector at¬†medical¬†colleges,¬†amritsar,¬†patiala¬†and faridkot",death,0,0,0,0,0,punjab
3/18/15,https://www.tribuneindia.com/news/punjab/punjab-budget-speech-text/55244.html," under this¬†mission, i also propose to set up three specialised skill development centres in construction sector in partnership with renowned companies in the construction sector",death,0,0,0,0,0,punjab
3/18/15,https://www.tribuneindia.com/news/punjab/punjab-budget-speech-text/55244.html,"to provide skill training at their doorsteps, 2000 skill training centres for girls and 500 centres for boys will be opened in villages in the existing infrastructure of government schools and other buildings at village level when they are not in use",death,0,0,0,0,0,punjab
3/18/15,https://www.tribuneindia.com/news/punjab/punjab-budget-speech-text/55244.html,the infant mortality rate (imr) declined by 18 points from 44 in 2006 to 26 in 2013,death,0,0,0,0,0,punjab
3/18/15,https://www.tribuneindia.com/news/punjab/punjab-budget-speech-text/55244.html,the maternal mortality rate (mmr) declined from 192 in 2004-06 to 141 in 2011-13,death,0,0,0,0,0,punjab
3/18/15,https://www.tribuneindia.com/news/punjab/punjab-budget-speech-text/55244.html,skill development 100,death,0,0,0,0,0,punjab
3/18/15,https://www.tribuneindia.com/news/punjab/punjab-budget-speech-text/55244.html,"an amount of rs 267.92 crore has been earmarked for skill development of 1,21,000 youth under various schemes",death,0,0,0,0,0,punjab
3/3/15,https://www.tribuneindia.com/news/community/3-of-family-die-in-roof-collapse/48956.html,3 of family die in roof collapse,death,11,2,8,0,21,"patiala, sas nagar"
3/3/15,https://www.tribuneindia.com/news/community/3-of-family-die-in-roof-collapse/48956.html,"tribune news service  patiala, march 2 three members of a family, including two children, were killed in bharat nagar, patiala, when the roof of their house collapsed because of heavy rainfall last night",death,11,2,8,0,21,"patiala, sas nagar"
10/27/19,https://www.tribuneindia.com/news/punjab/dengue-scare-in-ludhiana-10-year-old-girl-dies/852773.html,"dengue scare in ludhiana, 10-year-old girl dies",death,18,0,2,0,20,ludhiana
10/27/19,https://www.tribuneindia.com/news/punjab/dengue-scare-in-ludhiana-10-year-old-girl-dies/852773.html,"tribune news service ludhiana, october 26  a 10-year-old girl died of dengue on friday night",death,18,0,2,0,20,ludhiana
10/27/19,https://www.tribuneindia.com/news/punjab/dengue-scare-in-ludhiana-10-year-old-girl-dies/852773.html,"besides, a four-year-old girl ananya of new durga colony had died on monday after she suffered from dengue shock syndrome as per the report of pgimer, chandigarh",death,18,0,2,0,20,ludhiana
10/27/19,https://www.tribuneindia.com/news/punjab/dengue-scare-in-ludhiana-10-year-old-girl-dies/852773.html, two children have died due to dengue in the last five days in new durga colony of dhandari khurd in ward 28 ludhiana,death,18,0,2,0,20,ludhiana
10/27/19,https://www.tribuneindia.com/news/punjab/dengue-scare-in-ludhiana-10-year-old-girl-dies/852773.html,"  rk yadav, president of yadav mahasabha punjab, said, ‚Äúapart from death of these two children, a few suspected dengue deaths have also been reported",death,18,0,2,0,20,ludhiana
8/26/19,https://www.tribuneindia.com/news/punjab/inflow-from-pak-still-on-army-ndrf-on-alert/822775.html,‚Äúalready six villagers have died while crossing the river on a ‚Äòbera‚Äô that got damaged,death,16,10,27,1,54,ferozepur
8/19/19,https://www.tribuneindia.com/news/punjab/rain-wreaks-havoc-4-die-in-roof-collapse/819437.html,"rain wreaks havoc, 4 die in roof collapse",death,18,3,16,3,40,"fatehgarh sahib, patiala, sbs nagar"
8/19/19,https://www.tribuneindia.com/news/punjab/rain-wreaks-havoc-4-die-in-roof-collapse/819437.html,"gurminder grewal  khanna, august 18  four persons were killed in two separate rain-related incidents in khanna",death,18,3,16,3,40,"fatehgarh sahib, patiala, sbs nagar"
8/19/19,https://www.tribuneindia.com/news/punjab/rain-wreaks-havoc-4-die-in-roof-collapse/819437.html," three members of a family, including a minor boy, died when the roof of their house collapsed in hole village near khanna",death,18,3,16,3,40,"fatehgarh sahib, patiala, sbs nagar"
8/19/19,https://www.tribuneindia.com/news/punjab/rain-wreaks-havoc-4-die-in-roof-collapse/819437.html," toddler washed away  ropar: a three-year-old daughter of a watchman, identified as sundri, was feared drowned when water flooded their house situated in a low-lying area of ropar district on sunday",death,18,3,16,3,40,"fatehgarh sahib, patiala, sbs nagar"
8/18/19,https://www.tribuneindia.com/news/punjab/budhki-sarsa-rivers-in-spate-admn-orders-evacuation-of-dozens-of-villages/819303.html,"meanwhile, a three-year-old son of a watchman at a private school feared drowned when the water flooded his house situated in the low-lying area of the building.",death,12,2,23,0,37,punjab
7/17/19,https://www.tribuneindia.com/news/punjab/from-deficit-to-10-surplus-rain-in-punjab/803143.html,"ush({ });  record rainfall drowns bathinda fields in moga flooded as sutlej swells school turns into pond, kids at risk gushing ghaggar floods patiala villages   the rainfall in punjab, which till a few days ago was deficient by almost 50 per cent, is now 10 per cent above the long-term average",death,1,3,4,0,8,"amritsar, bathinda, ferozepur, gurdaspur, hoshiarpur, jalandhar, moga, patiala, sas nagar"
7/17/19,https://www.tribuneindia.com/news/punjab/record-rainfall-drowns-bathinda/803032.html,"of nealy 80 cows inside the shelter, 37 died in the incident",death,5,4,7,1,17,bathinda
2/1/19,https://www.tribuneindia.com/news/punjab/amrita-s-works-reflect-partition-pangs-prof/721877.html,"it reignited memories of the great calcutta killings of 1946 and the sufferings of millions of refugees, who flooded the city in the aftermath of partition",death,6,1,1,0,8,patiala
9/25/18,https://www.tribuneindia.com/news/punjab/8-month-old-girl-drowns-in-jalandhar/658400.html,8-month-old girl drowns in jalandhar,death,6,3,0,0,9,jalandhar
9/25/18,https://www.tribuneindia.com/news/punjab/8-month-old-girl-drowns-in-jalandhar/658400.html,"jalandhar, september 24 a rajasthani woman‚Äôs eight-month-old daughter drowned after rainwater flooded their kiosk here on sunday night",death,6,3,0,0,9,jalandhar
12/7/17,https://www.tribuneindia.com/news/punjab/bills-pending-hc-asks-ag-if-state-in-deep-fiscal-crisis/509323.html, justice rajan gupta‚Äôs bench also set six-week deadline for advocate-general atul nanda to come out with his response on the issue after holding a meeting with the finance department officers,death,2,0,1,0,3,punjab
7/1/17,https://www.tribuneindia.com/news/punjab/heavy-rain-in-mansa-man-electrocuted/429959.html,"nikhila pant dhawan tribune news service mansa, june 30 a shopkeeper was electrocuted to death here today following a heavy rainfall",death,10,0,7,0,17,mansa
5/29/16,https://www.tribuneindia.com/news/crime/bhagat-singh-s-grandnephew-and-aap-activist-abhitej-killed-in-mishap/243788.html,"ush({ });  abhitej sandhu, grandnephew of shaheed bhagat singh and an aap activist, died after he sustained grave injuries in a motorcycle accident at maglad, near rampur in shimla district, about 135 km from here, late on saturday evening",death,13,4,3,0,20,"sas nagar, sbs nagar"
5/13/16,https://www.tribuneindia.com/news/community/six-booked-for-attacking-power-dept-staff/235983.html,"as per the police complaint, chamkaur singh alleged that his father jagdish singh killed his mother sukhpal kaur (38)",death,6,4,10,0,20,"sri muktsar sahib, tarn taran"
5/5/16,https://www.tribuneindia.com/news/community/heard-of-kidnapping-what-relief-in-the-end/232170.html,"ush({ });  read all about gangsters at work in punjab:  kidnapped patiala schoolgirl freed in 6 hours 4 incidents in a month have cops worried 70 active gangs, over 500 gangsters and counting gangsters fire at rivals, kill 1 where crime is law don‚Äôt let gangsters become heroes, sukhbir tells police    the civil lines sho was not available, so i called up area dsp harpal",death,2,1,7,0,10,patiala
5/3/16,https://www.tribuneindia.com/news/community/ig-terms-gangsters-offensive-fb-posts-freedom-of-speech/231182.html," nikhil bhardwaj tribune news service jalandhar, may 2    the facebook page of notorious gangster sukha kahlon, who was killed in police custody near phagwara in january last year, is still being flooded with threatening posts aimed at rival gangster vicky gounder and the police",death,2,3,1,0,6,jalandhar
10/9/15,https://www.tribuneindia.com/news/governance/abohar-municipal-council-to-act-tough-against-defaulters/143560.html, the council had recently come under fire over the dead animal disposal scam which revealed that the mc had been ‚Äúunofficially‚Äù awarding a contract to any person for the past eight years and earning about rs 2 lakh per annum,death,10,0,1,1,12,"sangrur, sas nagar"
10/9/15,https://www.tribuneindia.com/news/governance/abohar-municipal-council-to-act-tough-against-defaulters/143560.html," the council, at a meeting held after four months, has now resolved to put disposal of dead animals on auction",death,10,0,1,1,12,"sangrur, sas nagar"
8/12/15,https://www.tribuneindia.com/news/community/house-gets-flooded-ex-dig-sits-on-dharna/118756.html,"tribune news service  ropar, august 11 a retired deputy inspector general of police iqbal singh lalpura started a fast-unto-death outside the deputy commissioner‚Äôs residence when his pleas to remove water from his flooded house fell on deaf ears",death,3,14,11,0,28,punjab
2/28/15,https://www.tribuneindia.com/news/punjab/punjab-entrepreneurs-say-budget-has-no-goodies-for-sports-cycle-industry/48015.html,ush({ });  sports goods industry developed in jalandhar after skilled hindu craftsmen migrated from pakistan's sialkot area after partition in 1947,death,5,6,2,0,13,"jalandhar, ludhiana"
2/5/15,https://www.tribuneindia.com/news/punjab/vvip-visits-fail-to-provide-succour-to-cancer-village/38139.html,"tribune news service faridkot, february 4  they came, they saw and they zipped away, leaving behind residents to wonder who would be the next vvip to descend on them to ‚Äútake stock‚Äù of the situation in mari mustafa village, where a number of residents have died of cancer and hepatitis c",death,33,0,17,0,50,"faridkot, moga"
2/5/15,https://www.tribuneindia.com/news/punjab/vvip-visits-fail-to-provide-succour-to-cancer-village/38139.html," besides two deaths due to cancer in his family, there are four other members suffering with hepatitis c in gurtej‚Äôs family",death,33,0,17,0,50,"faridkot, moga"
2/5/15,https://www.tribuneindia.com/news/punjab/vvip-visits-fail-to-provide-succour-to-cancer-village/38139.html," after over 60 persons died of cancer and hcv last year, the health department started a large-scale household survey in the village that has a population of 11,000 in the first week of december last year",death,33,0,17,0,50,"faridkot, moga"
2/3/15,https://www.tribuneindia.com/news/courts/hc-sets-3-month-deadline-on-plea-for-flats-by-84-riot-victims/37255.html,hc sets 3-month deadline on plea for flats by ‚Äô84 riot victims,death,18,0,5,0,23,sas nagar
2/3/15,https://www.tribuneindia.com/news/courts/hc-sets-3-month-deadline-on-plea-for-flats-by-84-riot-victims/37255.html,"taking up their petition, a division bench has set three-month deadline for gmada to decide their pleas",death,18,0,5,0,23,sas nagar
2/3/15,https://www.tribuneindia.com/news/courts/hc-sets-3-month-deadline-on-plea-for-flats-by-84-riot-victims/37255.html, the latest deadline came on a petition filed against the state of punjab and other respondents by joginder singh and 12 other petitioners through counsel mansur ali and hs deol,death,18,0,5,0,23,sas nagar
2/3/15,https://www.tribuneindia.com/news/courts/hc-sets-3-month-deadline-on-plea-for-flats-by-84-riot-victims/37255.html,"earlier also, the high court in march 2013 had set a two-month deadline for the state of punjab and its functionaries to redress the grievance of 1984 riot victims for handing over the possession of lig flats",death,18,0,5,0,23,sas nagar
1/16/15,https://www.tribuneindia.com/news/diaspora/diaspora-seeks-nri-act/30760.html,"according to a complaint sent by amrik singh, a us-based nri, to ig gurpreet deo, his paralytic father residing in india was killed and cremated by his uncle‚Äôs family in 2005",death,4,5,1,0,10,jalandhar
7/17/19,https://www.tribuneindia.com/news/punjab/two-found-dead-in-minor/803051.html,"tribune news service  muktsar, july 16  two youths were found dead in a minor near doda village in the¬† district on monday night",death,10,3,3,0,16,sri muktsar sahib
7/13/19,https://www.tribuneindia.com/news/punjab/pak-drops-pro-khalistan-activist-gopal-chawla-others-from-psgpc/801600.html,his name had popped up in the investigation into a grenade attack at nirankari bhawan in amritsar in november last wherein three people were killed,death,3,3,1,0,7,"amritsar, gurdaspur, jalandhar"
5/28/19,https://www.tribuneindia.com/news/punjab/india-pak-corridor-talks-hit-a-bump/779230.html,"ravi dhaliwal  tribune news service  gurdaspur, may 27  the fourth ‚Äútechnical committee‚Äù meeting on the kartapur corridor between india and pakistan, which was held at zero line today, ended in a deadlock with india suggesting that a 800-metre bridge be built on the ravi while the pakistan delegation, fearing¬† flooding during monsoons could erode the bridge, suggested a causeway",death,2,1,2,0,5,gurdaspur
9/25/18,https://www.tribuneindia.com/news/punjab/sukhna-gates-shut-after-water-recedes-in-himachal-rivers/658592.html,ush({ }); five deaths were reported from the states due to the rains,death,2,9,6,0,17,sas nagar
9/25/18,https://www.tribuneindia.com/news/punjab/punjab-toll-3-many-towns-waterlogged/658361.html,"tribune news service chandigarh, september 24  three persons, including two children, were drowned on monday as heavy rain continued for the third day across punjab, leaving cities and towns waterlogged and paddy fields flattened in many areas",death,10,6,5,0,21,"amritsar, gurdaspur, jalandhar, ludhiana, pathankot, patiala, sangrur"
9/25/18,https://www.tribuneindia.com/news/punjab/punjab-toll-3-many-towns-waterlogged/658361.html,"  at the ‚Äòsodal mela‚Äô in jalandhar, an eight-month-old daughter of a rajasthani stall owner drowned after she fell off a bench on which she was asleep in the night as the area was inundated",death,10,6,5,0,21,"amritsar, gurdaspur, jalandhar, ludhiana, pathankot, patiala, sangrur"
9/25/18,https://www.tribuneindia.com/news/punjab/punjab-toll-3-many-towns-waterlogged/658361.html,"in amritsar, a man and his 12-year-old son drowned after their car fell off a bridge into an overflowing drain near khiyala village during heavy rain",death,10,6,5,0,21,"amritsar, gurdaspur, jalandhar, ludhiana, pathankot, patiala, sangrur"
7/5/18,https://www.tribuneindia.com/news/punjab/rain-pours-misery-in-malwa-5-dead/615378.html,"rain pours misery in malwa, 5 dead",death,20,27,30,0,77,"patiala, sas nagar, sri muktsar sahib"
7/5/18,https://www.tribuneindia.com/news/punjab/rain-pours-misery-in-malwa-5-dead/615378.html," a few hours after the death of her husband and two daughters, the woman gave birth to twins at a private hospital",death,20,27,30,0,77,"patiala, sas nagar, sri muktsar sahib"
7/5/18,https://www.tribuneindia.com/news/punjab/rain-pours-misery-in-malwa-5-dead/615378.html," in another incident at malout village, harjinder kaur (22), who was also pregnant, died after the roof of her house collapsed",death,20,27,30,0,77,"patiala, sas nagar, sri muktsar sahib"
7/5/18,https://www.tribuneindia.com/news/punjab/rain-pours-misery-in-malwa-5-dead/615378.html,"ush({ });  at mahuana village, tarsem singh (56), a truck driver from samana in patiala district, who had come here to attend a two-day refresher course at the state institute of automotive and driving skills (siads) died after the roof of a roadside eatery gave way",death,20,27,30,0,77,"patiala, sas nagar, sri muktsar sahib"
9/2/19,https://www.tribuneindia.com/news/punjab/1-lakh-cattle-on-the-loose-claim-100-lives-a-year-in-punjab/826294.html," in patiala, the home district of chief minister capt amarinder singh and local bodies minister brahm mohindra, four people have died in the past one month in such incidents",death,18,26,4,2,50,"patiala, sangrur"
9/2/19,https://www.tribuneindia.com/news/punjab/1-lakh-cattle-on-the-loose-claim-100-lives-a-year-in-punjab/826294.html,"ush({ });  as per the record of the ministry of road transport, provided by the state police, 114 persons died and 11 were injured in accidents involving strays in 2018",death,18,26,4,2,50,"patiala, sangrur"
9/2/19,https://www.tribuneindia.com/news/punjab/1-lakh-cattle-on-the-loose-claim-100-lives-a-year-in-punjab/826294.html,"in the last three years, 370 people have died and another 167 have injured in road accidents",death,18,26,4,2,50,"patiala, sangrur"
9/2/19,https://www.tribuneindia.com/news/punjab/1-lakh-cattle-on-the-loose-claim-100-lives-a-year-in-punjab/826294.html,"4 killed in patiala, 8 in sangrur last month  in patiala, four people have died in the past one month in stray cattle-related incidents",death,18,26,4,2,50,"patiala, sangrur"
9/2/19,https://www.tribuneindia.com/news/punjab/1-lakh-cattle-on-the-loose-claim-100-lives-a-year-in-punjab/826294.html,"as per the record of the ministry of road transport, provided by the state police, 114 persons died and 11 were injured in accidents involving strays in 2018",death,18,26,4,2,50,"patiala, sangrur"
8/5/19,https://www.tribuneindia.com/news/punjab/sad-aap-disrupt-punjab-assembly-on-bargari-probe/813341.html,"tribune news service chandigarh, august 5¬†  the question hour during the second sitting of the punjab assembly monsoon session on monday was drowned amidst din over the bargari sacrilege investigation",death,2,2,3,0,7,punjab
8/2/19,https://www.tribuneindia.com/news/punjab/punjab-assembly-adjourned-within-minutes-on-day-1/811894.html,  parminder singh dhindsa of akali dal and aman arora of aap said that the name of fatehveer‚Äîa two-year-old child who had fallen into a borewell in sangrur and died‚Äîshould be included in the list,death,2,3,2,0,7,sangrur
7/11/19,https://www.tribuneindia.com/news/punjab/rains-cast-shadow-on-corridor-work/800091.html,"ravi dhaliwal tribune news service  dera baba nanak, july 10  with just 30 per cent of the work completed till yet and the monsoon setting in, there are reports that the october 31st deadline to complete the kartarpur corridor project may be missed",death,5,1,1,0,7,punjab
7/11/19,https://www.tribuneindia.com/news/punjab/rains-cast-shadow-on-corridor-work/800091.html," officials confirmed that for the next two months, when the monsoon will be at its peak, the work would continue to be done in bits and pieces, a development which is sure to push the deadline back by a few weeks",death,5,1,1,0,7,punjab
7/11/19,https://www.tribuneindia.com/news/punjab/rains-cast-shadow-on-corridor-work/800091.html,this means we have very less time left if we have to meet the october 31 deadline,death,5,1,1,0,7,punjab
7/11/19,https://www.tribuneindia.com/news/punjab/rains-cast-shadow-on-corridor-work/800091.html,"       officials confirmed that for the next two months, when the monsoon will be at its peak, the work would continue to be done in bits and pieces, a development which is sure to push the deadline back by a few weeks",death,5,1,1,0,7,punjab
6/11/19,https://www.tribuneindia.com/news/punjab/sluggish-monsoon-may-spell-trouble-for-farm-sector/786365.html," if there is a long gap between two rain spells, there is high probability of newly planted seeds getting killed",death,1,24,2,0,27,punjab
9/16/18,https://www.tribuneindia.com/news/punjab/daduwal-mand-are-congress-puppets-sukhbir-badal/653799.html,¬†  highlights parkash¬†badal claims one sikh radical arrested with a pistol meant to kill him and his son at the rally,death,3,2,1,1,7,faridkot
9/14/18,https://www.tribuneindia.com/news/punjab/outlet-blocked-village-turns-pond/652677.html," irked with no response from the administration, the villagers collected rs 3,000 and drained out water from the streets with the help of a diesel pump",death,11,6,20,0,37,"gurdaspur, sas nagar"
9/3/18,https://www.tribuneindia.com/news/punjab/things-get-verse-in-vidhan-sabha/646983.html,"cancer-prone village bats for hygiene  abohar: dangarkhera village, once infamous for cancer deaths, is now focusing on health and hygiene",death,10,1,8,0,19,"mansa, pathankot, sri muktsar sahib"
8/22/18,https://www.tribuneindia.com/news/punjab/sidhu-issue-will-be-raised-in-assembly-and-parliament-shwait-malik/641037.html,"ravi s singh  tribune news service  new delhi, august 22  the controversy stoked by punjab minister navjot singh sidhu by  hugging¬†pakistan army chief qamar javed bajwa¬†refuses to die down with  the state bjp president and rajya sabha mp shwait malik saying¬†the issue  would be raised in the state assembly during the monsoon session, and  in parliament during its next session",death,5,0,2,0,7,amritsar
6/6/18,https://www.tribuneindia.com/news/punjab/beas-on-revival-mode-gets-fish-seeds/600824.html,   tonnes of fish that died due to molasses spill on may 17 were supposed to breed in the coming monsoon,death,3,10,3,0,16,punjab
5/26/18,https://www.tribuneindia.com/news/punjab/beas-spill-food-scarcity-to-hit-dolphins-gharials/595164.html,"gs paul tribune news service amritsar, may 25  tonnes of fish which died due to the molasses‚Äô spill in the beas were supposed to breed in the coming monsoon",death,3,8,6,0,17,amritsar
1/3/17,https://www.tribuneindia.com/news/community/as-rains-falter-bhakra-cuts-supply-to-states/345317.html,"in 1985, the water had dropped to 1,463 feet, just a foot above its dead storage level, implying that the reservoir was virtually devoid of usable water",death,1,0,1,1,3,punjab
11/23/16,https://www.tribuneindia.com/news/community/rough-ride-for-industry-in-jalandhar-north/327058.html,‚Äúas many as 28 youths aged less than 30 years have died due to drug addiction in my ward in the past five years,death,7,13,5,3,28,"jalandhar, ludhiana, sas nagar"
11/17/16,https://www.tribuneindia.com/news/politics/nothing-western-about-jalandhar-west/324441.html," the foundation stone of another skill centre, named after kabir, to train construction workers was laid on the 120-ft road earlier this year",death,23,11,9,1,44,"jalandhar, kapurthala"
9/22/16,https://www.tribuneindia.com/news/community/prolonged-monsoon-led-to-rise-in-dengue-cases-says-expert/299015.html," so far, 12 suspected dengue death has been reported from across the state",death,1,1,2,0,4,"amritsar, jalandhar, ludhiana, sangrur, sas nagar"
9/7/16,https://www.tribuneindia.com/news/community/stormy-monsoon-session-on-cards-in-punjab/291627.html,during the session four sittings will take place before being adjourned sine die on next wednesday,death,2,3,1,0,6,punjab
7/4/16,https://www.tribuneindia.com/news/community/paddy-on-450-acres-submerged/260794.html,"two killed, 5 hurt in roof collapse  muktsar: a man and his mother were killed when the roof of their house collapsed due to rain at dabwali malko ki village of lambi constituency on sunday",death,14,19,26,2,61,"jalandhar, sri muktsar sahib"
6/28/16,https://www.tribuneindia.com/news/governance/115-year-old-fazilka-building-now-a-protected-monument/258020.html,"after the death of sunder mal and his family members in the 1940s, nobody came forward to take care of it",death,4,0,1,0,5,fazilka
2/14/16,https://www.tribuneindia.com/news/community/to-serve-people-he-bridges-gaps-in-development/196012.html,bhag singh died in 1987.,death,4,0,7,1,12,punjab
10/20/15,https://www.tribuneindia.com/news/community/bbmb-s-plan-to-inspect-dams-submerged-parts-opposed/148157.html," the inspection will require bringing the level of the bhakra dam reservoir on the sutlej to its dead storage level of 1,462 feet ‚Äì about 220 feet lower than its maximum capacity ‚Äì for experts to study the state and health of the trash racks, penstocks, river outlets and other submerged installations",death,1,0,16,0,17,punjab
9/10/15,https://www.tribuneindia.com/news/punjab/punjab-govt-approves-bailout-package-for-sugar-mills/131383.html,the monsoon session would commence on september 18 afternoon at 2 pm with obituary references and legislative business would be transacted on september 21-24 and it would be adjourned sine die on september 24,death,1,16,2,2,21,punjab
9/1/15,https://www.tribuneindia.com/news/community/relief-for-region-s-farmers-as-dams-full-despite-deficient-rain/127285.html,  bhakra beas management board member (irrigation) sk sharma said water level at these dams was nearing capacity even as the filling-period deadline was 20 days away,death,2,17,3,1,23,punjab
9/1/15,https://www.tribuneindia.com/news/community/relief-for-region-s-farmers-as-dams-full-despite-deficient-rain/127285.html," bhakra officials said due to better inflow this year, there were chances that the dams would be filled to capacity even before the september 20 deadline.",death,2,17,3,1,23,punjab
8/4/15,https://www.tribuneindia.com/news/punjab/bamiyal-sector-remains-as-vulnerable-as-ever/115200.html," then, they shot dead their first target ‚Äî amarjit singh, who runs a ‚Äòchhole-kulcha‚Äô joint near the bus stand ‚Äî on july 27",death,8,0,4,0,12,"gurdaspur, pathankot, sas nagar"
7/30/15,https://www.tribuneindia.com/news/community/new-guidelines-for-bsf-army/113097.html,in december last year an army camp in uri had come under attack and 11 soldiers had died.,death,3,3,1,0,7,"gurdaspur, pathankot"
7/23/15,https://www.tribuneindia.com/news/community/denied-meeting-cps-sidhu-barges-into-cm-s-event/110217.html,"perneet singh tribune news service amritsar, july 22  chief parliamentary secretary dr navjot kaur sidhu, after being ‚Äúcold-shouldered‚Äù by the state government, today threatened to sit on fast-unto-death if a grant of rs10 crore for construction of roads in her amritsar east assembly segment is not released within a fortnight",death,5,1,2,1,9,"amritsar, bathinda"
7/6/15,https://www.tribuneindia.com/news/community/waterlogging-monsoon-nears-but-projects-unfinished/102939.html," when contacted, sl sidhu, superintending engineer, drainage department, said, ‚Äúwe hope to complete the cleaning work of drains before its deadline on july 10",death,5,22,12,3,42,sri muktsar sahib
6/2/15,https://www.tribuneindia.com/news/community/monsoon-ahead-but-drains-in-muktsar-yet-to-be-desilted/88370.html,"tribune news service muktsar, june 1  the irrigation department is likely to miss the deadline of june 30 to clean and desilt drains in muktsar district",death,3,4,4,1,12,sri muktsar sahib
5/21/15,https://www.tribuneindia.com/news/governance/facing-fund-crunch-dept-to-clean-only-16-of-92-drains/83231.html,‚Äúfinancial crunch means we had to identify just 16 drains which will be cleaned before the july 1 deadline expires,death,2,2,1,2,7,"gurdaspur, sas nagar, sri muktsar sahib"
5/14/15,https://www.tribuneindia.com/news/community/connecting-people-pulanwala-baba-builds-sixth-bridge-costing-rs-5-cr/80273.html,bhag singh died in 1987.,death,5,0,9,4,18,punjab
4/28/15,https://www.tribuneindia.com/news/community/gurdaspur-roads-in-a-dilapidated-state/73174.html,"  the 22-km mukerian-gurdaspur stretch, too, has become a virtual death trap",death,6,1,2,0,9,gurdaspur
12/19/14,https://www.tribuneindia.com/news/community/garbage-dumps-make-town-susceptible-to-diseases/19900.html,"the council pays a monthly electricity bill of rs 3 to 4 lakh  the state government had announced to open an industrial training institute in samana almost five years ago, but work on the project is yet to begin fact file  number of wards: 17  total population: 55,000  number of voters: 39,108  male voters: 20,577  female voters: 18,531  infant mortality rate: 29  gender ratio: 932/1,000 health/education  government schools: 14  private & aided schools: 30  no",death,7,2,4,0,13,punjab
11/30/14,https://www.tribuneindia.com/news/punjab/poor-supply-forcing-residents-to-dig-deep-for-water/12507.html,    infant mortality rate: 21  5,death,13,1,5,0,19,punjab
9/28/19,https://www.tribuneindia.com/news/punjab/six-pilgrims-from-punjab-killed-in-uttarakhand-accident/839621.html,"new tehri, september 28 six pilgrims from punjab, who were on their way to the himalayan shrine¬†of hemkund sahib,¬†were killed and four injured when a huge rock¬†fell on¬†their vehicle in tehri district following a landslip triggered by heavy rains",death,5,9,2,0,16,sas nagar
9/28/19,https://www.tribuneindia.com/news/punjab/six-pilgrims-from-punjab-killed-in-uttarakhand-accident/839621.html,"the vehicle, a tempo traveller, turned turtle after the huge rock fell on it, killing five pilgrims on the spot while another died at hospital",death,5,9,2,0,16,sas nagar
7/29/19,https://www.tribuneindia.com/news/punjab/woman-killed-as-roof-collapses-due-to-rain/809305.html,"our correspondent abohar, july 28  a woman was killed, while her husband and grandson were injured as the roof of their house collapsed after heavy rain at sardarpura village, 16 km from abohar, on saturday night",death,7,4,16,2,29,"bathinda, sas nagar"
7/18/19,https://www.tribuneindia.com/news/punjab/jail-where-nehru-was-kept-in-1923-collapses-in-heavy-rain/803586.html," santhanam, who died in 1980, in his memoir ‚Äúhandcuffed with jawaharlal‚Äù had recalled how they were lodged in a separate and secluded part of the jail which had mud walls",death,1,0,3,0,4,faridkot
9/26/18,https://www.tribuneindia.com/news/punjab/punjab-farmer-swept-away-to-pak-body-found/659121.html,"gs paul tribune news service amritsar, september 26  a 53-year-old farmer from a border village in this district died after he accidentally fell into the ravi on tuesday and swept away towards  pakistan",death,2,8,3,0,13,amritsar
8/10/18,https://www.tribuneindia.com/news/punjab/missing-forest-officer-s-body-found/634940.html," besides, vijay did not hold anyone responsible for his death",death,7,0,3,0,10,hoshiarpur
7/4/18,https://www.tribuneindia.com/news/punjab/two-girls-die-kin-hurt-as-roof-collapses-after-rain/614787.html,"our correspondent  ferozepur, july 3 two girls belonging to a migrant labourers‚Äô family died whereas three other family members got injured when the roof of their house collapsed following heavy rain at khai phemeke village on the ferozepur-fazilka road on tuesday",death,8,0,7,1,16,"fazilka, ferozepur"
7/4/18,https://www.tribuneindia.com/news/punjab/two-girls-die-kin-hurt-as-roof-collapses-after-rain/614787.html,"expressing concern over the deaths of the two girls, ramvir said the red cross society would bear all expenses related to the medicines for the injured and their treatment",death,8,0,7,1,16,"fazilka, ferozepur"
6/29/18,https://www.tribuneindia.com/news/punjab/businessman-found-dead-in-nurpur-bedi/612224.html,"tribune news service ropar, june 28  a 44-year-old businessman was found dead on the roof of his cement store in nurpur bedi near here on thursday",death,4,0,6,0,10,punjab
6/28/17,https://www.tribuneindia.com/news/community/300-stranded-at-attari-as-centre-blocks-pak-train/428830.html," (follow¬†the tribune on¬†facebook;¬†and¬†twitter @thetribunechd)  the sgpc said the centre has denied permission to a 251-member sikh delegation to visit pakistan on the occasion of death anniversary of maharaja ranjit singh, citing security reasons",death,9,0,1,0,10,"amritsar, ferozepur"
6/28/17,https://www.tribuneindia.com/news/community/300-stranded-at-attari-as-centre-blocks-pak-train/428830.html," hundreds of pilgrims, mostly sikhs, go to pakistan in large groups on different occasions, including the birth and death anniversaries of sikh gurus and on baisakhi festival",death,9,0,1,0,10,"amritsar, ferozepur"
6/13/17,https://www.tribuneindia.com/news/punjab/rain-fury-3-farmers-die-canal-breaches-submerge-cotton/421481.html,"rain fury: 3 farmers die, canal breaches submerge cotton",death,5,30,13,0,48,"fazilka, sas nagar"
6/13/17,https://www.tribuneindia.com/news/punjab/rain-fury-3-farmers-die-canal-breaches-submerge-cotton/421481.html," three farmers ‚Äî sardara ram (40) of pallu, hans raj jat (55) of lakha hakam and atma singh (51) of sagarwala ‚Äî died as walls collapsed in respective areas after incessant rain yesterday",death,5,30,13,0,48,"fazilka, sas nagar"
6/13/17,https://www.tribuneindia.com/news/punjab/rain-fury-3-farmers-die-canal-breaches-submerge-cotton/421481.html, at least 95 sheep were killed as 30-ft wall in a cattle shed owned by liaquat ali collapsed in the srikesarisinghpur segment of sriganganagar,death,5,30,13,0,48,"fazilka, sas nagar"
6/8/17,https://www.tribuneindia.com/news/punjab/3-die-as-roof-collapses-in-moga/419159.html,3 die as roof collapses in moga,death,16,3,16,1,36,"faridkot, moga, sas nagar"
6/8/17,https://www.tribuneindia.com/news/punjab/3-die-as-roof-collapses-in-moga/419159.html,"tribune reporters moga, june 7  three members of a family were killed and one injured when the roof of their house collapsed due to heavy rain at patto hira singh village in moga district on wednesday",death,16,3,16,1,36,"faridkot, moga, sas nagar"
6/8/17,https://www.tribuneindia.com/news/punjab/3-die-as-roof-collapses-in-moga/419159.html," meanwhile, in another incident, a 15-year-old daughter of a migrant rickshaw puller was buried to death when the roof of their rented accommodation collapsed at bedi nagar",death,16,3,16,1,36,"faridkot, moga, sas nagar"
6/8/17,https://www.tribuneindia.com/news/punjab/3-die-as-roof-collapses-in-moga/419159.html,elderly woman killed  abhohar: an elderly woman was killed while her husband and their three grandchildren were injured when the roof of their neighbour‚Äôs house collapsed in chak 3e village near sriganganagar,death,16,3,16,1,36,"faridkot, moga, sas nagar"
5/30/17,https://www.tribuneindia.com/news/punjab/storm-wreaks-havoc-2-dead/414744.html,storm wreaks havoc; 2 dead,death,9,4,9,0,22,"fazilka, sas nagar"
5/30/17,https://www.tribuneindia.com/news/punjab/storm-wreaks-havoc-2-dead/414744.html,"our correspondent  abohar, may 29 at least two persons died and many sustained injuries as a high-velocity thunderstorm lashed abohar and its neighbouring border district sriganganagar from about 12.15 to 12.45 am, followed by heavy rain",death,9,4,9,0,22,"fazilka, sas nagar"
5/30/17,https://www.tribuneindia.com/news/punjab/storm-wreaks-havoc-2-dead/414744.html," in choohariwala dhanna village on the abohar-fazilka road, rajbir singh (50) died as a shed fell on him at his house",death,9,4,9,0,22,"fazilka, sas nagar"
5/30/17,https://www.tribuneindia.com/news/punjab/storm-wreaks-havoc-2-dead/414744.html,tejpal singh (32) of suratgarh in sriganganagar died on the spot when his motorcycle reportedly rammed into a truck during thunderstorm,death,9,4,9,0,22,"fazilka, sas nagar"
8/21/16,https://www.tribuneindia.com/news/community/four-killed-12-hurt-as-buses-collide-in-jalandhar-village/283192.html,"four killed, 12 hurt as buses collide in jalandhar village",death,13,10,5,0,28,"jalandhar, ludhiana, moga, pathankot, sri muktsar sahib"
8/21/16,https://www.tribuneindia.com/news/community/four-killed-12-hurt-as-buses-collide-in-jalandhar-village/283192.html,"gagandeep singh tribune news service malsian (jalandhar), aug 20  four persons were killed and 12 sustained critical injuries when an orbit bus collided with another private bus on the nakodar-shahkot road near billi chuharmi village this afternoon",death,13,10,5,0,28,"jalandhar, ludhiana, moga, pathankot, sri muktsar sahib"
8/21/16,https://www.tribuneindia.com/news/community/four-killed-12-hurt-as-buses-collide-in-jalandhar-village/283192.html,  a case has been registered under section 304-a (causing death by negligence) of the ipc,death,13,10,5,0,28,"jalandhar, ludhiana, moga, pathankot, sri muktsar sahib"
6/15/16,https://www.tribuneindia.com/news/community/three-women-die-in-roof-collapse/251792.html,"tribune news service  moga, june 14 three women were killed when the roof of a cow shelter shed collapsed at dhalleke village in the district this evening",death,8,3,6,0,17,moga
6/10/16,https://www.tribuneindia.com/news/community/two-killed-as-tree-falls-on-tent-in-hp/249267.html,two killed as tree falls on tent in hp,death,14,7,2,1,24,jalandhar
6/10/16,https://www.tribuneindia.com/news/community/two-killed-as-tree-falls-on-tent-in-hp/249267.html,"tribune news service shimla/jalandhar, june 9  two jalandhar residents were killed and another sustained injuries when a tree fell on a tent in which they were sleeping at an eco-tourism site near narkanda early this morning",death,14,7,2,1,24,jalandhar
6/10/16,https://www.tribuneindia.com/news/community/two-killed-as-tree-falls-on-tent-in-hp/249267.html,"gagan was posted in the education department after his father, om parkash, died eight years ago",death,14,7,2,1,24,jalandhar
6/9/16,https://www.tribuneindia.com/news/community/2-jalandhar-youths-killed-as-tree-falls-on-tent-in-narkanda/249009.html,2 jalandhar youths killed as tree falls on tent in narkanda,death,9,8,1,1,19,jalandhar
6/9/16,https://www.tribuneindia.com/news/community/2-jalandhar-youths-killed-as-tree-falls-on-tent-in-narkanda/249009.html," bhanu p lohumi tribune news service shimla, june 9two youths were killed while another was injured when a tree fell over the tent in which they were sleeping in the wee hours of thursday at a nature park managed by himachal pradesh forest corporation near narkanda, 65 km from here",death,9,8,1,1,19,jalandhar
8/17/15,https://www.tribuneindia.com/news/punjab/bhakra-floodgates-to-be-re-opened/120192.html," sources at the dam said that the water touched the level of 1,666.89 ft at 3 pm, a little less than the deadline of 1,667 ft",death,1,15,10,0,26,"amritsar, jalandhar"
7/27/15,https://www.tribuneindia.com/news/community/1-dies-3-injured-in-mishaps-due-to-rain/111819.html,"1 dies, 3 injured in mishaps due to rain",death,8,1,7,0,16,sas nagar
7/27/15,https://www.tribuneindia.com/news/community/1-dies-3-injured-in-mishaps-due-to-rain/111819.html,"our correspondent  abohar, july 26 a labourer was killed and three children sustained injuries in separate incidents due to heavy rain in the region today",death,8,1,7,0,16,sas nagar
7/27/15,https://www.tribuneindia.com/news/community/1-dies-3-injured-in-mishaps-due-to-rain/111819.html,"sudhish prasad (50) of purani abadi in sriganganagar, 40 km from here, died when he reportedly slipped from the roof of a house in vinoba bast",death,8,1,7,0,16,sas nagar
6/28/15,https://www.tribuneindia.com/news/punjab/hundreds-of-hemkund-sahib-pilgrims-evacuated/99493.html,two youths killed in mishap near rishikesh  amritsar: two amritsar youths were killed in a road mishap near rishikesh while they were returning from hemkund sahib in uttarakhand,death,17,10,13,0,40,"amritsar, sas nagar"
3/17/15,https://www.tribuneindia.com/news/community/6-killed-in-abohar-sriganganagar/54631.html,"6 killed in abohar, sriganganagar",death,9,12,11,0,32,sas nagar
3/17/15,https://www.tribuneindia.com/news/community/6-killed-in-abohar-sriganganagar/54631.html,"raj sadosh our correspondentabohar, march 17at least six persons, including three of a family, were killed due to heavy rain and hailstorm that lashed abohar and the neighbouring sriganganagar district of rajasthan last night",death,9,12,11,0,32,sas nagar
3/17/15,https://www.tribuneindia.com/news/community/6-killed-in-abohar-sriganganagar/54631.html,alkar singh (31) and kuldeep singh (27) of kundal village near here were killed as the tractor-trailer they were travelling on turned turtle last night during rain,death,9,12,11,0,32,sas nagar
3/17/15,https://www.tribuneindia.com/news/community/6-killed-in-abohar-sriganganagar/54631.html,sumit (10) was killed as the wall of gogamedi temple in suratgarh collapsed following heavy rain,death,9,12,11,0,32,sas nagar
3/4/15,https://www.tribuneindia.com/news/community/woman-dies-in-roof-collapse/49459.html,"an elderly woman, bhago devi (80), died and her brother lal chand and nephew jaskaran were injured as the roof of their house collapsed in munda village on the outskirts of hanumangarh last night",death,5,23,16,0,44,sas nagar
7/2/16,https://www.dainiktribuneonline.com/2016/07/%e0%a4%b2%e0%a5%81%e0%a4%a7%e0%a4%bf%e0%a4%af%e0%a4%be%e0%a4%a8%e0%a4%be-%e0%a4%ae%e0%a5%87%e0%a4%82-%e0%a4%aa%e0%a4%b9%e0%a4%b2%e0%a5%80-%e0%a4%b9%e0%a5%80-%e0%a4%ac%e0%a4%be%e0%a4%bf%e0%a4%b0/,ccording to the meteorological department 7322 millimeters of rain occurred in ludhiana today one of the advocates sitting on fastuntodeath yesterday was rushed to the hospital after the condition of a female advocate deteriorated but after necessary treatment this female advocate again sat on a fast banning rafting on the beas boom rapidly melting snow on the shimla nis mountains and beas one of the major rivers of himachal pradesh is in full flow,death,5,0,4,0,9,"ferozepur, ludhiana, sas nagar"
8/16/17,https://www.dainiktribuneonline.com/2017/08/‡§¨‡§æ‡§¢‡§º-‡§ï‡•Ä-‡§ö‡§™‡•á‡§ü-‡§Æ‡•á‡§Ç-9-‡§∞‡§æ‡§ú‡•ç‡§Ø-100-‡§ï‡•Ä/,women cooking in the open in the floodravaged morigaon of assam  9 states are in the grip of floods due to heavy rains and water released from nepal;100 people are also reported to be killed in bihar and eastern up ndrf is bad on wednesday.4 additional teams airlift from bathinda punjab to patna bihar assam up west bengal himachal pradesh arunach 113 teams of ndrf have been deployed in disaster affected areas of the state of gujarat rajasthan and tripura rescuing,death,5,1,2,0,8,bathinda
8/18/08,https://www.ndtv.com/video/news/news/14-perish-as-flood-wreaks-havoc-in-punjab-36255,14 people have died in the last three days as incessant rain and rising water levels in rivers and dams have hit nine districts in the state,death,3,1,4,0,8,"ferozepur, jalandhar, moga"
8/22/13,https://timesofindia.indiatimes.com/city/chandigarh/Satluj-continues-to-flood-villages-in-Ferozepur-Fazilka/articleshow/21969055.cms,one more drowns ferozepur,death,14,32,52,1,99,"fazilka, ferozepur"
8/22/13,https://timesofindia.indiatimes.com/city/chandigarh/Satluj-continues-to-flood-villages-in-Ferozepur-Fazilka/articleshow/21969055.cms,one person reportedly drowned in gushing sutlej waters while shifting his belongings to safer places at chak hamad village of the district on tuesday,death,14,32,52,1,99,"fazilka, ferozepur"
10/18/19,https://reliefweb.int/node/3354153,"the extended monsoon has left a trail of devastation and the death toll has reached more than 1,600 across 14 states",death,16,2,21,1,40,punjab
10/18/19,https://reliefweb.int/node/3354153, more than 100 people have died since 27 september following incessant rains3,death,16,2,21,1,40,punjab
8/29/19,https://reliefweb.int/node/3279863,"situation report in india on flood/heavy rain fall (as on 29th august 2019)  situation in india more than 8869768 population affected by flood and landslide, nearly 1155 people are reported to be dead across india due to monsoon related incidents as per the latest report of the national emergency response centre, mha released on 26th august 2019",death,10,11,25,1,47,"ferozepur, sas nagar"
8/29/19,https://reliefweb.int/node/3279863,"over 8,000 poultry birds and 120 bovines have been reported dead in the punjab floods",death,10,11,25,1,47,"ferozepur, sas nagar"
8/29/19,https://reliefweb.int/node/3279863,"uttarakhand in uttarakhand, the number of dead rose to 12, cloudbursts have wreaked havoc in a dozen villages of uttarakhand's uttarkashi district, washing away houses and hectares of agricultural land",death,10,11,25,1,47,"ferozepur, sas nagar"
8/29/19,https://reliefweb.int/node/3279863,so far evacuated 53 persons & 01 livestock and retrieved 04 dead bodies.,death,10,11,25,1,47,"ferozepur, sas nagar"
8/20/19,https://reliefweb.int/node/3267823,at least 35 people have been killed in rain related incidents,death,17,7,21,0,45,"jalandhar, ludhiana, sas nagar"
8/20/19,https://reliefweb.int/node/3267743,"in uttarakhand, death toll in mori subdivision of uttarkashi district has risen to 12 whereas 5 people are missing",death,18,17,17,5,57,punjab
8/20/19,https://reliefweb.int/node/3267743,"meanwhile, in himachal pradesh, death toll has risen to 25 after one more death was reported from chamba district due to heavy rain",death,18,17,17,5,57,punjab
8/19/19,https://reliefweb.int/node/3263983,"according to media reports, at least 23 people have been killed in himachal pradesh, while 3 died and 22 are missing following a cloudburst in uttarakhand, 3 more reportedly died in punjab",death,6,1,3,0,10,punjab
9/20/18,https://reliefweb.int/node/2831344,"according to the national disaster management authority (ndma), as on august 24th, 417 people have died and over 54.11 lakh people were affected,12.47 lakh of whom had to seek shelter in 5,645 relief camps",death,7,0,10,1,18,punjab
9/25/18,https://reliefweb.int/node/2802759,"flood fury: situation grim in himachal, punjab and j&k  incessant rains triggered flash floods and landslides in hill states of northern india, with at least 11 people killed on monday in jammu and kashmir, himachal pradesh and haryana, and a 'red alert' being issued in punjab",death,3,3,1,0,7,punjab
9/24/18,https://reliefweb.int/node/2800734,himachal chief minister jai ram thakur has said that after the met department's forewarning all authorities concerned have been put on alert and advisories have been issued for rescue and relief work.2 people are reported to have been killed in heavy rains in himachal pradesh,death,13,8,6,0,27,punjab
7/26/18,https://reliefweb.int/node/2716534,"in muzaffarnagar, 3 persons died in rain-related incidents but the rain brought respite to farmers of the parched bundelkhand region",death,8,3,8,0,19,sas nagar
6/21/18,https://reliefweb.int/node/2664929,"flood threat looms large over these 10 indian states  highlights at least five of these flood-affected states have been placed on high risk on two other hazards‚Äîcyclone and heat wave west bengal has the highest risk of cyclone, followed by odisha, andhra, gujarat and kerala at least 100 cyclone prone districts have been studied for the purpose new delhi: monsoon has just set in and more than 30 people have already died in floods in north east, 20 of them in assam alone with over half a million marooned",death,8,5,12,0,25,punjab
6/21/18,https://reliefweb.int/node/2664929,"in fact, last year, bihar disaster management authorities had reported more than 500 deaths due to floods",death,8,5,12,0,25,punjab
6/21/18,https://reliefweb.int/node/2664929,"odisha, up, andhra, west bengal, bihar and punjab are also among the top 10 states facing the highest risk of heat wave deaths in the country",death,8,5,12,0,25,punjab
6/21/18,https://reliefweb.int/node/2664929,"in 2015 and 2016, more than 1,100 people reported killed in disasters and over 350 million affected across the country",death,8,5,12,0,25,punjab
6/15/18,https://reliefweb.int/node/2656989,"in kerala, at least 16 people have been killed in rain related incidents in the past one week",death,9,12,11,0,32,punjab
6/15/18,https://reliefweb.int/node/2656989,heavy rains also led to a landslide in kozhikode killing at least 8 people,death,9,12,11,0,32,punjab
6/12/18,https://reliefweb.int/node/2650389,"10 killed in lightning strike incidents in wb; heat wave conditions prevail in north india  at least 10 people were killed and several others were injured in incidents of lightning strike in west bengal with heavy monsoon rain triggering floods in mizoram, even as heat wave conditions prevailed in north india",death,8,3,2,0,13,"amritsar, patiala, sas nagar"
6/12/18,https://reliefweb.int/node/2650389,"in west bengal, four people were killed in lightning strikes in bankura district, three in hooghly district, while one death each was reported from west midnapore, birbhum and north 24 parganas districts, officials said",death,8,3,2,0,13,"amritsar, patiala, sas nagar"
8/7/17,https://reliefweb.int/node/2159444,"achievement during flood -2017 season are as under: assam :      so far ndrf teams rescued 82 persons ,evacuated 532 persons, retrieved 5 dead bodies and provide medical  assistance to 30 persons",death,51,6,13,0,70,mansa
8/7/17,https://reliefweb.int/node/2159444,"so far teams have rescued 122 persons, evacuated 847 persons, 13 live stocks and retrieved 03 dead bodies and also distributed food-  7810pkts and medicines",death,51,6,13,0,70,mansa
8/7/17,https://reliefweb.int/node/2159444,"gujarat:  so far teams have rescued 1355 persons, evacuated 7286 persons, 27 livestock and retrieved 11 dead bodies and distributed food- 71193 pkts, water pouches/ bottles-  81150 nos, dry ration ( rice, dal, suger, churaetc -1750 bags,biscuits / namkin- 2225 pkts,  cloth- 1750 nos and blanket- 75 nos",death,51,6,13,0,70,mansa
8/7/17,https://reliefweb.int/node/2159444,"so far teams have rescued 253 persons, evacuated 1029 persons and retrieved 05 dead bodies and distributed food 1500 pkts, water pouches/ bottles-  25564 nos, dry ration ( rice, dal, suger, churaetc ‚Äì 236 bags, baby food - 244 ctns, milk- 1056 pkts, gur -2205  kgs, tarpoline-  58 nos,  vegetable- 540 kgs and medicines",death,51,6,13,0,70,mansa
12/15/15,https://reliefweb.int/node/1307226,so far nearly 400 people have died and over 1.8 million people have been displaced,death,31,5,22,0,58,punjab
12/15/15,https://reliefweb.int/node/1307226,at least 269 people have been killed to due to rain and flood related incidents in tamil nadu where thousands have become homeless,death,31,5,22,0,58,punjab
12/15/15,https://reliefweb.int/node/1307226,the floods have also killed 54 in neighboring andhra pradesh and two in pondicherry,death,31,5,22,0,58,punjab
12/15/15,https://reliefweb.int/node/1307226,"the floods have left over 269 dead in tamil nadu and 54 in andhra pradesh, said home minister rajnath singh in loksabha",death,31,5,22,0,58,punjab
4/27/15,https://reliefweb.int/node/955971,the death toll in india was revised to 62 on sunday after the massive earthquake struck nepal around saturday noon,death,21,1,5,1,28,punjab
4/27/15,https://reliefweb.int/node/955971,"the death toll in neighbouring nepal crossed 2,200",death,21,1,5,1,28,punjab
4/27/15,https://reliefweb.int/node/955971,the government announced rs 6 lakh compensation to the relatives of those killed as prime minister narendra modi took stock of rescue and relief operations at a review meeting,death,21,1,5,1,28,punjab
4/27/15,https://reliefweb.int/node/955971,"""19 dead bodies were retrieved and 61 injured persons were rescued by the indian army expedition team",death,21,1,5,1,28,punjab
11/18/14,https://reliefweb.int/node/728766,"help for recovery after south asia floods  by david tereshchuk* november 18, 2014‚Äîin september of this year, south asia‚Äôs worst monsoon season in 50 years caused torrential flooding and landslides that killed hundreds of people in india and pakistan, and displaced many thousands from their homes",death,14,4,15,0,33,sas nagar
11/18/14,https://reliefweb.int/node/728766,"in india-administered kashmir‚Äîa region that for decades has been disputed territory between the two countries, and where the rains were especially severe‚Äîat least 120 people died and 200,000 were left homeless",death,14,4,15,0,33,sas nagar
10/28/14,https://reliefweb.int/node/703828,"essential relief for flood-affected families in pakistan in pakistan, hundreds died and around 2.5 million people were affected as floodwaters destroyed homes, vital infrastructure, and livelihoods last month",death,13,3,31,0,47,punjab
9/13/14,https://reliefweb.int/node/691309,"kumar is among an estimated 12,000 people, who have trekked to ramban in sheer desperation as they received no help from administration, which was practically washed away in the flood waters that have killed over 200 people and marooned tens of thousands besides leaving as many homeless",death,12,1,7,1,21,"amritsar, sas nagar"
9/12/14,https://reliefweb.int/node/691053,"the floods have also brought devastation to parts of pakistan where 230 people have died, with the state of punjab badly affected, as well as bangladesh and nepal",death,11,8,12,0,31,punjab
9/10/14,https://reliefweb.int/node/690316,"hundreds of villages have been submerged, forcing hundreds of thousands of people from their homes and leaving hundreds of people dead",death,10,9,18,0,37,sas nagar
9/10/14,https://reliefweb.int/node/690209,"j&k floods: over 200 dead, 47,000 people rescued  sameer arshad,tnn | sep 10, 2014, 06.40 am ist jammu: the death toll from the floods in jammu & kashmir crossed 200 on tuesday even as water receded in some parts with officials fearing the number of those killed could rise once the actual extent of damage becomes clearer",death,16,5,22,0,43,sas nagar
9/9/14,https://reliefweb.int/node/690121,sources said at least 143 people have died in the jammu region alone,death,23,3,23,0,49,sas nagar
8/18/11,https://reliefweb.int/node/441578,"heavy rains in up, bengal, meghalaya; 12 dead  new delhi: monsoon on wednesday continued to wreak havoc as heavy rains triggered floods, landslides and claimed at least twelve lives in northern and eastern india",death,19,8,5,0,32,punjab
8/18/11,https://reliefweb.int/node/441578,"eight persons were killed in uttar pradesh, two each in west bengal and meghalaya, official reports said",death,19,8,5,0,32,punjab
8/18/11,https://reliefweb.int/node/441578,heavy downpours left eight persons dead in uttar pradesh where major rivers are on the verge of flooding hundreds of villages,death,19,8,5,0,32,punjab
8/18/11,https://reliefweb.int/node/441578,"two more persons were killed on wednesday and another was said to be missing in heavy rains since sunday, the sources said adding that the landslide toll climbed to six after one person died last night at west garo hills",death,19,8,5,0,32,punjab
9/21/10,https://reliefweb.int/node/382328,colonel and one major are reported to be dead,death,3,3,2,0,8,punjab
7/13/10,https://reliefweb.int/node/360982,the death toll in punjab went up to 22 as two more bodies were recovered in patiala,death,9,9,15,0,33,"amritsar, fatehgarh sahib, ferozepur, gurdaspur, hoshiarpur, ludhiana, patiala, sangrur, sas nagar"
7/9/10,https://reliefweb.int/node/360584,#NAME?,death,5,3,14,0,22,"fatehgarh sahib, ludhiana, patiala, sangrur, sas nagar, sbs nagar"
7/6/10,https://reliefweb.int/node/360264,- ¬† ¬† ¬† ¬†total 05 human deaths have been reported in the state so far,death,7,4,14,0,25,punjab
7/6/10,https://reliefweb.int/node/360264,- ¬† ¬† ¬† ¬†total 48 human deaths have been reported in the state so far,death,7,4,14,0,25,punjab
7/5/10,https://reliefweb.int/node/360195,- ¬† ¬† ¬† ¬†total 05 human deaths have been reported in the state so far,death,7,4,14,0,25,punjab
7/5/10,https://reliefweb.int/node/360195,- ¬† ¬† ¬† ¬†total 46 human deaths have been reported in the state so far,death,7,4,14,0,25,punjab
7/4/10,https://reliefweb.int/node/360232,- ¬† ¬† ¬† ¬†total 05 human deaths have been reported in the state so far,death,7,4,14,0,25,punjab
7/4/10,https://reliefweb.int/node/360232,- ¬† ¬† ¬† ¬†total 37 human deaths have been reported in the state so far,death,7,4,14,0,25,punjab
7/3/10,https://reliefweb.int/node/360255,- ¬† ¬† ¬† ¬†total 05 human deaths have been reported in the state so far,death,7,6,15,0,28,punjab
7/3/10,https://reliefweb.int/node/360255,- ¬† ¬† ¬† ¬†total 37 human deaths have been reported in the state so far,death,7,6,15,0,28,punjab
7/2/10,https://reliefweb.int/node/360081,- total 05 human deaths have been reported in the state so far,death,7,6,15,0,28,punjab
7/2/10,https://reliefweb.int/node/360081,- total 37 human deaths have been reported in the state so far,death,7,6,15,0,28,punjab
7/1/10,https://reliefweb.int/node/359848,- ¬† ¬† ¬† ¬†total 05 human deaths have been reported in the state so far,death,7,5,14,0,26,punjab
7/1/10,https://reliefweb.int/node/359848,- ¬† ¬† ¬† ¬†total 37 human deaths have been reported in the state so far,death,7,5,14,0,26,punjab
6/30/10,https://reliefweb.int/node/359918,- ¬† ¬† ¬† ¬†total 05 human deaths have been reported in the state so far,death,7,7,14,0,28,punjab
6/30/10,https://reliefweb.int/node/359918,- ¬† ¬† ¬† ¬†total 37 human deaths have been reported in the state so far,death,7,7,14,0,28,punjab
6/29/10,https://reliefweb.int/node/359891,- ¬† ¬† ¬† ¬†total 04 human deaths have been reported in the state so far,death,5,7,14,0,26,punjab
6/29/10,https://reliefweb.int/node/359891,- ¬† ¬† ¬† ¬†total 35 human deaths have been reported in the state so far,death,5,7,14,0,26,punjab
6/28/10,https://reliefweb.int/node/359938,- ¬† ¬† ¬† ¬†total 04 human deaths have been reported in the state so far,death,3,4,5,0,12,punjab
6/3/10,https://reliefweb.int/node/359948,- ¬† ¬† ¬† ¬†04 human deaths have been reported in the state so far,death,1,2,14,0,17,punjab
9/11/09,https://reliefweb.int/node/324281,"human deaths - as per provisional information received from the affected states/uts, 13 human deaths have been reported from states of bihar, uttar pradesh & west bengal, thus raising the total death toll to 1012 from 999",death,5,0,3,0,8,punjab
9/10/09,https://reliefweb.int/node/324067,"human deaths - as per provisional information received from the affected states/uts, 04 human deaths have been reported from states of uttar pradesh & west bengal, thus raising the total death toll to 999 from 995",death,4,0,2,0,6,punjab
9/3/09,https://reliefweb.int/node/323143,"human deaths - as per provisional information received from the affected states/uts, 27 human deaths {uttarakhand -21(18 persons missing in pithoragarh landslide have been included in the death list by the state of uttarakhand), uttar pradesh -03, punjab -02 and west bengal -01} have been reported, thus raising the total death toll to 967 from 939",death,8,4,2,0,14,punjab
8/18/09,https://reliefweb.int/node/320992,- total 06 human deaths have been reported in the state so far,death,17,11,32,0,60,sas nagar
8/18/09,https://reliefweb.int/node/320992,- total 07 human deaths have been reported in the state so far,death,17,11,32,0,60,sas nagar
8/18/09,https://reliefweb.int/node/320992,- total 56 human deaths have been reported in the state so far,death,17,11,32,0,60,sas nagar
8/18/09,https://reliefweb.int/node/320992,- 123 human deaths have been reported in the state so far,death,17,11,32,0,60,sas nagar
8/18/09,https://reliefweb.int/node/320992,- 82 human deaths have been reported in the state so far,death,17,11,32,0,60,sas nagar
8/18/09,https://reliefweb.int/node/320992,- 109 human deaths have been reported so far in the state,death,17,11,32,0,60,sas nagar
8/18/09,https://reliefweb.int/node/320992,"human deaths - as per provisional information received from the affected states/uts, 02 human deaths (assam-01 & punjab-01) have been reported, thus raising the total death toll to 703 from 701",death,17,11,32,0,60,sas nagar
8/5/09,https://reliefweb.int/node/319788, - 01 human death has been reported during last 24 hours,death,19,14,43,0,76,punjab
8/5/09,https://reliefweb.int/node/319788,"human deaths - as per provisional information received from the affected states/uts, 09 human deaths (tamil nadu-04, madhya pradesh-02, kerala, punjab and west bengal-01 each) have been reported, thus raising the total death toll to 636 from 627",death,19,14,43,0,76,punjab
7/29/09,https://reliefweb.int/node/318915, - 04 human deaths have been reported during last 24 hours,death,15,17,38,0,70,punjab
7/29/09,https://reliefweb.int/node/318915," human deaths  - as per provisional information received from the affected states/uts, 26 human deaths (uttarakhand-19, kerala-04, punjab-02 & gujarat-01) have been reported, thus raising the total death toll to 555 from 529",death,15,17,38,0,70,punjab
9/21/08,https://reliefweb.int/node/281535,- 13 human deaths have been reported in the state during last 24 hours,death,47,29,84,0,160,sas nagar
9/21/08,https://reliefweb.int/node/281535,- no human death has been reported by the state during last 24 hours,death,47,29,84,0,160,sas nagar
9/21/08,https://reliefweb.int/node/281535,- no human death has been reported in the state during last 24 hours,death,47,29,84,0,160,sas nagar
9/21/08,https://reliefweb.int/node/281535,- 02 human deaths have been reported by the state during last 24 hours,death,47,29,84,0,160,sas nagar
9/21/08,https://reliefweb.int/node/281535,- 04 human deaths have been reported by the state today,death,47,29,84,0,160,sas nagar
9/21/08,https://reliefweb.int/node/281535,the total human death toll of the state is 216,death,47,29,84,0,160,sas nagar
9/21/08,https://reliefweb.int/node/281535,- 82 human deaths have been reported by the state which includes information of more than 24 hours in respect of some districts,death,47,29,84,0,160,sas nagar
9/21/08,https://reliefweb.int/node/281535,"human deaths - as per provisional information received from the affected states/uts, 135 human deaths were reported, raising the total death toll to 2364 from 2210 during the last 48 hours",death,47,29,84,0,160,sas nagar
9/20/08,https://reliefweb.int/node/281294,- 13 human deaths have been reported by the state during last 48 hours,death,46,21,89,0,156,punjab
9/20/08,https://reliefweb.int/node/281294,- no human death has been reported in the state during last 24 hours,death,46,21,89,0,156,punjab
9/20/08,https://reliefweb.int/node/281294,the total human death toll of the state is 212,death,46,21,89,0,156,punjab
9/20/08,https://reliefweb.int/node/281294,- no human death has been reported by the state during last 24 hours,death,46,21,89,0,156,punjab
9/20/08,https://reliefweb.int/node/281294,"human deaths - as per provisional information received from the affected states/uts, 19 human deaths were reported, raising the total death toll to 2229 from 2210",death,46,21,89,0,156,punjab
9/9/08,https://reliefweb.int/node/279984,the reported death toll reads 84,death,30,8,38,7,83,punjab
9/7/08,https://reliefweb.int/node/279521,- 06 human deaths have been reported by the state during last 24 hours,death,25,11,42,0,78,punjab
9/7/08,https://reliefweb.int/node/279521,the total human death toll of the state is 78,death,25,11,42,0,78,punjab
9/7/08,https://reliefweb.int/node/279521,"human deaths  - as per provisional information received from the affected states/uts, 08 human deaths (bihar -06 and kerala-02) were reported, raising the total death toll to 1884 to 1876",death,25,11,42,0,78,punjab
9/6/08,https://reliefweb.int/node/280844,- 03 human deaths have been reported by the state during last 24 hours,death,26,13,53,0,92,punjab
9/6/08,https://reliefweb.int/node/280844,the total human death toll of the state is 72,death,26,13,53,0,92,punjab
9/6/08,https://reliefweb.int/node/280844,- 07 human deaths have been reported by the state today,death,26,13,53,0,92,punjab
9/6/08,https://reliefweb.int/node/280844,"human deaths - as per provisional information received from the affected states/uts, 10 human deaths (uttar pradesh -07 and bihar -03) were reported, raising the total death toll to 1876 to 1866",death,26,13,53,0,92,punjab
9/3/08,https://reliefweb.int/node/278859,"with over 18.6 million people affected across india and 1,778 people killed, it has been a major blow to the country's economy and people",death,49,30,91,1,171,"amritsar, gurdaspur, hoshiarpur, jalandhar, kapurthala, moga, sas nagar"
9/3/08,https://reliefweb.int/node/278859,seven more deaths reported in the past 24 hours has taken the total death toll to 63,death,49,30,91,1,171,"amritsar, gurdaspur, hoshiarpur, jalandhar, kapurthala, moga, sas nagar"
9/1/08,https://reliefweb.int/node/278555,- 02 human deaths have been reported by the state during last 24 hours,death,38,19,78,0,135,punjab
9/1/08,https://reliefweb.int/node/278555,the total human death toll of the state is 56,death,38,19,78,0,135,punjab
9/1/08,https://reliefweb.int/node/278555,- 01 human death has been reported by the state during last 24 hours,death,38,19,78,0,135,punjab
9/1/08,https://reliefweb.int/node/278555,- no human death has been reported by the state during last 24 hours,death,38,19,78,0,135,punjab
9/1/08,https://reliefweb.int/node/278555,- in 4 cattle camps about 1775 cattle have been accommodated west bengal - heavy to very heavy rainfall with isolated extremely heavy falls has been reported in some parts of the state - 07 human deaths reported by the state during last 24 hours,death,38,19,78,0,135,punjab
9/1/08,https://reliefweb.int/node/278555,"human deaths - as per provisional information received from the affected states/uts, 08 human deaths (west bengal-07, bihar-02 & assam-01) were reported, raising the total death toll to 1746 from 1736",death,38,19,78,0,135,punjab
8/29/08,https://reliefweb.int/node/278448,"so far, 2.6 million people have been affected in the state and 47 people killed(1) since the breach occurred earlier this week",death,23,11,34,0,68,punjab
8/29/08,https://reliefweb.int/node/278448,of people killed 47 no,death,23,11,34,0,68,punjab
8/29/08,https://reliefweb.int/node/278448,"a total of 12 million people have been affected throughout the country this year and approximately 1,600 people have been killed in 19 states2 (himachal pradesh, andhra pradesh, uttar pradesh, uttarakhand, bihar, assam, jharkhand, west bengal, orissa, tamil nadu, kerala, karnataka, goa, maharashtra, madhya pradesh, gujarat, rajasthan, haryana and punjab).",death,23,11,34,0,68,punjab
8/27/08,https://reliefweb.int/node/278134, - 45 human deaths have been reported by the state during last 24 hours,death,25,9,55,0,89,ferozepur
8/27/08,https://reliefweb.int/node/278134,- 04 human deaths have been reported by the state during last 24 hours,death,25,9,55,0,89,ferozepur
8/27/08,https://reliefweb.int/node/278134,"human deaths - as per provisional information received from the affected states/uts, 50 human deaths (bihar -45, uttar pradesh -04 and maharashtra - 01) were reported, raising the total death toll to 1644 from 1594",death,25,9,55,0,89,ferozepur
8/26/08,https://reliefweb.int/node/278299,- 07 human deaths have been reported by the state during last 24 hours,death,33,9,56,0,98,"ferozepur, jalandhar, kapurthala, moga"
8/26/08,https://reliefweb.int/node/278299,- no human death has been reported by the state during last 24 hours,death,33,9,56,0,98,"ferozepur, jalandhar, kapurthala, moga"
8/26/08,https://reliefweb.int/node/278299,- 04 human deaths have been reported by the state during last 24 hours,death,33,9,56,0,98,"ferozepur, jalandhar, kapurthala, moga"
8/26/08,https://reliefweb.int/node/278299,- 01human death has been reported in the state during last 24 hours,death,33,9,56,0,98,"ferozepur, jalandhar, kapurthala, moga"
8/26/08,https://reliefweb.int/node/278299,"human deaths - as per provisional information received from the affected states/uts, 19 human deaths (gujarat & bihar-07 each, uttar pradesh-04, and west bengal-01) were reported, raising the total death toll to 1594 from 1575",death,33,9,56,0,98,"ferozepur, jalandhar, kapurthala, moga"
8/25/08,https://reliefweb.int/node/278295,- 04 human deaths have been reported by the state,death,21,4,42,0,67,"amritsar, kapurthala"
8/25/08,https://reliefweb.int/node/278295,- 02 human deaths have been reported by the state,death,21,4,42,0,67,"amritsar, kapurthala"
8/25/08,https://reliefweb.int/node/278295,"human deaths - as per provisional information received from the affected states/uts, 07 human deaths (uttar pradesh -04, bihar-02 and haryana -01) were reported during last 24 hours, raising the total death toll to 1575 from 1568",death,21,4,42,0,67,"amritsar, kapurthala"
8/24/08,https://reliefweb.int/node/278337,- 01 human death has been reported by the state during last 24 hours,death,23,11,51,0,85,punjab
8/24/08,https://reliefweb.int/node/278337,- no human death has been reported by the state during last 24 hours,death,23,11,51,0,85,punjab
8/24/08,https://reliefweb.int/node/278337,- no human death has been reported in the state during last 24 hours,death,23,11,51,0,85,punjab
8/24/08,https://reliefweb.int/node/278337,"human deaths - as per provisional information received from the affected states/uts, 05 human deaths were reported during last 24 hours, raising the total death toll to 1568 from 1563",death,23,11,51,0,85,punjab
8/23/08,https://reliefweb.int/node/278317,- 03 human deaths occurred earlier in the state reported today,death,23,6,48,0,77,kapurthala
8/23/08,https://reliefweb.int/node/278317,- no human death has been reported by the state during last 24 hours,death,23,6,48,0,77,kapurthala
8/23/08,https://reliefweb.int/node/278317,"human deaths - as per provisional information received from the affected states/uts, 03 human deaths (uttar pradesh) were reported during last 24 hours, raising the total death toll to 1563 from 1560",death,23,6,48,0,77,kapurthala
8/22/08,https://reliefweb.int/node/278298,- no human death has been reported by the state during last 24 hours,death,28,10,52,0,90,kapurthala
8/22/08,https://reliefweb.int/node/278298,- 50 human deaths occurred earlier in the state reported today,death,28,10,52,0,90,kapurthala
8/22/08,https://reliefweb.int/node/278298,- 03 human deaths have been reported in the state during last 24 hours,death,28,10,52,0,90,kapurthala
8/22/08,https://reliefweb.int/node/278298,"human deaths - as per provisional information received from the affected states/uts, 67 human deaths (uttar pradesh-50, gujarat-12, west bengal-03, mp & tamil nadu-01 each) were reported during last 24 hours, raising the total death toll to 1560 from 1493",death,28,10,52,0,90,kapurthala
8/21/08,https://reliefweb.int/node/277451,- 09 human deaths (06 deaths during last 24 hours & 03 deaths of earlier) have been reported by the state,death,24,5,35,0,64,"ferozepur, jalandhar, kapurthala, moga, sas nagar"
8/21/08,https://reliefweb.int/node/277451,- no human death has been reported by the state during last 24 hours,death,24,5,35,0,64,"ferozepur, jalandhar, kapurthala, moga, sas nagar"
8/21/08,https://reliefweb.int/node/277451,- 41 human deaths occurred earlier in the state reported today,death,24,5,35,0,64,"ferozepur, jalandhar, kapurthala, moga, sas nagar"
8/21/08,https://reliefweb.int/node/277451,- 01 human death has been reported by the state during last 24 hours,death,24,5,35,0,64,"ferozepur, jalandhar, kapurthala, moga, sas nagar"
8/21/08,https://reliefweb.int/node/277451,- 03 human deaths have been reported in the state during last 24 hours,death,24,5,35,0,64,"ferozepur, jalandhar, kapurthala, moga, sas nagar"
8/21/08,https://reliefweb.int/node/277451,"human deaths - as per provisional information received from the affected states/uts, 62 human deaths (uttar pradesh -41, maharashtra -08, punjab -09, west bengal -03 and bihar -01) were reported during last 24 hours, raising the total death toll to 1493 from 1431",death,24,5,35,0,64,"ferozepur, jalandhar, kapurthala, moga, sas nagar"
8/21/08,https://reliefweb.int/node/277239,"as a result, more than 300 people are reported to have died in different parts of andhra pradesh and orissa",death,16,19,28,1,64,punjab
8/20/08,https://reliefweb.int/node/277545,- no human deaths have been reported by the state during last 24 hours,death,24,2,31,0,57,"ferozepur, jalandhar, kapurthala, moga"
8/20/08,https://reliefweb.int/node/277545,- no human death has been reported by the state during last 24 hours,death,24,2,31,0,57,"ferozepur, jalandhar, kapurthala, moga"
8/20/08,https://reliefweb.int/node/277545,- no human death has been reported in the state during last 24 hours,death,24,2,31,0,57,"ferozepur, jalandhar, kapurthala, moga"
8/20/08,https://reliefweb.int/node/277545,- 19 human deaths occurred earlier in the state reported today,death,24,2,31,0,57,"ferozepur, jalandhar, kapurthala, moga"
8/20/08,https://reliefweb.int/node/277545,assam - heavy to very heavy rainfall with isolated extremely heavy falls has been reported in a few parts of the state - 01 old human death reported by the state,death,24,2,31,0,57,"ferozepur, jalandhar, kapurthala, moga"
8/20/08,https://reliefweb.int/node/277545,- no human deaths have been reported in the state during last 24 hours,death,24,2,31,0,57,"ferozepur, jalandhar, kapurthala, moga"
8/20/08,https://reliefweb.int/node/277545,"human deaths - as per provisional information received from the affected states/uts, 20 human deaths (uttar pradesh -19 and assam -01) which occurred earlier in these states but reported today thereby raising the total death toll to 1431 from 1411",death,24,2,31,0,57,"ferozepur, jalandhar, kapurthala, moga"
8/19/08,https://reliefweb.int/node/277180,- 20 human deaths occurred earlier in the state but reported today,death,29,6,63,0,98,"ferozepur, jalandhar, kapurthala, moga"
8/19/08,https://reliefweb.int/node/277180,- no human death has been reported by the state during last 24 hours,death,29,6,63,0,98,"ferozepur, jalandhar, kapurthala, moga"
8/19/08,https://reliefweb.int/node/277180,"human deaths - as per provisional information received from the affected states/uts, 26 human deaths (uttar pradesh -20, orissa- 03, kerala -02 and rajasthan -01) were reported during last 24 hours, raising the total death toll to 1411 from 1385",death,29,6,63,0,98,"ferozepur, jalandhar, kapurthala, moga"
8/18/08,https://reliefweb.int/node/277200,"india: 19 dead in punjab, haryana floods  chandigarh: heavy rain claimed three more lives taking the toll to 19 in the region on monday as water began receding in rivers passing through punjab and haryana giving respite to over 150 villages",death,6,2,9,0,17,"ferozepur, gurdaspur, jalandhar, moga"
8/18/08,https://reliefweb.int/node/277023,- 18 human deaths have been reported by the state during last 24 hours,death,33,6,50,0,89,"ferozepur, jalandhar, kapurthala, moga"
8/18/08,https://reliefweb.int/node/277023,- 10 army columns with 10 engineer task forces have been deployed in the flood affected areas for rescue and relief operations delhi - light rainfall has been reported in delhi and ncr during last 24 hours - no human death has been reported by the state during last 24 hours,death,33,6,50,0,89,"ferozepur, jalandhar, kapurthala, moga"
8/18/08,https://reliefweb.int/node/277023,- 02 human deaths have been reported by the state during last 24 hours,death,33,6,50,0,89,"ferozepur, jalandhar, kapurthala, moga"
8/18/08,https://reliefweb.int/node/277023,- no human death has been reported by the state during last 24 hours,death,33,6,50,0,89,"ferozepur, jalandhar, kapurthala, moga"
8/18/08,https://reliefweb.int/node/277023,- no human death has been reported in the state during last 24 hours,death,33,6,50,0,89,"ferozepur, jalandhar, kapurthala, moga"
8/18/08,https://reliefweb.int/node/277023,- 73 human deaths occurred earlier in the state but reported today,death,33,6,50,0,89,"ferozepur, jalandhar, kapurthala, moga"
8/18/08,https://reliefweb.int/node/277023,- 02 human deaths have been reported in the state during last 24 hours,death,33,6,50,0,89,"ferozepur, jalandhar, kapurthala, moga"
8/18/08,https://reliefweb.int/node/277023,"human deaths - as per provisional information received from the affected states/uts, 103 human deaths were reported during last 24 hours, raising the total death toll to 1385 from 1282",death,33,6,50,0,89,"ferozepur, jalandhar, kapurthala, moga"
8/17/08,https://reliefweb.int/node/276987,- 02 human deaths have been reported by the state,death,32,2,42,0,76,moga
8/17/08,https://reliefweb.int/node/276987,- no human death has been reported by the state during last 24 hours,death,32,2,42,0,76,moga
8/17/08,https://reliefweb.int/node/276987,"human deaths - as per provisional information received from the affected states/uts, 02 human deaths were reported from punjab state during last 24 hours, raising the total death toll to 1282 from 1280",death,32,2,42,0,76,moga
8/16/08,https://reliefweb.int/node/277005,- no human death has been reported by the state during last 24 hours,death,31,3,36,0,70,punjab
8/16/08,https://reliefweb.int/node/277005,haryana - heavy to very heavy rainfall with isolated extremely falls has been reported in most parts of the state/ - no human death has been reported by the state during last 24 hours,death,31,3,36,0,70,punjab
8/16/08,https://reliefweb.int/node/277005,- no human death has been reported in the state during last 24 hours,death,31,3,36,0,70,punjab
8/16/08,https://reliefweb.int/node/277005,"human deaths - as per provisional information received from the affected states/uts, 04 human deaths were reported from uttarakhand state during last 24 hours, raising the total death toll to 1280 from 1276",death,31,3,36,0,70,punjab
8/15/08,https://reliefweb.int/node/277055,- 01 human death has been reported in the state,death,29,5,41,0,75,punjab
8/15/08,https://reliefweb.int/node/277055,- 15 human deaths have been reported in the state during last 24 hours,death,29,5,41,0,75,punjab
8/15/08,https://reliefweb.int/node/277055,- 02 human deaths have been reported in the state,death,29,5,41,0,75,punjab
8/15/08,https://reliefweb.int/node/277055,- 11 human deaths have been reported in the state during last 24 hours,death,29,5,41,0,75,punjab
8/15/08,https://reliefweb.int/node/277055,"human deaths - as per provisional information received from the affected states/uts, 32 human deaths (andhra pradesh -15, west bengal-11, kerala & maharashtra -02 each and goa & karnataka - 01 each) were reported during last 24 hours, raising the total death toll to 1276 from 1244",death,29,5,41,0,75,punjab
8/14/08,https://reliefweb.int/node/276931,- 14 human deaths have been reported in the state from 12.08.2008 to 14.08.2008,death,33,3,38,0,74,mansa
8/14/08,https://reliefweb.int/node/276931,- no human deaths have been reported in the state during last 24 hours,death,33,3,38,0,74,mansa
8/14/08,https://reliefweb.int/node/276931,- 13 human deaths have been reported in the state during last 24 hours,death,33,3,38,0,74,mansa
8/14/08,https://reliefweb.int/node/276931,- no human death has been reported in the state during last 24 hours,death,33,3,38,0,74,mansa
8/14/08,https://reliefweb.int/node/276931,- 01 human death has been reported in the state during last 24 hours,death,33,3,38,0,74,mansa
8/14/08,https://reliefweb.int/node/276931,- 06 human deaths have been reported by the state during last 24 hours,death,33,3,38,0,74,mansa
8/14/08,https://reliefweb.int/node/276931,"human deaths - as per provisional information received from the affected states/uts, 37 human deaths (gujarat-14, karnataka-13, uttar pradesh-6, kerala-2 and bihar & maharashtra-1 each) were reported during last 24 hours, raising the total death toll to 1244 from 1207",death,33,3,38,0,74,mansa
8/9/08,https://reliefweb.int/node/275899,- no human death has been reported in the state during last 24 hours,death,21,3,33,0,57,punjab
8/9/08,https://reliefweb.int/node/275899,- no human death has been reported by the state during last 24 hours,death,21,3,33,0,57,punjab
8/9/08,https://reliefweb.int/node/275899,"human deaths - as per provisional information received from the affected states/uts, 08 human deaths (himachal pradesh-07 (previous deaths reported today) and punjab -01) were reported during last 24 hours, raising the total death toll to 1054 from 1046",death,21,3,33,0,57,punjab
6/16/08,https://reliefweb.int/node/270161,the official death count was four in the state,death,15,16,10,0,41,jalandhar
6/16/08,https://reliefweb.int/node/270161,"six persons were killed in separate incidents in uttar pradesh due to heavy rainfall since sunday, taking the toll of rain-related deaths this season to 12",death,15,16,10,0,41,jalandhar
6/16/08,https://reliefweb.int/node/270161,a woman drowned and five houses were damaged in doda and reasi districts of jammu and kashmir following heavy rains and flash floods,death,15,16,10,0,41,jalandhar
6/16/08,https://reliefweb.int/node/270161,a woman along with her son died in house collapse last night in jalandhar while three persons were killed and two injured when lightning struck them at a village in bihar's banka district.,death,15,16,10,0,41,jalandhar
10/2/07,https://reliefweb.int/node/245244," loss of human lives as per provisional information received from the affected states, 07 human deaths have been reported during the last 24 hrs",death,6,3,20,0,29,punjab
8/18/07,https://reliefweb.int/node/240663,"out of the missing, dead bodies of only 08 persons have been recovered so far",death,23,16,57,0,96,"roopnagar, sangrur, sas nagar"
8/18/07,https://reliefweb.int/node/240663, - 02 human deaths have been reported in the state during last 24 hours,death,23,16,57,0,96,"roopnagar, sangrur, sas nagar"
8/18/07,https://reliefweb.int/node/240663, - 03 human deaths (lakhimpur kheri -02 and jp nagar -01) have been reported in the state during last 24 hours,death,23,16,57,0,96,"roopnagar, sangrur, sas nagar"
8/18/07,https://reliefweb.int/node/240663,- 03 human deaths have been reported in the state during last 24 hours,death,23,16,57,0,96,"roopnagar, sangrur, sas nagar"
8/18/07,https://reliefweb.int/node/240663, - 06 human deaths have been reported in the state during last 24 hours,death,23,16,57,0,96,"roopnagar, sangrur, sas nagar"
8/18/07,https://reliefweb.int/node/240663,"loss of human lives - as per provisional information received from the affected states, 14 human deaths have been reported during the last 24 hrs",death,23,16,57,0,96,"roopnagar, sangrur, sas nagar"
8/17/07,https://reliefweb.int/node/240777,"out of the missing, dead bodies of only 08 persons have been recovered so far",death,24,11,61,0,96,"roopnagar, sangrur, sas nagar"
8/17/07,https://reliefweb.int/node/240777,"loss of human lives - as per provisional information received from the affected states, 32 human deaths have been reported during the last 24 hrs",death,24,11,61,0,96,"roopnagar, sangrur, sas nagar"
7/17/07,https://reliefweb.int/node/244592,"loss of human lives -as per provisional information received from the affected states 33 human deaths (kerala-14, gujarat & maharashtra 06 each, karnataka & punjab-2 each, madhya pradesh, chhattisgarh & west bengal-01 each) have been reported during the last 24 hrs",death,5,10,22,0,37,punjab
10/21/19,https://www.tribuneindia.com/news/punjab/flood-hit-farmers-to-get-9k-quintal-wheat-seed/849947.html,"jalandhar, october 20  in a major initiative aimed at providing succour to farmers of flood-affected villages in the district, the punjab government will distribute around 9,000 quintals of high-yielding varieties of wheat seeds to food growers free of cost",lives,2,43,10,1,56,jalandhar
10/21/19,https://www.tribuneindia.com/news/punjab/flood-hit-farmers-to-get-9k-quintal-wheat-seed/849947.html,"he said in total, 25,000 quintals of wheat seeds would be supplied to farmers in flood-affected villages across the state",lives,2,43,10,1,56,jalandhar
10/21/19,https://www.tribuneindia.com/news/punjab/flood-hit-farmers-to-get-9k-quintal-wheat-seed/849947.html,"he said of this, nearly 9,000 quintals of seeds would be distributed to farmers who had suffered losses during floods in the sutlej",lives,2,43,10,1,56,jalandhar
10/16/19,https://www.tribuneindia.com/news/punjab/debt-relief-likely-for-flood-hit-farmers/847607.html," according to a proposal, farmers in 14 districts (794 villages) of the state, whose standing crops were damaged in the floods that occurred in august, would be able to repay the crop loans that they took in april this year within the next three years",lives,2,64,14,0,80,punjab
10/16/19,https://www.tribuneindia.com/news/punjab/debt-relief-likely-for-flood-hit-farmers/847607.html,"ush({ });  according to estimates prepared by the revenue department, which conducted a special girdawari to assess the crop losses, paddy worth rs 507 crore on 51,364 hectares, maize on 5,553 hectares and sugarcane on 863 hectares, besides fruits and vegetables on 1,304 on 1,306 hectares was damaged in the floods",lives,2,64,14,0,80,punjab
10/14/19,https://www.tribuneindia.com/news/punjab/no-wheat-seed-disbursal-farmers-livid/846770.html,"aparna banerji tribune news service jalandhar, october 13  the free of cost wheat seed disbursal in 13 villages of kapurthala has been hit due to the election code of conduct for the phagwara bypolls",lives,3,78,9,2,92,"jalandhar, kapurthala"
10/14/19,https://www.tribuneindia.com/news/punjab/no-wheat-seed-disbursal-farmers-livid/846770.html,the government‚Äôs decision to disburse wheat seed to flood-affected villagers from october 21 (after the phagwara bypolls) has earned them farming community‚Äôs ire,lives,3,78,9,2,92,"jalandhar, kapurthala"
10/14/19,https://www.tribuneindia.com/news/punjab/farmers-in-flood-affected-areas-to-get-free-wheat-seed/846749.html,"tribune news service  moga, october 13 the state government will provide high-quality wheat crop seeds to flood-hit farmers in moga, jalandhar, kapurthala, ferozepur, fazilka and other flood-affected districts for the upcoming rabi season",lives,2,54,11,3,70,"fazilka, ferozepur, jalandhar, kapurthala, moga"
10/14/19,https://www.tribuneindia.com/news/punjab/farmers-in-flood-affected-areas-to-get-free-wheat-seed/846749.html,"ush({ });as per details available, 30,000 hectares land was affected by the floods",lives,2,54,11,3,70,"fazilka, ferozepur, jalandhar, kapurthala, moga"
10/14/19,https://www.tribuneindia.com/news/punjab/farmers-in-flood-affected-areas-to-get-free-wheat-seed/846749.html,"‚Äúthe total cost of seed requirement in the state has been estimated at rs 9-crore,‚Äù dr pannu said",lives,2,54,11,3,70,"fazilka, ferozepur, jalandhar, kapurthala, moga"
10/14/19,https://www.tribuneindia.com/news/punjab/farmers-in-flood-affected-areas-to-get-free-wheat-seed/846749.html,"the quality seed of wheat crop costs around rs 3,000 per quintal",lives,2,54,11,3,70,"fazilka, ferozepur, jalandhar, kapurthala, moga"
10/14/19,https://www.tribuneindia.com/news/punjab/farmers-in-flood-affected-areas-to-get-free-wheat-seed/846749.html,"meanwhile, chief agriculture officer, moga, dr balwinder singh, and plant protection officer dr jaswinder singh brar said 7,000 hectares was affected by the floods in the district",lives,2,54,11,3,70,"fazilka, ferozepur, jalandhar, kapurthala, moga"
10/10/19,https://www.tribuneindia.com/news/punjab/no-festive-cheer-flood-hit-areas-grapple-with-gloom/844861.html,he has two acres of land along with two more on lease but the crop has been destroyed,lives,3,15,13,2,33,jalandhar
10/4/19,https://www.tribuneindia.com/news/punjab/drone-threat-mustn-t-be-linked-with-gurpurb-cm/842199.html,"the state government was dealing with the matter and was geared to maintain law and order in punjab at any cost, he said, adding, ‚Äúwe will not allow anyone to disturb the state‚Äôs peace and harmony",lives,0,0,1,2,3,punjab
10/4/19,https://www.tribuneindia.com/news/punjab/drone-threat-mustn-t-be-linked-with-gurpurb-cm/842199.html,"in a proposal to the pm, he suggested construction of high-speed economic corridors on the 985-km-long river embankments, apart from river training works, flood protection measures and lining of internal side-slopes of the sutlej, ravi and beas",lives,0,0,1,2,3,punjab
10/3/19,https://www.tribuneindia.com/news/punjab/capt-meets-modi-proposes-canalisation-of-punjab-s-major-rivers/842061.html,"tribune news service   new delhi, october 3   punjab chief minister captain amarinder singh on thursday urged the central government to take up canalisation of the state‚Äôs three eastern rivers of the indus water system as a national project, to enable conservation of water and enhancement of the region‚Äôs economic growth",lives,2,2,3,6,13,punjab
10/3/19,https://www.tribuneindia.com/news/punjab/capt-meets-modi-proposes-canalisation-of-punjab-s-major-rivers/842061.html,"  in his proposal presented to prime minister narendra modi during a meeting here, the chief minister suggested construction of high-speed economic corridors on 985 km long river embankments, apart from river training works, flood protection measures and lining of internal side-slopes of the sutlej, ravi and beas",lives,2,2,3,6,13,punjab
10/3/19,https://www.tribuneindia.com/news/punjab/capt-meets-modi-proposes-canalisation-of-punjab-s-major-rivers/842061.html,"pointing out that the three rivers as of now have kutcha (earthen) embankments, measuring 945.24 km; (sutlej 484.12 km, ravi 245.28 km and beas 215.84 km), covering almost over 60 per cent of state‚Äôs area, he observed that the 1/3rd of the state‚Äôs population living in the riverfront areas was also suffering due to the flooding that occurs during the monsoon period",lives,2,2,3,6,13,punjab
9/28/19,https://www.tribuneindia.com/news/punjab/no-contamination-in-flood-hit-areas/839260.html,"it is estimated that contamination has affected only the upper strata, especially up to 150-200 feet deep",lives,2,2,18,0,22,jalandhar
9/22/19,https://www.tribuneindia.com/news/punjab/flood-of-troubles-for-teacherless-schools/836127.html,"aakanksha n bhardwaj tribune news service jalandhar, september 21  students at government primary school, mehrajwala, in lohian block of the district have been badly affected ever since floods ravaged the area",lives,2,1,3,0,6,jalandhar
9/19/19,https://www.tribuneindia.com/news/punjab/flood-leaves-white-layer-in-fields-of-muktsar/834669.html,"similarly, the government will give a compensation of rs 95,000 against house damage",lives,4,29,15,2,50,sri muktsar sahib
9/18/19,https://www.tribuneindia.com/news/punjab/akalis-for-release-of-sikh-prisoners/834054.html," the committee demanded rs 25,000 per acre as compensation for the crop loss or damage and a matching grant to farm labourers affected by the floods",lives,2,7,9,3,21,punjab
9/17/19,https://www.tribuneindia.com/news/punjab/450-dengue-cases-reported-flood-hit-areas-vulnerable/833510.html,punjab is one of the worst affected states in the country,lives,6,1,8,0,15,jalandhar
9/17/19,https://www.tribuneindia.com/news/punjab/450-dengue-cases-reported-flood-hit-areas-vulnerable/833510.html," one dengue case has been reported from flood-affected mandala village, forcing medical teams to get to their toes as doctors are seeing danger ahead",lives,6,1,8,0,15,jalandhar
9/17/19,https://www.tribuneindia.com/news/punjab/450-dengue-cases-reported-flood-hit-areas-vulnerable/833510.html, the victim has been identified as manjit kaur (30),lives,6,1,8,0,15,jalandhar
9/17/19,https://www.tribuneindia.com/news/punjab/450-dengue-cases-reported-flood-hit-areas-vulnerable/833510.html," a senior doctor said a survey was done to check the breeding of mosquitoes in the flood-affected areas earlier, but no disease-causing breed was found",lives,6,1,8,0,15,jalandhar
9/17/19,https://www.tribuneindia.com/news/punjab/450-dengue-cases-reported-flood-hit-areas-vulnerable/833510.html," now, a survey will be done in the village and it will be checked if anyone else is suffering from dengue",lives,6,1,8,0,15,jalandhar
9/17/19,https://www.tribuneindia.com/news/punjab/450-dengue-cases-reported-flood-hit-areas-vulnerable/833510.html," on the precautions to be taken, smo dr as duggal said if anybody was suffering from fever for three-four days, they must visit their nearby medical camp",lives,6,1,8,0,15,jalandhar
9/14/19,https://www.tribuneindia.com/news/punjab/parties-spar-over-drugs-economic-slump/832152.html,he claimed that thousands of educated youth were being rendered jobless daily due to the economic crisis,lives,1,8,1,6,16,"amritsar, fatehgarh sahib, ludhiana, patiala, sangrur"
9/14/19,https://www.tribuneindia.com/news/punjab/jalandhar-kapurthala-losses-pegged-at-rs-526-cr/832145.html," in jalandhar, the divisional commissioner and deputy commissioner sought compensation of rs 224 crore for agricultural losses, rs 78.25 lakh for loss of animals and provision of fodder, rs 15 crore for damage to more than 3,000 houses in 29 villages, rs 20 crore for plugging breaches and for further strengthening embankments, rs 7 crore for repair of the 83-km link road, rs 1.50 crore for repair of 15 down feeders, 200 transformers and a 66-kv sub-station at mehrajwala besides rs 1 crore for the repair of water works in flood-affected villages",lives,2,58,49,4,113,"jalandhar, kapurthala"
9/14/19,https://www.tribuneindia.com/news/punjab/jalandhar-kapurthala-losses-pegged-at-rs-526-cr/832145.html," additionally, the dc sought rs 4 lakh for gratuitous loss due to the floods, rs 30 lakh for search, rescue and temporary shelters in flood-affected villages, rs 80 lakh for temporary accommodation, food and water and rs 15 lakh for clearing attached areas",lives,2,58,49,4,113,"jalandhar, kapurthala"
9/14/19,https://www.tribuneindia.com/news/punjab/jalandhar-kapurthala-losses-pegged-at-rs-526-cr/832145.html,"ush({ });  in kapurthala, crop losses have been pegged at rs 160 crore which includes rs 60 crore for bandh repairs and rs 85 lakh for damaged roads and houses, including 1,618 cattle deaths",lives,2,58,49,4,113,"jalandhar, kapurthala"
9/14/19,https://www.tribuneindia.com/news/punjab/jalandhar-kapurthala-losses-pegged-at-rs-526-cr/832145.html,"due to the polluted water, three crops of farmers have been lost",lives,2,58,49,4,113,"jalandhar, kapurthala"
9/14/19,https://www.tribuneindia.com/news/punjab/jalandhar-kapurthala-losses-pegged-at-rs-526-cr/832145.html," telling numbers  total loss¬† rs 526 crore¬† total land submerged¬†75,000 acres¬† total crop loss¬† rs 384 crore¬† breach/bandh repair¬†¬† rs 80 crore¬† animal, fodder loss¬† rs 78.25 lakh damage to houses in jalandhar¬† rs 15 crore¬† link road repair (jalandhar)¬† rs 7 crore¬† ",lives,2,58,49,4,113,"jalandhar, kapurthala"
9/13/19,https://www.tribuneindia.com/news/punjab/200-duty-hits-cement-importers-hard/831690.html,"ush({ });  the cement demand was at its peak in india after the modi government announced rs 5,000-crore rehabilitation projects for the flood-hit kerala",lives,0,2,4,4,10,amritsar
9/13/19,https://www.tribuneindia.com/news/punjab/200-duty-hits-cement-importers-hard/831690.html,  chatha said a bag of pakistani cement normally used to cost between rs 250-rs 300 after paying normal duty,lives,0,2,4,4,10,amritsar
9/13/19,https://www.tribuneindia.com/news/punjab/fight-over-ration-hits-relief/831670.html,"aparna banerji tribune news service jalandhar, september 12  the flood relief operations have been hit in the affected areas with some bogus beneficiaries attacking activists and volunteers over ration and other material",lives,8,4,30,0,42,"jalandhar, kapurthala"
9/13/19,https://www.tribuneindia.com/news/punjab/fight-over-ration-hits-relief/831670.html," recently, volunteers of two organisations distributing relief material were attacked and several videos of altercations went viral",lives,8,4,30,0,42,"jalandhar, kapurthala"
9/13/19,https://www.tribuneindia.com/news/punjab/fight-over-ration-hits-relief/831670.html," with 1000s of trailers containing the relief material continue to flood villages, some people queuing up and picking up fights for the ration has plagued the efforts",lives,8,4,30,0,42,"jalandhar, kapurthala"
9/13/19,https://www.tribuneindia.com/news/punjab/state-pitches-for-aid-as-central-team-visits-flood-affected-areas/831669.html,the team during its two-day visit will assess the damage caused in the wake of the floods in 11 districts of punjab,lives,9,21,32,0,62,"amritsar, ferozepur, gurdaspur, jalandhar, kapurthala, ludhiana, moga, pathankot, roopnagar, sas nagar, sbs nagar, tarn taran"
9/13/19,https://www.tribuneindia.com/news/punjab/state-pitches-for-aid-as-central-team-visits-flood-affected-areas/831669.html," according to a report submitted by the district administration, 46,300 residents in 182 villages were affected while standing crop on 11,580 acres and 313 houses were damaged completely",lives,9,21,32,0,62,"amritsar, ferozepur, gurdaspur, jalandhar, kapurthala, ludhiana, moga, pathankot, roopnagar, sas nagar, sbs nagar, tarn taran"
9/13/19,https://www.tribuneindia.com/news/punjab/state-pitches-for-aid-as-central-team-visits-flood-affected-areas/831669.html,"other than this, 27 buildings of government schools, dispensaries and community centres and nine bridges have been damaged",lives,9,21,32,0,62,"amritsar, ferozepur, gurdaspur, jalandhar, kapurthala, ludhiana, moga, pathankot, roopnagar, sas nagar, sbs nagar, tarn taran"
9/13/19,https://www.tribuneindia.com/news/punjab/state-pitches-for-aid-as-central-team-visits-flood-affected-areas/831669.html,the farmers have suffered a loss of rs 14 crore,lives,9,21,32,0,62,"amritsar, ferozepur, gurdaspur, jalandhar, kapurthala, ludhiana, moga, pathankot, roopnagar, sas nagar, sbs nagar, tarn taran"
9/12/19,https://www.tribuneindia.com/news/punjab/punjab-govt-centre-team-meet-to-discuss-flood-damage-in-11-districts/831565.html,"punjab govt, centre team meet, to discuss flood damage in 11 districts",lives,0,8,13,0,21,"jalandhar, kapurthala, sbs nagar"
9/12/19,https://www.tribuneindia.com/news/punjab/punjab-govt-centre-team-meet-to-discuss-flood-damage-in-11-districts/831565.html,"tribune news service  chandigarh, september 12  the punjab government and inter-ministerial central team on thursday, held a meeting to discussed damage caused due to floods in punjab",lives,0,8,13,0,21,"jalandhar, kapurthala, sbs nagar"
9/12/19,https://www.tribuneindia.com/news/punjab/punjab-govt-centre-team-meet-to-discuss-flood-damage-in-11-districts/831565.html,"  the central team will head to ropar and nawanshahr to assess the damage caused by the floods from september 17-19, and will visit jalandhar and kapurthala on friday",lives,0,8,13,0,21,"jalandhar, kapurthala, sbs nagar"
9/12/19,https://www.tribuneindia.com/news/punjab/punjab-govt-centre-team-meet-to-discuss-flood-damage-in-11-districts/831226.html,"punjab govt, centre team meet, to discuss flood damage in 11 districts",lives,15,25,41,0,81,"amritsar, ferozepur, gurdaspur, jalandhar, kapurthala, ludhiana, moga, pathankot, sbs nagar, tarn taran"
9/12/19,https://www.tribuneindia.com/news/punjab/punjab-govt-centre-team-meet-to-discuss-flood-damage-in-11-districts/831226.html,"ruchika m khanna  tribune news service  chandigarh, september 12    the punjab government and inter-ministerial central team on thursday, held a meeting to discuss damage caused due to floods in punjab",lives,15,25,41,0,81,"amritsar, ferozepur, gurdaspur, jalandhar, kapurthala, ludhiana, moga, pathankot, sbs nagar, tarn taran"
9/12/19,https://www.tribuneindia.com/news/punjab/punjab-govt-centre-team-meet-to-discuss-flood-damage-in-11-districts/831226.html,"  the central team will now head to ropar and nawanshahr to assess the damage caused by the floods from september 17-19, and will visit jalandhar and kapurthala on friday",lives,15,25,41,0,81,"amritsar, ferozepur, gurdaspur, jalandhar, kapurthala, ludhiana, moga, pathankot, sbs nagar, tarn taran"
9/12/19,https://www.tribuneindia.com/news/punjab/punjab-govt-centre-team-meet-to-discuss-flood-damage-in-11-districts/831226.html,"  the state government has suffered damages worth rs 1, 216.39 crore in 11 districts of the state because of the heavy discharge of water last month",lives,15,25,41,0,81,"amritsar, ferozepur, gurdaspur, jalandhar, kapurthala, ludhiana, moga, pathankot, sbs nagar, tarn taran"
9/12/19,https://www.tribuneindia.com/news/punjab/punjab-govt-centre-team-meet-to-discuss-flood-damage-in-11-districts/831226.html,"as many as six persons lost their lives, 1,400 suffered injuries, over 2,400 were evacuated from areas spread over 1 lakh acres and relief has been provided to over 1,530 families",lives,15,25,41,0,81,"amritsar, ferozepur, gurdaspur, jalandhar, kapurthala, ludhiana, moga, pathankot, sbs nagar, tarn taran"
9/12/19,https://www.tribuneindia.com/news/punjab/punjab-govt-centre-team-meet-to-discuss-flood-damage-in-11-districts/831226.html, standing paddy crop in 794 villages worth rs 506.06 crore; maize rs 31.82 crore; sugarcane rs 21.40 crore and horticulture crops worth rs 16.44 crore were damaged in floods,lives,15,25,41,0,81,"amritsar, ferozepur, gurdaspur, jalandhar, kapurthala, ludhiana, moga, pathankot, sbs nagar, tarn taran"
9/12/19,https://www.tribuneindia.com/news/punjab/punjab-govt-centre-team-meet-to-discuss-flood-damage-in-11-districts/831226.html," an estimate of damages in the districts of ropar, nawanshahr, jalandhar, kapurthala, ludhiana, moga, ferozepur, pathankot, gurdaspur, amritsar and tarn taran shows that 260 villages were affected by floods with even dairy and poultry suffering huge losses of nearly rs 1.78 crore",lives,15,25,41,0,81,"amritsar, ferozepur, gurdaspur, jalandhar, kapurthala, ludhiana, moga, pathankot, sbs nagar, tarn taran"
9/12/19,https://www.tribuneindia.com/news/punjab/punjab-govt-centre-team-meet-to-discuss-flood-damage-in-11-districts/831226.html," about 900 houses were damaged, 630 completely washed away, causing a total loss of rs 6.26 crore",lives,15,25,41,0,81,"amritsar, ferozepur, gurdaspur, jalandhar, kapurthala, ludhiana, moga, pathankot, sbs nagar, tarn taran"
9/12/19,https://www.tribuneindia.com/news/punjab/punjab-govt-centre-team-meet-to-discuss-flood-damage-in-11-districts/831226.html,"almost 2,871 km of link roads in villages, 417 km of highways and 75 bridges were washed away or damaged (loss rs 178.83 crore)",lives,15,25,41,0,81,"amritsar, ferozepur, gurdaspur, jalandhar, kapurthala, ludhiana, moga, pathankot, sbs nagar, tarn taran"
9/12/19,https://www.tribuneindia.com/news/punjab/punjab-govt-centre-team-meet-to-discuss-flood-damage-in-11-districts/831226.html,"initial assessment  6¬†persons died¬† 1,400¬†injured 2,400¬†evacuated 1,530¬†families¬†provided relief rs 506-crore¬†paddy crop damaged ",lives,15,25,41,0,81,"amritsar, ferozepur, gurdaspur, jalandhar, kapurthala, ludhiana, moga, pathankot, sbs nagar, tarn taran"
9/9/19,https://www.tribuneindia.com/news/punjab/little-efforts-a-life-saved/829769.html,he says one donation gives light to two people and even a person suffering from some disease can also donate eyes,lives,21,3,4,0,28,"amritsar, fatehgarh sahib, gurdaspur, patiala, sangrur"
9/9/19,https://www.tribuneindia.com/news/punjab/floods-hope-relations-washed-away/829761.html,"aakanksha n bhardwaj tribune news service jalandhar, september 8  floods have affected everything, including relations which are yet to be materialised",lives,14,14,23,2,53,jalandhar
9/9/19,https://www.tribuneindia.com/news/punjab/floods-hope-relations-washed-away/829761.html,the crop on two-acre land he owned and the other two acre which he had taken on lease has got destroyed due to the rain fury,lives,14,14,23,2,53,jalandhar
9/9/19,https://www.tribuneindia.com/news/punjab/floods-hope-relations-washed-away/829761.html, the sufferers said that no one else could have even a slight feeling of the problems these flood-affected villagers have been facing,lives,14,14,23,2,53,jalandhar
9/3/19,https://www.tribuneindia.com/news/punjab/gurusar-disburses-rs2-5-lakh-in-two-villages/826746.html,"tribune news service  muktsar, september 2  residents of gurusar village in gidderbaha subdivision yesterday disbursed rs 2.5 lakh among the flood-affected people of mandala channa and mundi chohlian villages in jalandhar district",lives,10,1,21,2,34,"jalandhar, sri muktsar sahib"
9/3/19,https://www.tribuneindia.com/news/punjab/gurusar-disburses-rs2-5-lakh-in-two-villages/826746.html,"we gave rs 1,000 each to the affected families of the two worst affected villages",lives,10,1,21,2,34,"jalandhar, sri muktsar sahib"
9/3/19,https://www.tribuneindia.com/news/punjab/gurusar-disburses-rs2-5-lakh-in-two-villages/826746.html, ‚Äúwe had to visit one more affected village but could not due to the inclement weather,lives,10,1,21,2,34,"jalandhar, sri muktsar sahib"
9/3/19,https://www.tribuneindia.com/news/punjab/rs-4-lakh-for-kin-of-victims/826745.html,rs 4 lakh for kin of victims,lives,10,22,20,2,54,fazilka
9/3/19,https://www.tribuneindia.com/news/punjab/rs-4-lakh-for-kin-of-victims/826745.html," the dc said after preliminary assessment it was found that the standing crops on nearly 6,810 acres have been damaged completely or partially in 19 villages of fazilka district",lives,10,22,20,2,54,fazilka
9/3/19,https://www.tribuneindia.com/news/punjab/rs-4-lakh-for-kin-of-victims/826745.html,"ush({ });  soon, relief for livestock loss  chandigarh: floods in punjab have taken a heavy toll on the livestock with the fall of 445 large animals/cattle, 90 pigs, 38 goats and 29,200 poultry birds, an official spokesman said",lives,10,22,20,2,54,fazilka
9/3/19,https://www.tribuneindia.com/news/punjab/rs-4-lakh-for-kin-of-victims/826745.html,at least 170 teams of vets have been constituted and 157 relief camps established,lives,10,22,20,2,54,fazilka
9/3/19,https://www.tribuneindia.com/news/punjab/rs-4-lakh-for-kin-of-victims/826745.html, ‚Äî tns      chhatwal added that seven medical teams have been pressed into service round the clock to examine the patients in flood-affected areas,lives,10,22,20,2,54,fazilka
9/3/19,https://www.tribuneindia.com/news/punjab/rs-4-lakh-for-kin-of-victims/826745.html,"besides, 18 veterinary teams have also been deployed to examine the livestock as about 1,300 animals have been affected due to floods",lives,10,22,20,2,54,fazilka
9/3/19,https://www.tribuneindia.com/news/punjab/rs-4-lakh-for-kin-of-victims/826745.html," soon, relief for livestock loss  chandigarh: floods in punjab have taken a heavy toll on the livestock with the fall of 445 large animals/cattle, 90 pigs, 38 goats and 29,200 poultry birds, an official spokesman said",lives,10,22,20,2,54,fazilka
9/3/19,https://www.tribuneindia.com/news/punjab/khalsa-aid-women-team-reaches-out-to-villagers/826742.html,"aparna banerji tribune news service malsian (jalandhar), september 2  among the 100 volunteers slugging it out day and night to prepare 25-kg relief kits for punjab‚Äôs flood hit at the khalsa aid warehouse in malsian, there is only one woman relentlessly putting in her bit",lives,6,3,12,0,21,"jalandhar, patiala, sas nagar"
9/3/19,https://www.tribuneindia.com/news/punjab/khalsa-aid-women-team-reaches-out-to-villagers/826742.html," while a majority of volunteers and members chipped in during their holidays and have now gone back, nazia (30), education coordinator with khalsa aid for the past two years, who was part of the very first batches of khalsa aid to begin relief in punjab, stays on at jalandhar",lives,6,3,12,0,21,"jalandhar, patiala, sas nagar"
9/3/19,https://www.tribuneindia.com/news/punjab/walls-collapsed-computers-furniture-covered-with-muck/826741.html,"deepkamal kaur tribune news service gidderpindi (jalandhar), september 2  half-yearly examinations in the government schools are scheduled to start next monday but the schools in the flood-affected village of lohian are still to resume studies",lives,4,4,10,0,18,jalandhar
9/3/19,https://www.tribuneindia.com/news/punjab/walls-collapsed-computers-furniture-covered-with-muck/826741.html," one of the worst affected schools is government middle school at bara yodh singh, where two parallel boundary walls collapsed",lives,4,4,10,0,18,jalandhar
9/2/19,https://www.tribuneindia.com/news/punjab/ahead-of-sc-hearing-on-syl-capt-amarinder-meets-union-jalshakti-minister/826710.html," he said that the flood had caused damage to 1.72 lakh acres of crop, and destroyed some 500 houses",lives,1,6,10,0,17,punjab
9/2/19,https://www.tribuneindia.com/news/punjab/ahead-of-sc-hearing-on-syl-capt-amarinder-meets-union-jalshakti-minister/826710.html,he also dismissed rivals¬†shriomani akali¬†¬†dal‚Äôs allegation that his government did not provide adequate relief to the flood victims saying that the party should have done more to strengthen the state‚Äôs infrastructure in their 10 years of rule,lives,1,6,10,0,17,punjab
9/2/19,https://www.tribuneindia.com/news/punjab/flood-hit-want-to-sell-land-move-out/826303.html,he still remembers 1988 floods that had destroyed everything,lives,9,35,18,0,62,jalandhar
9/2/19,https://www.tribuneindia.com/news/punjab/flood-hit-want-to-sell-land-move-out/826303.html,"most of the farmers in around 50 villages, which are worst affected with rains and floods, and who have lost everything in the deluge have started looking for ways to move out of these villages",lives,9,35,18,0,62,jalandhar
9/2/19,https://www.tribuneindia.com/news/punjab/flood-hit-want-to-sell-land-move-out/826303.html,he has lost crop in 20 acres of his fields ‚Äî 10 acres of his own and 10 he had taken on lease,lives,9,35,18,0,62,jalandhar
9/2/19,https://www.tribuneindia.com/news/punjab/flood-hit-want-to-sell-land-move-out/826303.html,‚Äúbut no one is willing to buy the lands which are flood-affected,lives,9,35,18,0,62,jalandhar
9/2/19,https://www.tribuneindia.com/news/punjab/power-restored-to-108-villages/826302.html,"tribune news service chandigarh, september 1  as part of the operations to restore normalcy in the flood-affected areas, the pspcl has restored supply to the 21-flood hit villages of jalandhar and 87 of sultanpur lodhi",lives,4,5,17,0,26,jalandhar
9/2/19,https://www.tribuneindia.com/news/punjab/power-restored-to-108-villages/826302.html," as many as 25,000 personnel from different departments have been given deadlines to complete the relief, rehabilitation and restoration tasks",lives,4,5,17,0,26,jalandhar
9/2/19,https://www.tribuneindia.com/news/punjab/power-restored-to-108-villages/826302.html," six teams of the national disaster relief force (ndrf), three teams of the state disaster response force (sdrf) and six columns of the army were roped in for the rescue operations and plugging 18 breaches in the sutlej, with the support of various social organisations and locals",lives,4,5,17,0,26,jalandhar
9/2/19,https://www.tribuneindia.com/news/punjab/from-bundhs-villagers-keep-watch-on-homes/826301.html,"tribune news service    mandala channa/mundi shehrian, (jalandhar), sept 1  almost a fortnight after the floods hit the district, villagers are preferring to camp on bundhs, than spending nights at the relatively secure relief camps set up by the government",lives,10,3,20,0,33,jalandhar
9/2/19,https://www.tribuneindia.com/news/punjab/from-bundhs-villagers-keep-watch-on-homes/826301.html," raju, who shifted to mundi shehrian village three years ago, has lost his home and belongings in the flood",lives,10,3,20,0,33,jalandhar
9/2/19,https://www.tribuneindia.com/news/punjab/from-bundhs-villagers-keep-watch-on-homes/826301.html,"while mandeep spent eight days at the relief camp in lohian, worries for her house and belongings still left to be salvaged from the roof caused her to return",lives,10,3,20,0,33,jalandhar
9/1/19,https://www.tribuneindia.com/news/punjab/flood-fury-in-ropar-alone-46-300-hit-rs-152-cr-loss/825940.html,"ropar, august 31  the damage to crops and government and private properties during last week‚Äôs floods in ropar district ‚Äî owing to incessant rain followed by the release of water from the bhakra dam ‚Äî has been put at over rs 152 crore",lives,4,20,19,1,44,punjab
9/1/19,https://www.tribuneindia.com/news/punjab/flood-fury-in-ropar-alone-46-300-hit-rs-152-cr-loss/825940.html," a report submitted by the district administration said 46,300 residents in 182 villages were affected, while standing crop on 11,580 acres and 313 houses were completely damaged",lives,4,20,19,1,44,punjab
9/1/19,https://www.tribuneindia.com/news/punjab/flood-fury-in-ropar-alone-46-300-hit-rs-152-cr-loss/825940.html,"twenty-seven government buildings of schools, dispensaries and community centres, and nine bridges were damaged and rs 111 crore would be required to repair the infrastructure",lives,4,20,19,1,44,punjab
9/1/19,https://www.tribuneindia.com/news/punjab/flood-fury-in-ropar-alone-46-300-hit-rs-152-cr-loss/825940.html," farmers suffered a loss of rs 14 crore as the average per acre loss has been pegged at rs 12,000",lives,4,20,19,1,44,punjab
9/1/19,https://www.tribuneindia.com/news/punjab/sutlej-fury-fuelled-by-mining-encroachments/825854.html,"dc varinder kumar sharma said as per preliminary report, crops in 82 villages in the district had been destroyed due to floods",lives,2,20,11,1,34,jalandhar
8/31/19,https://www.tribuneindia.com/news/punjab/post-floods-land-demarcation-new-worry/825353.html,"kanksha n bhardwaj  tribune news service  jalandhar, august 30  farmers in flood-affected areas are worried about the cumbersome process of demarcation that they will have to go through now",lives,3,36,13,1,53,jalandhar
8/31/19,https://www.tribuneindia.com/news/punjab/post-floods-land-demarcation-new-worry/825353.html,"meanwhile, more than 1,500 tubewells in 24 villages have got affected as per the assessment by the pspcl",lives,3,36,13,1,53,jalandhar
8/31/19,https://www.tribuneindia.com/news/punjab/post-floods-land-demarcation-new-worry/825353.html,"‚Äúdue to the vast amount of sludge which has covered everything, including tubewells, pumps, motors, starters, etc, almost 70-80 per cent of tubewells will become redundant and new bores will have to be dug which will cost high,‚Äù a farmer said",lives,3,36,13,1,53,jalandhar
8/31/19,https://www.tribuneindia.com/news/punjab/post-floods-land-demarcation-new-worry/825353.html,"‚Äúhad everything been alright, basmati would have started coming in the mandis and after that paddy, but this time, thousands of farmers in over 50 affected villages will not be able to sell anything,‚Äù he added",lives,3,36,13,1,53,jalandhar
8/31/19,https://www.tribuneindia.com/news/punjab/post-floods-land-demarcation-new-worry/825353.html,"the farmers said they would have earned rs 50,000-60,000 per acre for their crop but due to the deluge, they had suffered huge losses",lives,3,36,13,1,53,jalandhar
8/31/19,https://www.tribuneindia.com/news/punjab/report-ready-on-damage-to-roads/825351.html,"chandigarh, august 30  the public works department has prepared a preliminary damage assessment report regarding the roads, bridges and buildings falling under jurisdiction of the department, said an official spokesman",lives,0,5,10,1,16,sas nagar
8/31/19,https://www.tribuneindia.com/news/punjab/report-ready-on-damage-to-roads/825351.html," giving details, he said due to recent heavy rains and floods, approximately 1,450 km link roads, 420 km plan roads/national highways, 36 bridges and 36 buildings under jurisdiction of the department have been damaged",lives,0,5,10,1,16,sas nagar
8/31/19,https://www.tribuneindia.com/news/punjab/report-ready-on-damage-to-roads/825351.html,"most damage to link and plan roads was observed in rupnagar district wherein it is to the extent of 693.96 km and 123.1 km, respectively",lives,0,5,10,1,16,sas nagar
8/31/19,https://www.tribuneindia.com/news/punjab/report-ready-on-damage-to-roads/825351.html," around rs 95.50 crore is required for the repairs but the exact cost can be estimated only when the flood water recedes completely, he said, adding that the basic patchwork and repair of road breaches was underway",lives,0,5,10,1,16,sas nagar
8/29/19,https://www.tribuneindia.com/news/punjab/water-from-pak-inundates-fazilka-village/824265.html,"hansa singh said of the 1,435 acres of the agricultural land, the paddy crop in about 800-900 acres had been damaged due to the floods",lives,2,11,15,0,28,fazilka
8/29/19,https://www.tribuneindia.com/news/punjab/crores-spent-on-bundhs-washed-away/824263.html,"the most affected lohian-shahkot area, which falls in the 45-km section, got just rs 30 lakh",lives,3,6,12,0,21,"hoshiarpur, jalandhar, kapurthala, ludhiana, sbs nagar"
8/28/19,https://www.tribuneindia.com/news/punjab/inter-ministerial-central-team-to-visit-punjab-to-assess-damage-by-floods/824234.html,"chandigarh, august 28   an inter-ministerial central team will soon visit punjab for on the spot assessment of the damage caused by the recent floods in various districts of the state, an official said on wednesday",lives,1,16,27,0,44,"ferozepur, jalandhar, kapurthala, ludhiana, moga, sas nagar"
8/28/19,https://www.tribuneindia.com/news/punjab/inter-ministerial-central-team-to-visit-punjab-to-assess-damage-by-floods/824234.html," people in several punjab districts, including jalandhar, kapurthala, ferozepur, rupnagar, moga, ludhiana, have lost their houses, belongings, and standing crops in the recent floods, which are said to be the worst since 1988",lives,1,16,27,0,44,"ferozepur, jalandhar, kapurthala, ludhiana, moga, sas nagar"
8/28/19,https://www.tribuneindia.com/news/punjab/inter-ministerial-central-team-to-visit-punjab-to-assess-damage-by-floods/824234.html," the punjab government had assessed the damage to the tune of rs 2,000 crore due to the deluge and had already sought rs 1,000 crore from the centre as the special flood relief package",lives,1,16,27,0,44,"ferozepur, jalandhar, kapurthala, ludhiana, moga, sas nagar"
8/28/19,https://www.tribuneindia.com/news/punjab/nambardar-union-to-give-rs-14-cr-to-cm-fund/823788.html,"chandigarh: members of the punjab nambardar union on tuesday volunteered to contribute their three-month honorarium, amounting to rs 14.16 crore, to the chief minister's relief fund for providing help to flood-affected parts of the state",lives,7,36,19,2,64,"jalandhar, kapurthala, moga, sangrur"
8/28/19,https://www.tribuneindia.com/news/punjab/nambardar-union-to-give-rs-14-cr-to-cm-fund/823788.html,tns jac members to donate one-day salary  chandigarh: the joint action committee (jac) comprising 12 different associations of unaided colleges has announced to contribute one-day salary of all employees working in its institutions towards the chief minister's relief fund to provide much-needed relief to the flood-stricken families across the state,lives,7,36,19,2,64,"jalandhar, kapurthala, moga, sangrur"
8/28/19,https://www.tribuneindia.com/news/punjab/nambardar-union-to-give-rs-14-cr-to-cm-fund/823788.html,"he said as per the initial crop damage reports, 100 per cent crop damage has been reported in about 25,000 hectares of farmland",lives,7,36,19,2,64,"jalandhar, kapurthala, moga, sangrur"
8/28/19,https://www.tribuneindia.com/news/punjab/nambardar-union-to-give-rs-14-cr-to-cm-fund/823788.html,"extending a major relief to farmers, the high quality seed of the wheat crop, which costs around  rs 3,000 per quintal, taking the cost of initial seed requirement to the tune of  rs 7.50 crore, will be provided for free to the affected farmers",lives,7,36,19,2,64,"jalandhar, kapurthala, moga, sangrur"
8/28/19,https://www.tribuneindia.com/news/punjab/nambardar-union-to-give-rs-14-cr-to-cm-fund/823788.html,"ush({ });  chandigarh: cooperation minister sukhjinder singh randhawa on tuesday said the department, especially one of its wings - markfed - had taken the lead in providing flood-relief material to the people and areas affected by floods",lives,7,36,19,2,64,"jalandhar, kapurthala, moga, sangrur"
8/28/19,https://www.tribuneindia.com/news/punjab/nambardar-union-to-give-rs-14-cr-to-cm-fund/823788.html,"as per the complaint, the 17-year-old victim was raped by her uncle amrik singh in august last year, but she lodged the complaint with the dhuri police on monday evening",lives,7,36,19,2,64,"jalandhar, kapurthala, moga, sangrur"
8/28/19,https://www.tribuneindia.com/news/punjab/month-on-muktsar-farmers-await-special-girdawari/823774.html,"archit watts  tribune news service  muktsar, august 27   it‚Äôs been over a month after the rain flooded agricultural fields in a large number of villages in the district, but the work of special girdawari to assess crop damage is yet to finish",lives,1,31,18,1,51,sri muktsar sahib
8/28/19,https://www.tribuneindia.com/news/punjab/month-on-muktsar-farmers-await-special-girdawari/823774.html," notably, the rainwater in mid-july damaged the paddy and cotton crops in nearly 8,000 acres, as per an estimate of the district administration",lives,1,31,18,1,51,sri muktsar sahib
8/28/19,https://www.tribuneindia.com/news/punjab/month-on-muktsar-farmers-await-special-girdawari/823774.html,"further, it has damaged nearly 225 houses in the district",lives,1,31,18,1,51,sri muktsar sahib
8/28/19,https://www.tribuneindia.com/news/punjab/floods-destroy-power-infra-initial-loss-rs5-cr/823771.html,"floods destroy power infra, initial loss rs5 cr",lives,4,23,52,0,79,"ferozepur, jalandhar, kapurthala, moga, patiala"
8/28/19,https://www.tribuneindia.com/news/punjab/floods-destroy-power-infra-initial-loss-rs5-cr/823771.html,"aman sood  tribune news service  patiala, august 27  punjab‚Äôs worst floods in three decades, partially due to the bhakra beas management board decision to release excess water into sutlej, have caused damage to the power infrastructure in the state",lives,4,23,52,0,79,"ferozepur, jalandhar, kapurthala, moga, patiala"
8/28/19,https://www.tribuneindia.com/news/punjab/floods-destroy-power-infra-initial-loss-rs5-cr/823771.html," according to the pspcl top brass, the floods caused major damage in jalandhar and kapurthala where infrastructure worth rs4 crore is estimated to be damaged, while in ropar villages the loss is pegged at rs1 crore due to damage to transformers, poles and power meters",lives,4,23,52,0,79,"ferozepur, jalandhar, kapurthala, moga, patiala"
8/28/19,https://www.tribuneindia.com/news/punjab/floods-destroy-power-infra-initial-loss-rs5-cr/823771.html," ‚Äúthe places where the damage was done to electricity meters of consumers, power wires, poles or transformers, pspcl will bear all expenses,‚Äù sran said",lives,4,23,52,0,79,"ferozepur, jalandhar, kapurthala, moga, patiala"
8/28/19,https://www.tribuneindia.com/news/punjab/floods-destroy-power-infra-initial-loss-rs5-cr/823771.html," the worst-hit¬†  according to the pspcl top brass, floods caused major damage in jalandhar and kapurthala where infrastructure worth  rs 4 crore is estimated to be damaged in ropar villages, the loss is pegged at  rs 1 crore due to damage to transformers, poles and power meters however, there was no major loss in moga and ferozepur ",lives,4,23,52,0,79,"ferozepur, jalandhar, kapurthala, moga, patiala"
8/27/19,https://www.tribuneindia.com/news/punjab/schools-shelter-flood-hit-kids-skip-classes/823368.html,the functioning of more than 100 private schools too has crippled with some serving as relief centres,lives,1,7,10,0,18,"jalandhar, kapurthala, ludhiana, tarn taran"
8/27/19,https://www.tribuneindia.com/news/punjab/schools-shelter-flood-hit-kids-skip-classes/823368.html,"  her house inundated, kiranjot kaur (14), a class viii student at government high school, chak wadala, jalandhar, is lodged in a relief camp at lohian village",lives,1,7,10,0,18,"jalandhar, kapurthala, ludhiana, tarn taran"
8/27/19,https://www.tribuneindia.com/news/punjab/akalis-chip-in-send-10-trucks-of-essentials/823219.html,"sangrur, august 26  blaming the punjab government for the mismanagement of the flood-control operations, sad leaders, led by former state finance minister and lehra mla parminder dhindsa, on monday sent 10 trucks loaded with fodder and other essential items to the affected areas",lives,0,0,2,0,2,sangrur
8/27/19,https://www.tribuneindia.com/news/punjab/out-of-job-daily-wagers-struggle-to-feed-family/823215.html,it has been eight days and they are among thousands of other daily wagers who are out of work in over 50 affected villages of jalandhar,lives,5,13,17,4,39,jalandhar
8/27/19,https://www.tribuneindia.com/news/punjab/distress-calls-turn-pcr-into-flood-helpline/823214.html,  hundreds of distress calls like these were received on the police helpline from august 18 onwards as floods ravaged several parts of punjab,lives,4,8,14,0,26,"jalandhar, kapurthala, ludhiana, sas nagar"
8/27/19,https://www.tribuneindia.com/news/punjab/distress-calls-turn-pcr-into-flood-helpline/823214.html,"before the flood disaster management was put in place, the punjab police helpline, 112, for reporting crime and accidents turned into a flood sos helpline",lives,4,8,14,0,26,"jalandhar, kapurthala, ludhiana, sas nagar"
8/27/19,https://www.tribuneindia.com/news/punjab/800-labourers-to-clean-8-ropar-villages/823213.html," arora said on monday, 200 labourers were deployed in the eight affected villages to clean muck while 600 more workers would be sent in these areas on tuesday",lives,4,0,29,3,36,gurdaspur
8/27/19,https://www.tribuneindia.com/news/punjab/800-labourers-to-clean-8-ropar-villages/823213.html, arora announced that rs 1 crore had been handed over to the district administration to provide compensation to the affected people,lives,4,0,29,3,36,gurdaspur
8/27/19,https://www.tribuneindia.com/news/punjab/800-labourers-to-clean-8-ropar-villages/823213.html,"besides, rs 43 lakh had been given to conduct the relief operations, he added",lives,4,0,29,3,36,gurdaspur
8/27/19,https://www.tribuneindia.com/news/punjab/800-labourers-to-clean-8-ropar-villages/823213.html,"ush({ }); district admn gets rs 1-cr compensation  industries minister sunder sham arora, who visited phul khurd village, said 200 labourers were deployed in the affected villages on monday for cleaning, while 600 more workers would be sent in these eight areas on tuesday",lives,4,0,29,3,36,gurdaspur
8/27/19,https://www.tribuneindia.com/news/punjab/800-labourers-to-clean-8-ropar-villages/823213.html,he said  rs 1 crore had been handed over to the administration to provide compensation to the affected people,lives,4,0,29,3,36,gurdaspur
8/27/19,https://www.tribuneindia.com/news/punjab/800-labourers-to-clean-8-ropar-villages/823213.html,"besides,  rs 43 lakh has been given for the relief operations",lives,4,0,29,3,36,gurdaspur
8/27/19,https://www.tribuneindia.com/news/punjab/farmers-to-get-free-wheat-seed/823211.html,"chandigarh, august 26  chief minister capt amarinder singh on monday ordered a slew of additional measures for relief and rehabilitation of flood victims, including supply of free high quality wheat seed to farmers for the upcoming rabi season",lives,1,26,8,0,35,punjab
8/26/19,https://www.tribuneindia.com/news/punjab/embankment-in-ferozepur-district-collapses-as-pakistan-releases-water/823150.html, deputy commissioner chander gaind said 500 people had been evacuated  and 630 given necessary medical aid in 15 flood-affected villages in  makhu and hussaniwala areas,lives,2,1,22,0,25,ferozepur
8/26/19,https://www.tribuneindia.com/news/punjab/embankment-in-ferozepur-district-collapses-as-pakistan-releases-water/823150.html," gatti rajoke, the last village in india before the international  border, is one of the worst affected villages due to the water released  by pakistan",lives,2,1,22,0,25,ferozepur
8/26/19,https://www.tribuneindia.com/news/punjab/punjab-seeks-rs-1-000-cr-special-aid-from-centre/822847.html,"ruchika m khanna tribune news service chandigarh, august 25  the damage caused in punjab by floods, mainly on account of water being released through spillways of the bhakra dam, was immense and needed special assistance from the centre, in addition to the relief that was being provided through the disaster relief management fund, the state government has said",lives,11,11,42,0,64,"fazilka, ferozepur, jalandhar, kapurthala, ludhiana, patiala, sas nagar, sbs nagar"
8/26/19,https://www.tribuneindia.com/news/punjab/punjab-seeks-rs-1-000-cr-special-aid-from-centre/822847.html," though the union government initially asked punjab to provide relief from the disaster fund of rs 6,200 crore lying with the state, punjab has been insisting on a special package of rs 1,000 crore to rebuild infrastructure, a senior government official said",lives,11,11,42,0,64,"fazilka, ferozepur, jalandhar, kapurthala, ludhiana, patiala, sas nagar, sbs nagar"
8/26/19,https://www.tribuneindia.com/news/punjab/punjab-seeks-rs-1-000-cr-special-aid-from-centre/822847.html,"it was on capt amarinder‚Äôs request that the union home ministry, which grants special assistance, had decided to send teams to assess the damage in punjab along with 11 other states, he said",lives,11,11,42,0,64,"fazilka, ferozepur, jalandhar, kapurthala, ludhiana, patiala, sas nagar, sbs nagar"
8/26/19,https://www.tribuneindia.com/news/punjab/punjab-seeks-rs-1-000-cr-special-aid-from-centre/822847.html,"a person was feared drowned in the sutlej in fazilka while death of 176 cattle heads and damage to 161 houses had been reported from ropar, said officials",lives,11,11,42,0,64,"fazilka, ferozepur, jalandhar, kapurthala, ludhiana, patiala, sas nagar, sbs nagar"
8/26/19,https://www.tribuneindia.com/news/punjab/punjab-seeks-rs-1-000-cr-special-aid-from-centre/822847.html,"with the army‚Äôs help, the state government managed to strengthen an embankment at tendiwala village in ferozepur and averted flooding of nearby villages, they said",lives,11,11,42,0,64,"fazilka, ferozepur, jalandhar, kapurthala, ludhiana, patiala, sas nagar, sbs nagar"
8/26/19,https://www.tribuneindia.com/news/punjab/punjab-seeks-rs-1-000-cr-special-aid-from-centre/822847.html," rescue operation on¬† ferozepur:¬†500 evacuated, 630 given relief in 15 marooned villages in makhu and hussainiwala jalandhar: 31 evacuated, 389 families given medical aid, 655 treated at opds while 4,600 treated at medical camps kapurthala:¬† dry rations and other relief material provided to people; 1,415 given medical aid; veterinary care provided to 640 cattle ropar: 500 evacuated, drinking water and power supply restored in affected villages; 3,300 provided medical aid fortify banks along pakistan border: captain¬†  chandigarh: punjab chief minister capt amarinder singh on sunday asked the water resources department to work out a joint action plan to strengthen¬†embankment along the india-pakistan border to avert flooding of nearby villages.",lives,11,11,42,0,64,"fazilka, ferozepur, jalandhar, kapurthala, ludhiana, patiala, sas nagar, sbs nagar"
8/26/19,https://www.tribuneindia.com/news/punjab/after-education-other-depts-to-have-online-transfer-policy-too/822803.html,"since all online transfers are done without any official intervention, it helps greatly to end corruption",lives,4,1,2,0,7,sangrur
8/26/19,https://www.tribuneindia.com/news/punjab/locals-battle-skin-ailments/822793.html,"harshraj singh tribune news service ludhiana, august 25 in recent days, there has been a rise in skin infections and other ailments in the flood-affected villages of the district",lives,8,2,13,0,23,ludhiana
8/26/19,https://www.tribuneindia.com/news/punjab/flood-hit-throng-health-camps/822791.html,"aparna banerji tribune news service lohian (jalandhar), august 25 with the water at some villages beginning to recede, villages in lohian have been exposed to threat of grave diseases as evident from the burgeoning reportage of patients from flood-affected villages",lives,4,2,17,0,23,jalandhar
8/26/19,https://www.tribuneindia.com/news/punjab/flood-hit-throng-health-camps/822791.html,ush({ });no government medical relief team was seen in the villages during the tribune‚Äôs more than two-hour stay there,lives,4,2,17,0,23,jalandhar
8/26/19,https://www.tribuneindia.com/news/punjab/clash-erupts-during-relief-ops-6-injured/822784.html,clash erupts during relief ops; 6 injured,lives,14,1,14,0,29,jalandhar
8/26/19,https://www.tribuneindia.com/news/punjab/clash-erupts-during-relief-ops-6-injured/822784.html,"jalandhar, august 25  six persons of sheikh manga village in sultanpur lodhi were injured in when a clash erupted between two groups during flood relief operations on sunday",lives,14,1,14,0,29,jalandhar
8/26/19,https://www.tribuneindia.com/news/punjab/clash-erupts-during-relief-ops-6-injured/822784.html," among the six, two persons suffered serious gunshot wounds",lives,14,1,14,0,29,jalandhar
8/26/19,https://www.tribuneindia.com/news/punjab/cong-mla-gives-month-s-salary/822779.html,"chandigarh: hours after chief minister captain amarinder singh tweeted an appealed to all to join the state government in assisting flood-affected people, qudian congress mla fateh jung bajwa decided to donate his one month‚Äôs salary and appealed to his colleagues to follow the suit",lives,2,3,5,0,10,punjab
8/26/19,https://www.tribuneindia.com/news/punjab/cong-mla-gives-month-s-salary/822779.html,"he said flooding in the sutlej due to the discharge of water from bhakra, the heaviest since 1988, had caused extensive damage to the standing crops and inundation residential areas in the villages",lives,2,3,5,0,10,punjab
8/26/19,https://www.tribuneindia.com/news/punjab/crops-on-6-000-acres-damaged-in-fazilka/822777.html,"crops on 6,000 acres damaged in fazilka",lives,5,31,23,1,60,"fazilka, ferozepur, sas nagar"
8/26/19,https://www.tribuneindia.com/news/punjab/crops-on-6-000-acres-damaged-in-fazilka/822777.html,as many as 18 villages have been affected as sutlej has been overflowing in the border belt,lives,5,31,23,1,60,"fazilka, ferozepur, sas nagar"
8/26/19,https://www.tribuneindia.com/news/punjab/crops-on-6-000-acres-damaged-in-fazilka/822777.html, assistant civil surgeon dr davinder kumar bhukkal said medical camps in about 15 flood-affected villages were organised,lives,5,31,23,1,60,"fazilka, ferozepur, sas nagar"
8/26/19,https://www.tribuneindia.com/news/punjab/crops-on-6-000-acres-damaged-in-fazilka/822777.html, some farmers said about 400 acres of the fields were inundated and their paddy crop had been damaged,lives,5,31,23,1,60,"fazilka, ferozepur, sas nagar"
8/25/19,https://www.tribuneindia.com/news/punjab/capt-amarinder-seeks-joint-action-plan-with-army-to-strengthen-tendiwala-embankment/822677.html,"  union home secretary, mr ajay bhalla has informed the state give that a central team to assess damage on account of floods would also be sent to punjab, along with 11 other flood ravaged states",lives,19,16,35,0,70,"ferozepur, jalandhar, kapurthala"
8/25/19,https://www.tribuneindia.com/news/punjab/capt-amarinder-seeks-joint-action-plan-with-army-to-strengthen-tendiwala-embankment/822677.html,"ush({ });  according to deputy commissioner ferozepur, in 15 flood affected villages in makhu and hussaniwala area, nearly 500 people had been evacuated to safer places and about 630 people had been given necessary medical aid",lives,19,16,35,0,70,"ferozepur, jalandhar, kapurthala"
8/25/19,https://www.tribuneindia.com/news/punjab/capt-amarinder-seeks-joint-action-plan-with-army-to-strengthen-tendiwala-embankment/822677.html,"  while reviewing the progress of relief and rehabilitation measures being undertaken in jalandhar, the chief minister was informed that as many as 389 families with 1690 members in the flood hit villages had been treated by the mobile teams",lives,19,16,35,0,70,"ferozepur, jalandhar, kapurthala"
8/25/19,https://www.tribuneindia.com/news/punjab/capt-amarinder-seeks-joint-action-plan-with-army-to-strengthen-tendiwala-embankment/822677.html,about 4600 persons have so far visited the medical camps in the flood affected areas,lives,19,16,35,0,70,"ferozepur, jalandhar, kapurthala"
8/25/19,https://www.tribuneindia.com/news/punjab/capt-amarinder-seeks-joint-action-plan-with-army-to-strengthen-tendiwala-embankment/822677.html,as many as 31 persons have been evacuated to the nearby relief camps,lives,19,16,35,0,70,"ferozepur, jalandhar, kapurthala"
8/25/19,https://www.tribuneindia.com/news/punjab/capt-amarinder-seeks-joint-action-plan-with-army-to-strengthen-tendiwala-embankment/822677.html,"nearly 500 people had been evacuated, and drinking water and power supply has been restored in the flood affected villages",lives,19,16,35,0,70,"ferozepur, jalandhar, kapurthala"
8/25/19,https://www.tribuneindia.com/news/punjab/capt-amarinder-seeks-joint-action-plan-with-army-to-strengthen-tendiwala-embankment/822677.html,"according to preliminary estimates, the state has suffered damage to the tune of rs 1700 crore due to floods",lives,19,16,35,0,70,"ferozepur, jalandhar, kapurthala"
8/25/19,https://www.tribuneindia.com/news/punjab/pak-releases-more-water-flood-threat-looms-in-punjab-s-ferozepur/822675.html," ""pakistan has released water in huge quantity which caused damage to the embankment in tendiwala village, and there is danger of floods in some villages,"" a spokesperson of the punjab government said",lives,5,3,23,0,31,ferozepur
8/25/19,https://www.tribuneindia.com/news/punjab/pak-releases-more-water-flood-threat-looms-in-punjab-s-ferozepur/822675.html,"ush({ });  irrigation and drainage departments are already engaged to repair the damaged embankment in tendiwala village, he said",lives,5,3,23,0,31,ferozepur
8/25/19,https://www.tribuneindia.com/news/punjab/pak-releases-more-water-flood-threat-looms-in-punjab-s-ferozepur/822675.html," ""in the wake of the damage to the embankment due to heavy discharge of water from the pakistan side, the strengthening work of tendiwala embankment is being undertaken on war footing,"" the spokesperson said",lives,5,3,23,0,31,ferozepur
8/26/19,https://www.tribuneindia.com/news/punjab/capt-asks-ministers-dcs-to-step-up-vigil-as-rain-resumes-in-punjab/822655.html,"chandigarh, august 25with rains again lashing parts of flood-ravaged punjab, chief minister amarinder singh on sunday directed all ministers overseeing relief operations and the deputy commissioners to step up vigil",lives,7,17,23,0,47,"ferozepur, jalandhar, kapurthala, sas nagar"
8/26/19,https://www.tribuneindia.com/news/punjab/capt-asks-ministers-dcs-to-step-up-vigil-as-rain-resumes-in-punjab/822655.html,"at 2 pm today have called for a detailed review meeting on the flood relief measures,"" amarinder singh said in a tweet",lives,7,17,23,0,47,"ferozepur, jalandhar, kapurthala, sas nagar"
8/26/19,https://www.tribuneindia.com/news/punjab/capt-asks-ministers-dcs-to-step-up-vigil-as-rain-resumes-in-punjab/822655.html," he has deputed four ministers ‚Äî charanjit singh channi, sunder sham arora, gurpreet singh kangar and bharat bhushan ashu ‚Äî to oversee relief operations in worst-affected jalandhar, kapurthala and rupnagar districts",lives,7,17,23,0,47,"ferozepur, jalandhar, kapurthala, sas nagar"
8/26/19,https://www.tribuneindia.com/news/punjab/capt-asks-ministers-dcs-to-step-up-vigil-as-rain-resumes-in-punjab/822655.html,"ush({ });  he had written to prime minister narendra modi to seek a special flood relief package of rs 1,000 crore for compensating losses resulting from floods in the state",lives,7,17,23,0,47,"ferozepur, jalandhar, kapurthala, sas nagar"
8/26/19,https://www.tribuneindia.com/news/punjab/capt-asks-ministers-dcs-to-step-up-vigil-as-rain-resumes-in-punjab/822655.html," it is estimated, as per initial calculations, that the state has suffered damage worth rs 1,700 crore due to the floods",lives,7,17,23,0,47,"ferozepur, jalandhar, kapurthala, sas nagar"
8/26/19,https://www.tribuneindia.com/news/punjab/capt-asks-ministers-dcs-to-step-up-vigil-as-rain-resumes-in-punjab/822655.html," in jalandhar's shahkot, hundreds of flood-affected people thronged a medical camp set up by authorities",lives,7,17,23,0,47,"ferozepur, jalandhar, kapurthala, sas nagar"
8/25/19,https://www.tribuneindia.com/news/punjab/100-crop-damage-in-jalandhar-kapurthala-districts-say-farmers/822274.html,"100% crop damage in jalandhar, kapurthala districts, say farmers",lives,6,106,53,2,167,"jalandhar, kapurthala"
8/25/19,https://www.tribuneindia.com/news/punjab/100-crop-damage-in-jalandhar-kapurthala-districts-say-farmers/822274.html,"60,000 acres¬†inundated in jalandhar¬†  26,000 acres¬†inundated in kapurthala¬†  60,000 farmers¬†affected by floods aparna banerji tribune news service jalandhar, august 24  with the farmers being primarily at the receiving end due to the sutlej floods, which have ravaged over 50 villages in the district, they are now planning to conduct their own parallel survey of the affected fields after the water recedes",lives,6,106,53,2,167,"jalandhar, kapurthala"
8/25/19,https://www.tribuneindia.com/news/punjab/100-crop-damage-in-jalandhar-kapurthala-districts-say-farmers/822274.html,they claim that the damage was estimated to be 100 %,lives,6,106,53,2,167,"jalandhar, kapurthala"
8/25/19,https://www.tribuneindia.com/news/punjab/100-crop-damage-in-jalandhar-kapurthala-districts-say-farmers/822274.html,"ush({ });  the district administrations, however, estimated the damage to crops over 86,000 acres (60,000 acres in jalandhar and 26,000 acres in kapurthala)",lives,6,106,53,2,167,"jalandhar, kapurthala"
8/25/19,https://www.tribuneindia.com/news/punjab/100-crop-damage-in-jalandhar-kapurthala-districts-say-farmers/822274.html," kuldip singh, a farmer of janian chahal village, said, ‚Äúit took ages for farmers affected by the 1988 floods to recover from losses",lives,6,106,53,2,167,"jalandhar, kapurthala"
8/25/19,https://www.tribuneindia.com/news/punjab/100-crop-damage-in-jalandhar-kapurthala-districts-say-farmers/822274.html,"we are expecting relief of at leastrs 40,000 per acre",lives,6,106,53,2,167,"jalandhar, kapurthala"
8/25/19,https://www.tribuneindia.com/news/punjab/100-crop-damage-in-jalandhar-kapurthala-districts-say-farmers/822274.html,"we demand rs 40,000 per care as damages from the government",lives,6,106,53,2,167,"jalandhar, kapurthala"
8/25/19,https://www.tribuneindia.com/news/punjab/100-crop-damage-in-jalandhar-kapurthala-districts-say-farmers/822274.html,"an estimated crop over 70,000 acres in jalandhar is affected",lives,6,106,53,2,167,"jalandhar, kapurthala"
8/25/19,https://www.tribuneindia.com/news/punjab/100-crop-damage-in-jalandhar-kapurthala-districts-say-farmers/822274.html,"  meanwhile, jalandhar dc varinder kumar sharma said, ‚Äúdamage to crop on about 60,000 acres is estimated",lives,6,106,53,2,167,"jalandhar, kapurthala"
8/25/19,https://www.tribuneindia.com/news/punjab/100-crop-damage-in-jalandhar-kapurthala-districts-say-farmers/822274.html,"  kapurthala dc dps kharbanda, however, said, ‚Äúabout 26,000 acres has been damaged after 20,000 villages were marooned here",lives,6,106,53,2,167,"jalandhar, kapurthala"
8/25/19,https://www.tribuneindia.com/news/punjab/bittu-finally-visits-flooded-villages-across-ludhiana/822273.html,"ludhiana, august 24  ludhiana mp ravneet singh bittu finally visited the flood-affected areas of the district on saturday and reviewed the ongoing relief works",lives,0,1,12,0,13,ludhiana
8/25/19,https://www.tribuneindia.com/news/punjab/five-ministers-take-stock-of-relief-work/822272.html,"tribune news service chandigarh, august 24  in the wake of flood fury in various districts of doaba and malwa, five punjab ministers as well as the vidhan sabha speaker visited the affected areas on saturday, said a government spokesman",lives,6,4,11,0,21,"jalandhar, kapurthala, roopnagar, sas nagar"
8/25/19,https://www.tribuneindia.com/news/punjab/amid-deluge-jalandhar-welcomes-flood-babies/822267.html,"  mitri devi (30), who is 32 weeks‚Äô pregnant, was evacuated by a mobile team from maharajwala and admitted to the lohian health centre yesterday",lives,2,6,13,0,21,jalandhar
8/24/19,https://www.tribuneindia.com/news/punjab/cm-surprised-over-non-inclusion-of-punjab-in-list-for-flood-situation-assessment/822239.html,"the centre has listed 11 states for imct review of the flood damage but punjab does not find mention in it, even though the state has witnessed large-scale flooding in many areas following unprecedented rains",lives,4,30,25,0,59,"ferozepur, jalandhar, kapurthala, ludhiana, sas nagar"
8/24/19,https://www.tribuneindia.com/news/punjab/cm-surprised-over-non-inclusion-of-punjab-in-list-for-flood-situation-assessment/822239.html,"¬†singh said he had already written to prime minister narendra modi seeking a special flood relief package of rs 1,000 crore for compensating the losses resulting from floods in the state",lives,4,30,25,0,59,"ferozepur, jalandhar, kapurthala, ludhiana, sas nagar"
8/24/19,https://www.tribuneindia.com/news/punjab/cm-surprised-over-non-inclusion-of-punjab-in-list-for-flood-situation-assessment/822239.html,"¬†it is estimated, as per initial calculations, that the state has suffered damage worth rs 1,700 crore",lives,4,30,25,0,59,"ferozepur, jalandhar, kapurthala, ludhiana, sas nagar"
8/24/19,https://www.tribuneindia.com/news/punjab/cm-surprised-over-non-inclusion-of-punjab-in-list-for-flood-situation-assessment/822239.html,"meanwhile, bajwa donated one month's salary to the cm relief fund",lives,4,30,25,0,59,"ferozepur, jalandhar, kapurthala, ludhiana, sas nagar"
8/24/19,https://www.tribuneindia.com/news/punjab/toilets-clogged-villagers-defecate-on-roofs/821765.html,"jasmeen, 14, is not the only one suffering",lives,6,1,19,0,26,jalandhar
8/24/19,https://www.tribuneindia.com/news/punjab/4-ministers-deputed-to-oversee-relief-ops/821764.html,4 ministers deputed to oversee relief ops,lives,1,3,16,0,20,"jalandhar, kapurthala"
8/24/19,https://www.tribuneindia.com/news/punjab/4-ministers-deputed-to-oversee-relief-ops/821764.html,"tribune news service chandigarh, august 23  chief minister capt amarinder singh today deputed four ministers to oversee the relief operations in the flood-ravaged districts of ropar, jalandhar and kapurthala, and directed the officials concerned to expedite the restoration of power supply in the affected areas",lives,1,3,16,0,20,"jalandhar, kapurthala"
8/24/19,https://www.tribuneindia.com/news/punjab/trains-to-sultanpur-lodhi-off-track-for-now-railways/821763.html,"deepkamal kaur tribune news service gidderpindi (jalandhar), august 23  even as there were plans to start special trains for sultanpur lodhi ahead of the 550th gurpurb of guru nanak, the railways will now have to assess the damage to the tracks on the route via the flood-ravaged gidderpindi area before going ahead with it",lives,3,6,13,0,22,"ferozepur, jalandhar"
8/24/19,https://www.tribuneindia.com/news/punjab/to-plug-breach-neighbours-flood-shahkot/821758.html,"the breach, which is 45-50 feet deep and 150 metre wide, has cut off the affected villages from the rest of shahkot as well as sultanpur lodhi where many students had been going to study",lives,11,8,18,0,37,jalandhar
8/24/19,https://www.tribuneindia.com/news/punjab/to-plug-breach-neighbours-flood-shahkot/821758.html,"  dhussi bundh  45-50 ft deep & 150 m wide  2 weeks required to plug it  120 soldiers deployed¬†at both ends  fodder shortage hits cattle  along with the losses suffered by people, volunteers and relief workers on ground have pointed out the shortage of fodder for cattle",lives,11,8,18,0,37,jalandhar
8/23/19,https://www.tribuneindia.com/news/punjab/accused-of-regional-bias-over-punjab-floods-kapil-sharma-issues-clarification/821623.html,"he added one needed to rise above ‚Äúbihari, punjabi, marathi, madrasi‚Äù to stand by the ones who were suffering",lives,17,3,4,2,26,punjab
8/23/19,https://www.tribuneindia.com/news/punjab/accused-of-regional-bias-over-punjab-floods-kapil-sharma-issues-clarification/821623.html,"om/fvkhmvvvbg  ‚Äî kapil sharma (@kapilsharmak9) august 22, 2019  twitter reactions:¬†  @kapilsharmak9 you north indian people never supported south indian people during floods but we south people are always ready to help everyone #punjabfloods #humanityfirst  ‚Äî siddharth hulmani (@siddharthhulman) august 22, 2019  we definitely sympathize with our punjabi brothers and sisters",lives,17,3,4,2,26,punjab
8/23/19,https://www.tribuneindia.com/news/punjab/accused-of-regional-bias-over-punjab-floods-kapil-sharma-issues-clarification/821623.html,"but @kapilsharmak9, shame on your insensitivity towards people who suffered from severe floods in mh, where were you hiding ? you are earning name and money in maharashtra",lives,17,3,4,2,26,punjab
8/23/19,https://www.tribuneindia.com/news/punjab/450-rescued-in-moga/821456.html,450 rescued in moga,lives,8,0,9,0,17,moga
8/23/19,https://www.tribuneindia.com/news/punjab/450-rescued-in-moga/821456.html,"moga: water level in the sutlej has declined by about 3-5 ft at various places in the district, giving a sigh of relief to the flood-affected people living along the river banks",lives,8,0,9,0,17,moga
8/23/19,https://www.tribuneindia.com/news/punjab/450-rescued-in-moga/821456.html,"a spokesman claimed that the 22-member team of the ndrf had evacuated more than 450 persons with the help of local people from sanghera, kambo khurd, bhaini, mehrowal and sherewala villages",lives,8,0,9,0,17,moga
8/23/19,https://www.tribuneindia.com/news/punjab/450-rescued-in-moga/821456.html,a total of 28 villages in dharamkot sub-division have been affected by floods,lives,8,0,9,0,17,moga
8/23/19,https://www.tribuneindia.com/news/punjab/relief-camps-flooded/821455.html,"now, the administration plans to provide relief to the flood-hit at their houses through 18 relief teams",lives,1,1,11,0,13,kapurthala
8/23/19,https://www.tribuneindia.com/news/punjab/relief-camps-flooded/821455.html,"dc dps kharbanda said, ‚Äúthe relief teams will ensure fodder of 2.5 kg per cattle head and medication",lives,1,1,11,0,13,kapurthala
8/23/19,https://www.tribuneindia.com/news/punjab/-flood-relief-govt-priority/821303.html,"tribune news service gidderpindi/sultanpur lodhi, august 22  during his meetings to listen to the grievances of the flood-affected farmers at gidderpindi village of jalandhar and sarupwal village of sultanpur lodhi, chief minister captain amarinder singh said: ‚Äúwe will stop every project for the time being",lives,5,8,14,1,28,jalandhar
8/23/19,https://www.tribuneindia.com/news/punjab/-flood-relief-govt-priority/821303.html,"  meanwhile, members of the punjab ias association have decided to contribute one day's salary to the cm's relief fund",lives,5,8,14,1,28,jalandhar
8/23/19,https://www.tribuneindia.com/news/punjab/toxins-from-pak-tanneries-add-to-border-areas-woes/821301.html,"our correspondent ferozepur, august 22  already suffering due to floods, villagers in hussainiwala enclave along the india-pakistan border have another reason to worry about",lives,6,10,15,0,31,"fazilka, ferozepur"
8/23/19,https://www.tribuneindia.com/news/punjab/toxins-from-pak-tanneries-add-to-border-areas-woes/821301.html," due to ‚Äúdeliberate breach‚Äù in embankment along the sutlej on pakistan side, several villages, including gatti rajoke, tiniwala, kamalewala and nihalewala, get flooded, damaging thousands of acres of standing crop",lives,6,10,15,0,31,"fazilka, ferozepur"
8/23/19,https://www.tribuneindia.com/news/punjab/toxins-from-pak-tanneries-add-to-border-areas-woes/821301.html," about flood relief measures, the dc said nearly 400 persons had been saved in the past three days and the operations would continue till the danger was totally averted.",lives,6,10,15,0,31,"fazilka, ferozepur"
8/22/19,https://www.tribuneindia.com/news/punjab/water-continues-to-rise-so-do-fears/820859.html,"deepkamal kaur tribune news service janian chahal (jalandhar), august 21  marooned in their houses by the swollen sutlej, affected families at janian chahal, chak wadala and gatti peer baksh villages in the district today spent their fourth sleepless night stranded on rooftops, waiting for the water levels to recede",lives,8,2,22,0,32,jalandhar
8/22/19,https://www.tribuneindia.com/news/punjab/2-new-breaches-worsen-situation-in-jalandhar-kapurthala/820673.html, twentyfive boats (20 jalandhar and 5 kapurthala) and seven helicopters have been pressed into service for relief operations in the 138 flood-hit villages of the districts,lives,8,12,21,0,41,"jalandhar, kapurthala"
8/22/19,https://www.tribuneindia.com/news/punjab/2-new-breaches-worsen-situation-in-jalandhar-kapurthala/820673.html," not much relief 30,000 acres inundated in jalandhar¬† 138 villages affected in jalandhar, kapurthala 27 boats, 7 helicopters roped in for relief ops",lives,8,12,21,0,41,"jalandhar, kapurthala"
8/22/19,https://www.tribuneindia.com/news/punjab/farmers-stare-at-losses-govt-empty-coffers/820671.html,"ruchika m khanna  tribune news service  chandigarh, august 21  even as the state remained on the edge, with almost 75,000 cusecs water being released by the bbmb, the government is grappling with the issue of compensating farmers, who have suffered losses worth crores",lives,8,86,38,3,135,"fazilka, ferozepur, jalandhar, kapurthala, ludhiana, moga"
8/22/19,https://www.tribuneindia.com/news/punjab/farmers-stare-at-losses-govt-empty-coffers/820671.html,"in such a situation, the relief that the state can offer is just rs 12,200 per hectare (or rs 5,083.33 per acre) from the state disaster relief management fund, unless the centre recognises flooding in punjab as a natural disaster and gives it a flood relief package",lives,8,86,38,3,135,"fazilka, ferozepur, jalandhar, kapurthala, ludhiana, moga"
8/22/19,https://www.tribuneindia.com/news/punjab/farmers-stare-at-losses-govt-empty-coffers/820671.html,"at places, where the farmers have suffered a loss of more than one crop (in fazilka- abohar, where besides horticulture crops, cotton is grown), rs 5,625 per acre would be given for loss of horticulture crops and rs 5,083.33 per acre for other crops sown along with kinnows",lives,8,86,38,3,135,"fazilka, ferozepur, jalandhar, kapurthala, ludhiana, moga"
8/22/19,https://www.tribuneindia.com/news/punjab/farmers-stare-at-losses-govt-empty-coffers/820671.html," chief minister capt amarinder singh today wrote to the prime minister, seeking a rs 1,000-crore special package, besides asking him to instruct the authorities to waive crop loans taken by farmers in affected villages for the current cropping season",lives,8,86,38,3,135,"fazilka, ferozepur, jalandhar, kapurthala, ludhiana, moga"
8/22/19,https://www.tribuneindia.com/news/punjab/farmers-stare-at-losses-govt-empty-coffers/820671.html,"the flooding in the sutlej due to discharge of water from bhakra dam has caused extensive damage to crops, inundating 326 villages of ropar, ludhiana, jalandhar, moga, ferozepur and kapurthala",lives,8,86,38,3,135,"fazilka, ferozepur, jalandhar, kapurthala, ludhiana, moga"
8/22/19,https://www.tribuneindia.com/news/punjab/farmers-stare-at-losses-govt-empty-coffers/820671.html," the sources agree that on an average, punjab has had to release rs 100-150 crore crop damage compensation to farmers each year for the past seven years",lives,8,86,38,3,135,"fazilka, ferozepur, jalandhar, kapurthala, ludhiana, moga"
8/22/19,https://www.tribuneindia.com/news/punjab/farmers-stare-at-losses-govt-empty-coffers/820671.html," in 2015, because of the whitefly attack on cotton, crop worth rs 650 crore was damaged",lives,8,86,38,3,135,"fazilka, ferozepur, jalandhar, kapurthala, ludhiana, moga"
8/22/19,https://www.tribuneindia.com/news/punjab/farmers-stare-at-losses-govt-empty-coffers/820671.html,"in all, 368 people rescued in ferozepur, 60 in ludhiana and 200 in sultanpur lodhi",lives,8,86,38,3,135,"fazilka, ferozepur, jalandhar, kapurthala, ludhiana, moga"
8/22/19,https://www.tribuneindia.com/news/punjab/farmers-stare-at-losses-govt-empty-coffers/820671.html," 326 villages & 1.20 lakh acres flooded across state  rs 750-cr loss estimated on account of damage to crops 5,023 people rescued from¬†affected villages",lives,8,86,38,3,135,"fazilka, ferozepur, jalandhar, kapurthala, ludhiana, moga"
8/22/19,https://www.tribuneindia.com/news/punjab/help-pours-in-for-flood-hit-in-ropar/820668.html,"tribune news service  ropar, august 21  people from various parts of the state have come forward to help the flood victims in ropar district by donating essential items",lives,16,2,4,0,22,"fatehgarh sahib, ludhiana, sri muktsar sahib"
8/22/19,https://www.tribuneindia.com/news/punjab/help-pours-in-for-flood-hit-in-ropar/820668.html,"ush({ });  rana, who was interacting with the media after visiting the affected villages along with dc sumeet kumar jarangal, said there was no chance of floods in the area due to discharge from bhakra dam as the capacity of the sutlej was 2 lakh cusecs",lives,16,2,4,0,22,"fatehgarh sahib, ludhiana, sri muktsar sahib"
8/22/19,https://www.tribuneindia.com/news/punjab/help-pours-in-for-flood-hit-in-ropar/820668.html,"  he said the district administration, with help of the ndrf team, rescued over 500 people",lives,16,2,4,0,22,"fatehgarh sahib, ludhiana, sri muktsar sahib"
8/22/19,https://www.tribuneindia.com/news/punjab/part-of-dhussi-bundh-erodes-flood-threat-back-in-ludhiana/820665.html,"harshraj singh  tribune news service  ludhiana, august 21  a major portion of the dhussi bundh of the sutlej was damaged at garhi fazal near mattewara village of ludhiana district in the wee hours of wednesday, posing a threat of floods in nearby areas yet again",lives,9,7,21,0,37,ludhiana
8/22/19,https://www.tribuneindia.com/news/punjab/part-of-dhussi-bundh-erodes-flood-threat-back-in-ludhiana/820665.html,"when announcements about the damaged bundh were made in the gurdwaras of nearby villages around 4 am, over 400 residents rushed to the site and made efforts to protect the remaining portion",lives,9,7,21,0,37,ludhiana
8/22/19,https://www.tribuneindia.com/news/punjab/part-of-dhussi-bundh-erodes-flood-threat-back-in-ludhiana/820665.html, sidhu said chief minister capt amrinder singh immediately released a financial aid of rs 2 crore for flood protection works to the superintendent engineers of the water resources department so that no problems were faced during relief measures,lives,9,7,21,0,37,ludhiana
8/22/19,https://www.tribuneindia.com/news/punjab/part-of-dhussi-bundh-erodes-flood-threat-back-in-ludhiana/820665.html, special chief secy visits bundh site  special chief secretary kbs sidhu on wednesday visited the site where the breach in the sutlej was about to occur he reviewed the flood control arrangements and issued necessary instructions to the authorities on the relief work being done sidhu said the chief minister has released a financial aid of  rs 2 crore for carrying out flood protection works without any obstruction ,lives,9,7,21,0,37,ludhiana
8/21/19,https://www.tribuneindia.com/news/punjab/punjab-cm-writes-to-pm-for-rs-1000-crore-special-flood-relief-package/820655.html,punjab cm writes to pm for rs 1000 crore special flood relief package,lives,24,22,42,0,88,"ferozepur, jalandhar, kapurthala, ludhiana"
8/21/19,https://www.tribuneindia.com/news/punjab/punjab-cm-writes-to-pm-for-rs-1000-crore-special-flood-relief-package/820655.html," the flooding in river sutlej due to the discharge of water from bhakra dam, the heaviest since 1958, had caused extensive damage to the standing crops and inundation of residential areas in the villages, the chief minister said, adding that an early estimate suggested the damage to be to the extent of rs 1700 crore",lives,24,22,42,0,88,"ferozepur, jalandhar, kapurthala, ludhiana"
8/21/19,https://www.tribuneindia.com/news/punjab/punjab-cm-writes-to-pm-for-rs-1000-crore-special-flood-relief-package/820655.html,"  he said though necessary assistance was given by the army authorities, the floods in river sutlej had severely damaged standing crops, houses and other rural and urban infrastructure at many places, especially in the districts of ropar, ludhiana, jalandhar and kapurthala covering over 100 villages",lives,24,22,42,0,88,"ferozepur, jalandhar, kapurthala, ludhiana"
8/21/19,https://www.tribuneindia.com/news/punjab/punjab-cm-writes-to-pm-for-rs-1000-crore-special-flood-relief-package/820655.html,"  according to the spokesperson, with rescue and relief operations on war footing, 5023 people had so far been rescued from the affected villages",lives,24,22,42,0,88,"ferozepur, jalandhar, kapurthala, ludhiana"
8/21/19,https://www.tribuneindia.com/news/punjab/punjab-cm-writes-to-pm-for-rs-1000-crore-special-flood-relief-package/820655.html," more than 36,000 ‚Äòparanthas‚Äô and 18,000 packets of dry ration along with water bottles had been air dropped for the residents of all the 18 affected villages of jalandhar with the help of the indian army",lives,24,22,42,0,88,"ferozepur, jalandhar, kapurthala, ludhiana"
8/21/19,https://www.tribuneindia.com/news/punjab/punjab-cm-writes-to-pm-for-rs-1000-crore-special-flood-relief-package/820655.html,  the relief packets were transported to jalandhar cantonment earlier in the day and were then loaded on to six army helicopters under the supervision of deputy commissioner and senior superintendent of police,lives,24,22,42,0,88,"ferozepur, jalandhar, kapurthala, ludhiana"
8/21/19,https://www.tribuneindia.com/news/punjab/punjab-cm-writes-to-pm-for-rs-1000-crore-special-flood-relief-package/820655.html," in ferozepur alone, 368 persons were rescued by the jawans of national disaster response force (ndrf) and indian army during a special rescue operation",lives,24,22,42,0,88,"ferozepur, jalandhar, kapurthala, ludhiana"
8/21/19,https://www.tribuneindia.com/news/punjab/punjab-cm-writes-to-pm-for-rs-1000-crore-special-flood-relief-package/820655.html," in ludhiana, the administration successfully averted a possible breach in mattewada complex around village ghadi fazil, while more than 60 persons had been evacuated from the five affected villages of the district",lives,24,22,42,0,88,"ferozepur, jalandhar, kapurthala, ludhiana"
8/21/19,https://www.tribuneindia.com/news/punjab/punjab-cm-writes-to-pm-for-rs-1000-crore-special-flood-relief-package/820655.html," in kapurthala district, more than 200 persons had been rescued in 62 villages in the sultanpur lodhi area",lives,24,22,42,0,88,"ferozepur, jalandhar, kapurthala, ludhiana"
8/21/19,https://www.tribuneindia.com/news/punjab/punjab-cm-writes-to-pm-for-rs-1000-crore-special-flood-relief-package/820655.html,"  in ropar, 86 multi-purpose health workers, 111 anm nurses along with 40 fully equipped medical vans had been pressed into service to conduct special health camps for flood-affected persons and provide them necessary medical care",lives,24,22,42,0,88,"ferozepur, jalandhar, kapurthala, ludhiana"
8/21/19,https://www.tribuneindia.com/news/punjab/punjab-cm-writes-to-pm-for-rs-1000-crore-special-flood-relief-package/820655.html,  as many as 10 relief centres had also been set up to rehabilitate the displaced families.,lives,24,22,42,0,88,"ferozepur, jalandhar, kapurthala, ludhiana"
8/21/19,https://www.tribuneindia.com/news/punjab/300-punjab-villages-badly-affected-by-floods/820611.html,300 punjab villages badly affected by floods,lives,8,8,22,0,38,"ferozepur, gurdaspur, jalandhar, pathankot, sas nagar"
8/21/19,https://www.tribuneindia.com/news/punjab/300-punjab-villages-badly-affected-by-floods/820611.html,"chandigarh, august 21more than 300 villages, mainly in punjab's ropar, jalandhar and ferozepur districts, were badly affected in floods by the satluj river, damaging crops in thousands of acres and forcing thousands of villagers to spend nights on rooftops",lives,8,8,22,0,38,"ferozepur, gurdaspur, jalandhar, pathankot, sas nagar"
8/21/19,https://www.tribuneindia.com/news/punjab/300-punjab-villages-badly-affected-by-floods/820611.html,ush({ });  he also asked the finance department to immediately clear the pending relief funds to the tune of around rs 100 crore for expeditious disbursement by the revenue department through the respective deputy commissioners,lives,8,8,22,0,38,"ferozepur, gurdaspur, jalandhar, pathankot, sas nagar"
8/21/19,https://www.tribuneindia.com/news/punjab/rainfall-subsides-rivers-still-swollen/820229.html, over 150 villages in kapurthala and jalandhar have been affected by floods of which over 70 are completely submerged,lives,34,15,52,1,102,"jalandhar, kapurthala, sangrur"
8/21/19,https://www.tribuneindia.com/news/punjab/rainfall-subsides-rivers-still-swollen/820229.html,"villagers said in around 80-100 deras (field homes), residents had not been rescued",lives,34,15,52,1,102,"jalandhar, kapurthala, sangrur"
8/21/19,https://www.tribuneindia.com/news/punjab/rainfall-subsides-rivers-still-swollen/820229.html," in lohian village alone, 700-800 persons had been stranded on rooftops with no tarpaulins or even clean drinking water",lives,34,15,52,1,102,"jalandhar, kapurthala, sangrur"
8/21/19,https://www.tribuneindia.com/news/punjab/rainfall-subsides-rivers-still-swollen/820229.html,"however, over 200 persons have been rescued and only 50-100 men have stayed back",lives,34,15,52,1,102,"jalandhar, kapurthala, sangrur"
8/21/19,https://www.tribuneindia.com/news/punjab/rainfall-subsides-rivers-still-swollen/820229.html,  jalandhar dc varinder sharma said: ‚Äúthe chief minister has given a go-ahead for deploying three helicopters to airdrop food and water supplies to villagers stranded at lohian,lives,34,15,52,1,102,"jalandhar, kapurthala, sangrur"
8/21/19,https://www.tribuneindia.com/news/punjab/rainfall-subsides-rivers-still-swollen/820229.html,"  in july,¬† floods had damaged standing crops over 10,000 acres in bhundar bhaini, surjan bhaini, salemgarh, phullad villages and surrounding areas",lives,34,15,52,1,102,"jalandhar, kapurthala, sangrur"
8/21/19,https://www.tribuneindia.com/news/punjab/rainfall-subsides-rivers-still-swollen/820229.html,amarinder singh during his visit to flood-affected areas of moonak on july 23 had announced that he would urge the centre to give the clearance to the phase ii of the river project from makror sahib to karail,lives,34,15,52,1,102,"jalandhar, kapurthala, sangrur"
8/21/19,https://www.tribuneindia.com/news/punjab/rainfall-subsides-rivers-still-swollen/820229.html," ‚Äî tns  88 villages¬†submerged in kapurthala¬†district alone 60 villages¬†flooded in jalandhar after¬† breach in mandala  admn to plug gaps, locals call it eyewash  while the jalandhar administration said breaches would be plugged with the army help, mandala, janian, janian chahal and kapurthala villagers said the announcement was eyewash after repeated calls to officials went ‚Äòunanswered‚Äô, janian and madala villagers deployed jcbs and trolleys to plug breaches ",lives,34,15,52,1,102,"jalandhar, kapurthala, sangrur"
8/21/19,https://www.tribuneindia.com/news/punjab/flooded-ropar-villages-left-high-and-dry/820215.html,"‚Äúalso, the work on restoring the drinking water supply is in full swing and the district administration has already got rs 35 lakh from the state government to provided immediate relief to the people affected by floods",lives,9,6,32,0,47,punjab
8/21/19,https://www.tribuneindia.com/news/punjab/flooded-ropar-villages-left-high-and-dry/820215.html," rs 4-lakh ex gratia for toddler‚Äôs kin  the district administration has announced a relief of rs 4 lakh for the parents of a three-year-old girl, sundari, who got drowned in flood water at nurpur bedi",lives,9,6,32,0,47,punjab
8/21/19,https://www.tribuneindia.com/news/punjab/500-acres-inundated-in-fazilka-water-rising/820212.html,"these relief camps have been set up in mauzam, salemshah, asafwala hasta kalan villages and one in sant kabir polytechnical college in fazilka subdivision",lives,5,9,18,0,32,"fazilka, ferozepur, sas nagar"
8/21/19,https://www.tribuneindia.com/news/punjab/residents-on-edge/820209.html," while around 50 villages, including gidderpindi, kutbewal, kalu mundi and nawan pind khalewal, were affected in jalandhar, around 30 were flooded in kapurthala",lives,15,28,23,2,68,"jalandhar, kapurthala"
8/21/19,https://www.tribuneindia.com/news/punjab/residents-on-edge/820209.html,"  sukhdev singh, another farmer, said his 10 acres were completely destroyed",lives,15,28,23,2,68,"jalandhar, kapurthala"
8/21/19,https://www.tribuneindia.com/news/punjab/residents-on-edge/820209.html, 400 shifted to camps  over 400 displaced villagers will be spending the night at makeshift camps in shahkot (lohian) and phillaur alone,lives,15,28,23,2,68,"jalandhar, kapurthala"
8/21/19,https://www.tribuneindia.com/news/punjab/punjab-rain-loss-rs-1-700-crore/820174.html,"‚Äúthe state has suffered an estimated loss of around rs 1,700 crore,‚Äù said cm capt amarinder singh",lives,8,29,31,0,68,"fazilka, ferozepur, jalandhar, kapurthala, ludhiana, moga, sas nagar, tarn taran"
8/21/19,https://www.tribuneindia.com/news/punjab/punjab-rain-loss-rs-1-700-crore/820174.html,"  thirty-six villages in ropar, 16 in ferozepur and 28 in moga have been evacuated over the past two days",lives,8,29,31,0,68,"fazilka, ferozepur, jalandhar, kapurthala, ludhiana, moga, sas nagar, tarn taran"
8/21/19,https://www.tribuneindia.com/news/punjab/punjab-rain-loss-rs-1-700-crore/820174.html,as many as 350 persons have been rescued in moga and 274 in ferozepur,lives,8,29,31,0,68,"fazilka, ferozepur, jalandhar, kapurthala, ludhiana, moga, sas nagar, tarn taran"
8/21/19,https://www.tribuneindia.com/news/punjab/punjab-rain-loss-rs-1-700-crore/820174.html," though the exact extent of damage will be known only after the special¬†  girdawri is carried out, initial reports by the revenue department show that 30,000 acres of cultivated land was submerged in jalandhar; 21,000 acres in tarn taran; 14,500 in ludhiana; 13,000 in moga; and 7,000 acres in ferozepur",lives,8,29,31,0,68,"fazilka, ferozepur, jalandhar, kapurthala, ludhiana, moga, sas nagar, tarn taran"
8/21/19,https://www.tribuneindia.com/news/punjab/punjab-rain-loss-rs-1-700-crore/820174.html,"‚Äî tns  5,629 water supply schemes hit in hp  rains have claimed 63 lives in hp from june 1 to august 20 while the loss due to heavy rains and cloudbursts is estimated at rs 626 crore¬† as many as 5,629 water supply & irrigation schemes have been affected and 799 houses damaged",lives,8,29,31,0,68,"fazilka, ferozepur, jalandhar, kapurthala, ludhiana, moga, sas nagar, tarn taran"
8/21/19,https://www.tribuneindia.com/news/punjab/punjab-rain-loss-rs-1-700-crore/820174.html,"as many as 824 roads still remain closed the met office has predicted rains and thunderstorm in lower, mid and higher hills in the next six days from august 21 to august 26  hry flood-hit shifted¬† sonepat & karnal: 25 families evacuated in the two districts 11,000 acres submerged karnal fields: 7,100 acres of paddy, 3,000 of sugarcane and¬†900 acres of maize submerged 35 villages affected yamunanagar: standing crops on 1,972 hectares, 35 villages affected, as per initial reports",lives,8,29,31,0,68,"fazilka, ferozepur, jalandhar, kapurthala, ludhiana, moga, sas nagar, tarn taran"
8/21/19,https://www.tribuneindia.com/news/punjab/displaced-ferozepur-residents-demand-permanent-solution/820167.html," ndrf officials said they rescued and shifted more than 100 people to safer places, but at a few locations, the residents refused to come out of their houses and preferred to stay on rooftops",lives,22,6,18,1,47,ferozepur
8/20/19,https://www.tribuneindia.com/news/punjab/punjab-on-edge-rivers-in-spate/819828.html, he also asked the finance department to release rs 100 crore as relief fund,lives,4,14,14,0,32,"fazilka, ferozepur, jalandhar, ludhiana, pathankot, sbs nagar"
8/20/19,https://www.tribuneindia.com/news/punjab/punjab-on-edge-rivers-in-spate/819828.html,"‚Äî tns  fields inundated, bundhs breached 81 villages¬†¬†flooded after bundhs breached at nine places¬†in jalandhar  army called out in ferozepur to assist in rescue and¬†relief operations 35 villages flooded in ropar; breaches¬†in river embankments in ludhiana  over 1,000 roads closed¬† shimla 459mandi 314 kangra 191hamirpur 91",lives,4,14,14,0,32,"fazilka, ferozepur, jalandhar, ludhiana, pathankot, sbs nagar"
8/20/19,https://www.tribuneindia.com/news/punjab/army-roped-in-for-help-in-ferozepur/819827.html, several villages near harike are already inundated due to which people in 52 villages have already been asked to move to relief camps set up by the district administration,lives,3,9,14,0,26,"bathinda, ferozepur, hoshiarpur, jalandhar, ludhiana, sas nagar"
8/20/19,https://www.tribuneindia.com/news/punjab/army-roped-in-for-help-in-ferozepur/819827.html,the dc said 240 army men had been deployed along with 12 motorboats in the makhu and zira areas to help evacuate the people,lives,3,9,14,0,26,"bathinda, ferozepur, hoshiarpur, jalandhar, ludhiana, sas nagar"
8/20/19,https://www.tribuneindia.com/news/punjab/army-roped-in-for-help-in-ferozepur/819827.html,"  also at some places, the barbed-wire fencing erected along the indo-pakistan border has also been damaged and a few bsf border outposts have been submerged along the zero line",lives,3,9,14,0,26,"bathinda, ferozepur, hoshiarpur, jalandhar, ludhiana, sas nagar"
8/20/19,https://www.tribuneindia.com/news/punjab/70-ft-breach-in-sutlej-adds-to-misery-rescue-ops-on/819818.html,70-ft breach in sutlej adds to misery; rescue ops on,lives,12,11,31,0,54,"jalandhar, ludhiana"
8/20/19,https://www.tribuneindia.com/news/punjab/70-ft-breach-in-sutlej-adds-to-misery-rescue-ops-on/819818.html,  hundreds of acres of agricultural land has submerged in the affected villages,lives,12,11,31,0,54,"jalandhar, ludhiana"
8/20/19,https://www.tribuneindia.com/news/punjab/cm-orders-girdawari-rs-100-cr-relief/819814.html,"cm orders girdawari, rs 100-cr relief",lives,10,6,19,0,35,punjab
8/20/19,https://www.tribuneindia.com/news/punjab/cm-orders-girdawari-rs-100-cr-relief/819814.html,"tribune news service ropar, august 19  chief minister capt amarinder singh on monday ordered a special girdawari to assess the loss suffered by farmers and announced¬†  rs 100 crore for emergency relief and rehabilitation measures in the flood-hit areas of the state",lives,10,6,19,0,35,punjab
8/20/19,https://www.tribuneindia.com/news/punjab/cm-orders-girdawari-rs-100-cr-relief/819814.html," he then visited khairabad village, one of the worst-affected areas",lives,10,6,19,0,35,punjab
8/20/19,https://www.tribuneindia.com/news/punjab/cm-orders-girdawari-rs-100-cr-relief/819814.html," talking to the media, the cm described the situation as unprecedented and said nearly 3,000 people in the district were displaced due to floods",lives,10,6,19,0,35,punjab
8/19/19,https://www.tribuneindia.com/news/punjab/capt-amarinder-earmarks-rs-100-cr-for-flood-relief/819785.html,capt amarinder earmarks rs 100 cr for flood relief,lives,7,5,13,0,25,"ludhiana, sas nagar"
8/19/19,https://www.tribuneindia.com/news/punjab/capt-amarinder-earmarks-rs-100-cr-for-flood-relief/819785.html,"tribune news service  rupnagar, august 19  punjab chief minister amarinder singh announced on monday that his government would earmark rs 100 crore for flood relief, as reports of large-scale damage to property continues to trickle in from the various parts of the state",lives,7,5,13,0,25,"ludhiana, sas nagar"
8/19/19,https://www.tribuneindia.com/news/punjab/capt-amarinder-earmarks-rs-100-cr-for-flood-relief/819785.html," ropar is one of the worst hit districts of the state: as waters of sutlej and its tributaries, budhki and sarsa, swelled, district administration ordered evacuation of some 35 villages on monday",lives,7,5,13,0,25,"ludhiana, sas nagar"
8/19/19,https://www.tribuneindia.com/news/punjab/ropar-dc-gives-his-number-to-distressed-elderly-woman-in-flood-affected-area/819784.html,"tribune web desk chandigarh, august 19  in flood-affected ropar, deputy commissioner sumeet jarangal went beyond the call of duty as he gave a distressed elderly woman‚Äîwhose ‚Äòkuccha‚Äô house was washed away in the flood‚Äîhis contact number",lives,1,3,15,0,19,punjab
8/19/19,https://www.tribuneindia.com/news/punjab/ropar-dc-gives-his-number-to-distressed-elderly-woman-in-flood-affected-area/819784.html,"keeping in view the deteriorating situation, the district administration on sunday ordered evacuation from 35 villages and other locations on the banks of the budhki and sarsa rivers.",lives,1,3,15,0,19,punjab
8/19/19,https://www.tribuneindia.com/news/punjab/pull-up-socks-abohar-sdm-tells-officials/819449.html,"abohar, august 18 as excess water released from bhakra dam was likely to affect the gang canal that passes through abohar, sub-divisional magistrate poonam singh on sunday held an emergency meeting with the officials of the irrigation, drainage, sanitation, sewerage and education departments to ensure the relief arrangements",lives,0,0,2,0,2,punjab
8/19/19,https://www.tribuneindia.com/news/punjab/chief-secy-meets-dcs-demands-ground-report/819447.html,"‚Äúwater is standing in the fields and if it subsides within two-three days, the crops will be safe,‚Äù he said, adding that he had issued instructions to all field staff to help farmers drain out the standing water from fields",lives,2,17,5,0,24,"ferozepur, gurdaspur, jalandhar, ludhiana, pathankot, sbs nagar"
8/19/19,https://www.tribuneindia.com/news/punjab/jalandhar-villagers-caught-unawares-blame-authorities/819441.html,"aparna banerji  tribune news service  jalandhar, august 18  the flood-like situation in the district has triggered evacuation in 85 villages",lives,14,22,31,0,67,"jalandhar, sbs nagar"
8/19/19,https://www.tribuneindia.com/news/punjab/jalandhar-villagers-caught-unawares-blame-authorities/819441.html," while a holiday has already been declared in nawanshahr, in jalandhar as many as 31 flood relief centres have been created and two teams of the ndrf, one of the sdrf along with three army teams have been summoned for help with relief work",lives,14,22,31,0,67,"jalandhar, sbs nagar"
8/19/19,https://www.tribuneindia.com/news/punjab/jalandhar-villagers-caught-unawares-blame-authorities/819441.html,"the district administration said directions had been issued for evacuation of 63 villages in shahkot, 13 phillaur and 9 nakodar",lives,14,22,31,0,67,"jalandhar, sbs nagar"
8/19/19,https://www.tribuneindia.com/news/punjab/jalandhar-villagers-caught-unawares-blame-authorities/819441.html,"with news of release of 2 lakh cusecs of water from the bhakra dam this afternoon, villages along the sutlej in shahkot go little time to prepare for evacuation",lives,14,22,31,0,67,"jalandhar, sbs nagar"
8/19/19,https://www.tribuneindia.com/news/punjab/jalandhar-villagers-caught-unawares-blame-authorities/819441.html," army rescues 2 men, cattle from sutlej  an army team deputed at nawanshahr saved two people, besides nine rearing animals, from the sutlej near mattewara bridge at begowal village of the district on sunday a migrant labourer living in a room in the fields of a farmer was stuck as the flow of river water increased suddenly",lives,14,22,31,0,67,"jalandhar, sbs nagar"
8/19/19,https://www.tribuneindia.com/news/punjab/52-low-lying-ferozepur-areas-inundated-shifting-ordered/819439.html," looking at the grim situation, around 52 villages along the river, including 38 in ferozepur subdivision and another 14 in zira, have already been asked to evacuate following release of excess water from bhakhra dam through spill gates after heavy rainfall in its catchment area, which is likely to reach here tonight",lives,2,5,14,0,21,ferozepur
8/19/19,https://www.tribuneindia.com/news/punjab/52-low-lying-ferozepur-areas-inundated-shifting-ordered/819439.html," even before that, hundreds of acres of fertile agriculture land in these villages, most of which are situated on the riverbed, is feared marooned and more damage is anticipated after about 2.40 lakh cusecs of water released from bhakhra reaches downstream harike in a few hours",lives,2,5,14,0,21,ferozepur
8/18/19,https://www.tribuneindia.com/news/punjab/imd-says-rain-will-weaken-in-24-hours/819318.html,"vibha sharma  tribune news service  new delhi, august 18 the indian meteorological department said rain will weaken in the region in 24 hours‚Äîa development that comes as a relief for several states in the north that have reported heavy flooding",lives,4,5,5,0,14,punjab
8/18/19,https://www.tribuneindia.com/news/punjab/imd-says-rain-will-weaken-in-24-hours/819318.html," incessant rain and strong winds in himachal pradesh caused flood and landslides, killing at least nine people and leading to damage to infrastructure and property over the last two days",lives,4,5,5,0,14,punjab
8/19/19,https://www.tribuneindia.com/news/punjab/flood-threat-rises-in-punjab-haryana-authorities-go-into-huddle/819286.html,authorities ordered nearly one dozen villages to be evacuated near budhki and sarsa rivers,lives,19,8,21,1,49,"fatehgarh sahib, gurdaspur, ludhiana, pathankot, patiala, sas nagar, sbs nagar"
8/19/19,https://www.tribuneindia.com/news/punjab/flood-threat-rises-in-punjab-haryana-authorities-go-into-huddle/819286.html," in gurdaspur, 11 people, including four women, were rescued after they got stuck when the overflowing water of beas river flooded their village in gurdaspur district, an official said on sunday",lives,19,8,21,1,49,"fatehgarh sahib, gurdaspur, ludhiana, pathankot, patiala, sas nagar, sbs nagar"
8/18/19,https://www.tribuneindia.com/news/punjab/threat-looms-over-85-jalandhar-villages/819014.html," executive engineer, jalandhar division, ajit singh (in charge for kapurthala) also, said the strengthening work was recently done at baguana, baopur and sandhla to avoid damage during floods",lives,4,9,16,0,29,"jalandhar, kapurthala"
8/17/19,https://www.tribuneindia.com/news/punjab/torrential-rain-lashes-northern-states-alert-sounded-in-punjab/818855.html,"shimla/jaipur/thiruvananthapuram, august 17   heavy rain lashed northern states on saturday, with an alert sounded in punjab following release of excess water from bhakra dam and the chambal river in rajasthan flowing 12 metre above the danger mark, while normalcy was slowly returning to flood-ravaged kerala, where so far 113 people have lost their lives",lives,17,13,16,0,46,"amritsar, ludhiana, sas nagar"
8/17/19,https://www.tribuneindia.com/news/punjab/torrential-rain-lashes-northern-states-alert-sounded-in-punjab/818855.html," heavy rains also disrupted normal life in jammu, where a 47-year-old man was feared drowned while 15 people were rescued following flash floods in kathua and samba districts",lives,17,13,16,0,46,"amritsar, ludhiana, sas nagar"
8/17/19,https://www.tribuneindia.com/news/punjab/torrential-rain-lashes-northern-states-alert-sounded-in-punjab/818855.html," people have started moving to their homes from relief camps in kerala, even as the toll climbed to 113, with authorities retrieving more bodies from landslide-hit malappuram and wayanad districts",lives,17,13,16,0,46,"amritsar, ludhiana, sas nagar"
8/17/19,https://www.tribuneindia.com/news/punjab/torrential-rain-lashes-northern-states-alert-sounded-in-punjab/818855.html," fifty people have so far lost their lives in malappuram and 12 in wayanad, the two northern districts, where 28 people are still missing",lives,17,13,16,0,46,"amritsar, ludhiana, sas nagar"
8/5/19,https://www.tribuneindia.com/news/punjab/release-compensation-to-flood-hit-dhindsa/813067.html,"tribune news service sangrur, august 4  even after thousands of acres of standing crops was destroyed after a breach in the ghaggar last month, the authorities concerned are yet to take action to strengthen the river embankments",lives,3,11,6,4,24,sangrur
7/30/19,https://www.tribuneindia.com/news/punjab/dhindsa-urges-centre-punjab-gov-to-provide-compensation-to-ghaggar-flood-hit/810300.html,"ingh tribune news service new delhi, july 30  rajya sabha mp ss dhindsa on tuesday urged the centre and state government to compensate residents who were affected by floods due to the breach along the ghaggar river",lives,5,2,12,3,22,sangrur
7/30/19,https://www.tribuneindia.com/news/punjab/dhindsa-urges-centre-punjab-gov-to-provide-compensation-to-ghaggar-flood-hit/810300.html,the affected villages were inundated and marooned for five days,lives,5,2,12,3,22,sangrur
7/30/19,https://www.tribuneindia.com/news/punjab/dhindsa-urges-centre-punjab-gov-to-provide-compensation-to-ghaggar-flood-hit/810300.html," speaking to the tribune, dhindsa said that the first phase of the project to channelize the river cost rs 40 crore",lives,5,2,12,3,22,sangrur
7/29/19,https://www.tribuneindia.com/news/punjab/ludhiana-cycle-valley-to-be-operational-by-2022/809300.html,"the project will entail a cost of rs 300 crore,‚Äù he said in an official statement here",lives,0,11,5,1,17,ludhiana
7/24/19,https://www.tribuneindia.com/news/punjab/khalsa-aid-serves-ration-to-over-4-000-flood-victims-in-assam/807098.html,"khalsa aid serves ration to over 4,000 flood victims in assam",lives,12,1,6,0,19,punjab
7/24/19,https://www.tribuneindia.com/news/punjab/khalsa-aid-serves-ration-to-over-4-000-flood-victims-in-assam/807098.html,"tribune web desk¬†  chandigarh, july 24  assam has been battling a severe flood crisis, and khalsa aid india are here to help",lives,12,1,6,0,19,punjab
7/24/19,https://www.tribuneindia.com/news/punjab/khalsa-aid-serves-ration-to-over-4-000-flood-victims-in-assam/807098.html,"  the good samairtans of the non-profit aid and relief organisation have reached assam and are trying to provide ration to at least 4,000 people",lives,12,1,6,0,19,punjab
7/24/19,https://www.tribuneindia.com/news/punjab/khalsa-aid-serves-ration-to-over-4-000-flood-victims-in-assam/807098.html,  they wrote: ‚Äúassam floods: our @khalsaaid_india team is providing food rations to 4000 people who have been affected by the floods in #assam! much more to do,lives,12,1,6,0,19,punjab
7/24/19,https://www.tribuneindia.com/news/punjab/khalsa-aid-serves-ration-to-over-4-000-flood-victims-in-assam/807098.html,  assam floods:    our @khalsaaid_india team is providing food rations to 4000 people who have been affected by the floods in #assam  ! much more to do,lives,12,1,6,0,19,punjab
7/24/19,https://www.tribuneindia.com/news/punjab/khalsa-aid-serves-ration-to-over-4-000-flood-victims-in-assam/807098.html, torrential rains have affected at least 27 of assam‚Äôs 33 districts,lives,12,1,6,0,19,punjab
7/24/19,https://www.tribuneindia.com/news/punjab/khalsa-aid-serves-ration-to-over-4-000-flood-victims-in-assam/807098.html,"at last count, 48.87 lakh people have been displaced from their homes.",lives,12,1,6,0,19,punjab
7/23/19,https://www.tribuneindia.com/news/punjab/ghaggar-flood-capt-urges-haryana-to-join-hands-says-relief-after-survey/806555.html,"tribune news service  sangrur/patiala, july 23  blaming the akalis for the control of the ghaggar river going to  the central water commission (cwc), chief minister capt amarinder singh  on tuesday said he would meet central ministers and officials to press  for reinforcement of the embankments of the river, which had breached  causing serious damage to standing crop and other assets in sangrur and  patiala",lives,3,30,40,3,76,"bathinda, patiala, sangrur"
7/23/19,https://www.tribuneindia.com/news/punjab/ghaggar-flood-capt-urges-haryana-to-join-hands-says-relief-after-survey/806555.html," the cm, who flew over rajpura, ghanaur and shutrana before stopping  over at moonak, said about 50,000 acres of crop had been lost in patiala  and another 10,000 acres in sangrur due to the breach",lives,3,30,40,3,76,"bathinda, patiala, sangrur"
7/23/19,https://www.tribuneindia.com/news/punjab/ghaggar-flood-capt-urges-haryana-to-join-hands-says-relief-after-survey/806555.html," in moonak, the cm ordered the dc to pay immediate compensation to the  28 houses damaged, three of them completely, as a result of the  flooding",lives,3,30,40,3,76,"bathinda, patiala, sangrur"
7/23/19,https://www.tribuneindia.com/news/punjab/ghaggar-flood-capt-urges-haryana-to-join-hands-says-relief-after-survey/806555.html,he assured construction of 33 kucha houses that had been  damaged in the flooding,lives,3,30,40,3,76,"bathinda, patiala, sangrur"
7/23/19,https://www.tribuneindia.com/news/punjab/ghaggar-flood-capt-urges-haryana-to-join-hands-says-relief-after-survey/806555.html, the cm thanked the 1st armoured division of the army based in patiala  for the help extended to the district administration in providing  relief to the people,lives,3,30,40,3,76,"bathinda, patiala, sangrur"
7/23/19,https://www.tribuneindia.com/news/punjab/ghaggar-flood-capt-urges-haryana-to-join-hands-says-relief-after-survey/806555.html, amarinder also announced rs 60 lakh for rebuilding the bridge that  had been damaged at sirkapda village of ghanaur,lives,3,30,40,3,76,"bathinda, patiala, sangrur"
7/22/19,https://www.tribuneindia.com/news/punjab/amarinder-to-conduct-aerial-survey-of-punjab-s-flood-hit-areas-on-tuesday/806064.html,"chandigarh, july 22 punjab chief minister amarinder singh will conduct an aerial survey of the flood-affected areas of the state‚Äôs sangrur and patiala districts on tuesday",lives,3,9,17,0,29,"patiala, sangrur"
7/22/19,https://www.tribuneindia.com/news/punjab/amarinder-to-conduct-aerial-survey-of-punjab-s-flood-hit-areas-on-tuesday/806064.html,"he later told the chief minister that three villages‚Äîbhunderbhaini, surjanbhaini and salemgarh‚Äîwere affected by the breach",lives,3,9,17,0,29,"patiala, sangrur"
7/22/19,https://www.tribuneindia.com/news/punjab/amarinder-to-conduct-aerial-survey-of-punjab-s-flood-hit-areas-on-tuesday/806064.html,"amarinder singh was informed that agricultural lands were hit in the three villages, but settlements were not affected",lives,3,9,17,0,29,"patiala, sangrur"
7/22/19,https://www.tribuneindia.com/news/punjab/ministers-visit-rain-hit-areas/805537.html,"tribune news service chandigarh/nangal, july 21  reviewing the relief works at rainfall-hit areas in patiala and sangrur districts, punjab water resources minister sukhbinder singh sarkaria today said the government would soon end the flood menace of the ghaggar, which created havoc in these two districts during monsoon",lives,1,2,6,0,9,"patiala, sangrur"
7/22/19,https://www.tribuneindia.com/news/punjab/ministers-visit-rain-hit-areas/805537.html," on the concluding day of his two-day visit to the rain-hit areas, sarkaria today visited phulad and khanauri in sangrur district and badshahpur and sirkapra villages in patiala district and reviewed the ongoing relief works",lives,1,2,6,0,9,"patiala, sangrur"
7/21/19,https://www.tribuneindia.com/news/punjab/over-22-000-acres-flooded-in-muktsar/805106.html,"as per the report, 30 villages were affected in muktsar sub-division, 26 in gidderbaha and two in malout",lives,0,44,11,0,55,"amritsar, bathinda, faridkot, ferozepur, moga, sri muktsar sahib"
7/20/19,https://www.tribuneindia.com/news/punjab/cotton-on-6-500-hectares-inundated/804780.html,"perneet singh  tribune news service  bathinda, july 19  following the heavy spell of rainfall in the region this week, farm leaders are claiming huge losses to cotton and paddy crops while seeking immediate ‚Äògirdawari‚Äô followed by adequate relief to the farming community",lives,1,70,43,0,114,"bathinda, mansa"
7/20/19,https://www.tribuneindia.com/news/punjab/cotton-on-6-500-hectares-inundated/804780.html,"  chief agriculture officer, bathinda, gs sidhu said they had got reports that cotton in 6,500 hectares and paddy in 4,000 hectares of area were submerged in the district, but there was no information of crop damage as yet",lives,1,70,43,0,114,"bathinda, mansa"
7/20/19,https://www.tribuneindia.com/news/punjab/cotton-on-6-500-hectares-inundated/804780.html," however, chief agriculture officer, mansa, gurmail singh chahal, said 62 acres of crop had been damaged in jhunir block due to canal breach",lives,1,70,43,0,114,"bathinda, mansa"
7/20/19,https://www.tribuneindia.com/news/punjab/cotton-on-6-500-hectares-inundated/804780.html," meanwhile, pau farm economist gs romana said both cotton and paddy crops could not survive, if rainwater remained stagnant in the field for two to three days",lives,1,70,43,0,114,"bathinda, mansa"
7/19/19,https://www.tribuneindia.com/news/punjab/rain-water-enters-muktsar-villages-locals-blame-admn/804083.html,"tribune news service muktsar, july 18  the recent rain has caused damage to paddy and cotton crops and green fodder in the district",lives,8,9,22,0,39,sri muktsar sahib
7/18/19,https://www.tribuneindia.com/news/punjab/ghaggar-threat-abates-in-patiala/803584.html,"over 300 acres at bolar kalan, 300 acres at chappad village and 100 acres at rathian and adjoining villages are affected",lives,12,25,42,0,79,"patiala, sangrur"
7/18/19,https://www.tribuneindia.com/news/punjab/ghaggar-threat-abates-in-patiala/803584.html,"ush({ });  ‚Äúpaddy crop can remain submerged till three days and remain unaffected,‚Äù said se davinder singh",lives,12,25,42,0,79,"patiala, sangrur"
7/18/19,https://www.tribuneindia.com/news/punjab/ghaggar-threat-abates-in-patiala/803584.html,"shawkat ahmad parray, additional deputy commissioner, said, ‚Äúwe have written to the state government and demanded rs 20 crore for immediate relief",lives,12,25,42,0,79,"patiala, sangrur"
7/16/19,https://www.tribuneindia.com/news/punjab/paddy-crop-on-hundreds-of-acres-submerged-in-moga-villages/802986.html," sanghera village sarpanch balkar singh claimed that paddy, green fodder and mint crops had been damaged on more than 1,500 acres of land inside the dhussi bandh in at least six villages and settlements",lives,1,29,23,0,53,moga
7/16/19,https://www.tribuneindia.com/news/punjab/ghaggar-crosses-danger-mark-in-patiala-flood-like-situation-in-bathinda/802957.html,"he said: ""people can call at 7037900013 and 0173352247 cell phone numbers for help",lives,5,0,6,0,11,"bathinda, patiala"
7/15/19,https://www.tribuneindia.com/news/punjab/visa-free-travel-for-5-000-pilgrims-daily/802215.html,"india sought visa-free and no-cost access seven days a week to 5,000 pilgrims of all faiths, including those holding persons of indian origin (pio) cards",lives,4,0,3,1,8,"amritsar, gurdaspur, sas nagar"
7/10/19,https://www.tribuneindia.com/news/punjab/maize-growers-opt-for-drip-irrigation/799660.html," according to an estimate, the installation of drip irrigation system on an acre costs around rs 1 lakh",lives,1,43,2,1,47,moga
6/23/19,https://www.tribuneindia.com/news/punjab/pak-corridor-road-is-not-all-weather/791587.html," the officials said construction of the 4.2-km stretch from dera baba nanak in gurdaspur district up to the border on the indian side at a cost of rs 120 crore was at different stages of completion, with 45 per cent of the job having been finished",lives,2,0,3,1,6,gurdaspur
6/14/19,https://www.tribuneindia.com/news/punjab/kin-of-7-martyrs-get-jobs-on-compassionate-grounds/787429.html," while commanding a helicopter unit in northeast in july 2017, wg cdr dhillion from patiala had carried out five sorties and evacuated 169 civilians marooned in flood-hit areas of arunachal pradesh",lives,5,3,4,0,12,"gurdaspur, moga, pathankot, patiala, sangrur, tarn taran"
6/14/19,https://www.tribuneindia.com/news/punjab/kin-of-7-martyrs-get-jobs-on-compassionate-grounds/787429.html,"ush({ });  the brothers of sepoy mandeep singh of sikh regiment and sepoy mandeep singh of engineers hailing from sangrur and tarn taran, respectively, who lost their lives in january 2018, are being given jobs",lives,5,3,4,0,12,"gurdaspur, moga, pathankot, patiala, sangrur, tarn taran"
6/13/19,https://www.tribuneindia.com/news/punjab/punjab-govt-to-give-jobs-to-relatives-of-7-armed-forces-personnel-killed-in-line-of-duty/787411.html, wing commander ms dhillon had made the supreme sacrifice in an air crash while evacuating civilians from flood-hit areas in arunachal pradesh in 2017,lives,13,4,2,0,19,"gurdaspur, moga, pathankot, sangrur"
6/13/19,https://www.tribuneindia.com/news/punjab/punjab-govt-to-give-jobs-to-relatives-of-7-armed-forces-personnel-killed-in-line-of-duty/787411.html," to ensure well-being of brave soldiers and their families, the spokesperson said the chief minister has assured that the state government would leave no stone unturned to rehabilitate them in government sector",lives,13,4,2,0,19,"gurdaspur, moga, pathankot, sangrur"
3/20/19,https://www.tribuneindia.com/news/punjab/kartarpur-corridor-villagers-in-pak-demand-compensation-for-their-land/746196.html,it said no ordinary compensation would be accepted and the affected families be given one job each,lives,17,16,19,7,59,gurdaspur
2/2/19,https://www.tribuneindia.com/news/punjab/sidhu-set-to-replace-sukhbir-s-gharukas-with-shikaras-at-harike/722784.html,"a 4k drone survey of the entire area   would be conducted at a cost of rs 41 lakh to identify weak habitat   zones, bolster the indigenous species therein, and augment breeding   habitats",lives,2,18,4,1,25,"amritsar, gurdaspur, jalandhar"
1/2/19,https://www.tribuneindia.com/news/punjab/test-all-punjab-hand-pumps-for-arsenic-study/707473.html,"it costs just rs 20 per test,‚Äù he said",lives,2,1,8,1,12,"gurdaspur, tarn taran"
1/2/19,https://www.tribuneindia.com/news/punjab/test-all-punjab-hand-pumps-for-arsenic-study/707473.html," indo-pak research 30,000¬†hand pumps/wells under study in india, pakistan 13,000¬†water sources on the indian side under study 25 researchers, including 15 from india, conducted the study health concerns  high arsenic levels in water are leading to slow poisoning, potentially causing skin lesions, damage to nervous system, stomach ailments, diabetes, renal toxicity, cardiovascular diseases and cancer because of high fluoride content in water, kids are facing dental and skeletal fluorosis, while high nitrate levels are causing gastric cancer, goitre and birth malformations ",lives,2,1,8,1,12,"gurdaspur, tarn taran"
9/28/18,https://www.tribuneindia.com/news/punjab/91-000-bags-of-illegally-stocked-rice-found/659951.html,"‚Äúi have sanctioned  rs 50,000 from the red cross society as an immediate relief to deceased's family members,‚Äù kharbanda said",lives,5,9,5,0,19,"amritsar, ferozepur, jalandhar, moga, sangrur, sri muktsar sahib"
9/28/18,https://www.tribuneindia.com/news/punjab/ghaggar-closer-to-danger-mark/659914.html,"tns water enters villages, 1,000 acres affected moga: water in the sutlej has suddenly increased to alarming levels in the district during the past 24 hours due to heavy rainfall in the catchments areas",lives,10,22,21,0,53,"faridkot, fazilka, moga, sangrur, sri muktsar sahib"
9/27/18,https://www.tribuneindia.com/news/punjab/compensation-for-2017-still-due-fresh-girdawari-ordered/659578.html,"deepkamal kaur tribune news service sultanpur lodhi, september26amidst complaints by farmers that they were yet to receive compensation for the crop loss assessed by the state government last year, punjab chief minister capt amarinder singh today¬†  conducted a survey of the same flood-affected villages along the beas",lives,6,30,25,5,66,"gurdaspur, hoshiarpur, kapurthala, tarn taran"
9/27/18,https://www.tribuneindia.com/news/punjab/compensation-for-2017-still-due-fresh-girdawari-ordered/659578.html,"kulwant singh of qadir baksh village and amrik singh of baupur rued, ‚Äúabout 7,000 acres of cultivated land in 16 villages has been completely affected",lives,6,30,25,5,66,"gurdaspur, hoshiarpur, kapurthala, tarn taran"
9/27/18,https://www.tribuneindia.com/news/punjab/compensation-for-2017-still-due-fresh-girdawari-ordered/659578.html," subedar major satnam singh, who told the chief minister that ‚Äúhe helped him play polo in 1985‚Äù, raised the demand for a permanent bridge to connect majha and doaba near the site",lives,6,30,25,5,66,"gurdaspur, hoshiarpur, kapurthala, tarn taran"
9/27/18,https://www.tribuneindia.com/news/punjab/cm-surveys-waterlogged-areas/659406.html,"tribune news service tarn taran, september 26  to assess the damage caused by the overflowing beas, chief minister capt amarinder singh surveyed the affected areas of tarn taran on wednesday",lives,10,25,14,2,51,tarn taran
9/26/18,https://www.tribuneindia.com/news/punjab/pm-modi-calls-up-punjab-cm-assures-help-to-tackle-floods/659166.html," a punjab government spokesperson said, ""the prime minister spoke to capt amarinder singh on phone of wednesday evening and inquired about the flood situation in the state, and assured him of all possible help in mitigating the situation arising out of floods and rains",lives,1,4,5,0,10,"kapurthala, tarn taran"
9/26/18,https://www.tribuneindia.com/news/punjab/capt-amarinder-singh-does-aerial-survey-of-flood-affected-areas/659125.html,"tribune news service chandigarh/jalandhar, september 26  chief minister capt amarinder singh on wednesday undertook an aerial survey of the flood-affected areas in punjab",lives,0,7,9,0,16,jalandhar
9/26/18,https://www.tribuneindia.com/news/punjab/capt-amarinder-singh-does-aerial-survey-of-flood-affected-areas/659125.html, the cm assured her of help and said the girdawari would be completed in the next three days,lives,0,7,9,0,16,jalandhar
9/25/18,https://www.tribuneindia.com/news/punjab/red-alert-after-heavy-rain-schools-colleges-shut-today/658394.html," officials in the control room of the revenue, rehabilitation and disaster management department said that towards 6 pm, the water inflow to the three dams had reduced compared with the inflow over the last 12 hours",lives,6,4,13,0,23,punjab
9/25/18,https://www.tribuneindia.com/news/punjab/red-alert-after-heavy-rain-schools-colleges-shut-today/658394.html,"a contingency fund of rs 7.4 crore has been placed at the disposal of dcs to get flood protection works executed, besides carrying out rescue operations",lives,6,4,13,0,23,punjab
9/25/18,https://www.tribuneindia.com/news/punjab/red-alert-after-heavy-rain-schools-colleges-shut-today/658394.html, army on alert  the army has been asked to remain on alert to help the state deal with any eventuality the cm orders special girdawari to assess crop damage leave of irrigation and drainage staff cancelled¬† people advised to exercise restraint while moving out of their houses during the next 24 hours¬† ,lives,6,4,13,0,23,punjab
9/24/18,https://www.tribuneindia.com/news/punjab/incessant-rain-punjab-issues-red-alert-asks-dist-admns-to-be-vigilant-army-on-standby/658083.html,the districts in the catchment areas of three rivers have  been    asked to arrange enough boats to rescue the affected people,lives,9,2,6,0,17,punjab
9/24/18,https://www.tribuneindia.com/news/punjab/incessant-rain-punjab-issues-red-alert-asks-dist-admns-to-be-vigilant-army-on-standby/658083.html,"the fcr informed the chief minister that a   contingency fund to the tune of rs 7.40 crore has been placed at the   disposal of the deputy commissioners to get flood protection works   executed, besides carrying out rescue operations",lives,9,2,6,0,17,punjab
9/16/18,https://www.tribuneindia.com/news/punjab/water-scarcity-serious-challenge-bbmb/653704.html,"tribune news service  chandigarh, september 15 stating that water scarcity is among the serious problems affecting punjab, chairman of the bhakra beas management board (bbmb) dk sharma cautioned stakeholders that the situation would get worse if remedial measures were not taken",lives,0,1,3,0,4,punjab
9/16/18,https://www.tribuneindia.com/news/punjab/water-scarcity-serious-challenge-bbmb/653704.html,"speaking at the 51st engineers‚Äô day celebrations organised by the punjabi engineers welfare society here on saturday, dk sharma said climate change was also affecting the pattern of rain, with erratic and scattered precipitation becoming a regular phenomenon as was being witnessed presently",lives,0,1,3,0,4,punjab
9/3/18,https://www.tribuneindia.com/news/punjab/judiciary-raises-rs1-5-cr-for-kerala/646875.html,"tribune news service  chandigarh, september 2 judges and staff at the punjab and haryana high court, besides judicial officers across punjab, haryana and chandigarh contributed around rs 1.5 crore to the relief fund for the flood-hit in kerala",lives,0,0,3,0,3,punjab
9/3/18,https://www.tribuneindia.com/news/punjab/judiciary-raises-rs1-5-cr-for-kerala/646875.html,"registrar general arun kumar tyagi said judges, at a full court meeting, resolved to contribute rs 10,000 each to the kerala chief minister‚Äôs distress relief fund",lives,0,0,3,0,3,punjab
9/1/18,https://www.tribuneindia.com/news/punjab/hc-judges-court-staff-judicial-officers-collect-rs-1-5-crore-for-flood-relief/646228.html,"hc judges, court staff, judicial officers collect rs 1.5 crore for flood relief",lives,3,1,8,0,12,punjab
9/1/18,https://www.tribuneindia.com/news/punjab/hc-judges-court-staff-judicial-officers-collect-rs-1-5-crore-for-flood-relief/646228.html,"chandigarh, september 1 the punjab and haryana high court judges, court staff and judicial officers in the region have collected approximately rs 1.5 crore for flood victims in kerala",lives,3,1,8,0,12,punjab
9/1/18,https://www.tribuneindia.com/news/punjab/hc-judges-court-staff-judicial-officers-collect-rs-1-5-crore-for-flood-relief/646228.html,"registrar-general arun kumar tyagi said judges resolved to contribute rs.10, 000 each in ‚Äòkerala chief minister‚Äôs distress relief fund‚Äô at a full court meeting",lives,3,1,8,0,12,punjab
9/1/18,https://www.tribuneindia.com/news/punjab/hc-judges-court-staff-judicial-officers-collect-rs-1-5-crore-for-flood-relief/646228.html,ush({ }); tyagi added extensive damage to public and private property has paralysed normal life of millions of people,lives,3,1,8,0,12,punjab
8/28/18,https://www.tribuneindia.com/news/punjab/office-gives-31-lakh-for-kerala-flood-relief/643729.html,office gives ~31 lakh for kerala flood relief,lives,0,0,4,0,4,punjab
8/28/18,https://www.tribuneindia.com/news/punjab/office-gives-31-lakh-for-kerala-flood-relief/643729.html,"chandigarh: the advocate general‚Äôs office has contributed rs 31 lakh to the chief minister‚Äôs relief fund for kerala flood relief efforts, an official press release said here on monday",lives,0,0,4,0,4,punjab
8/19/18,https://www.tribuneindia.com/news/punjab/cong-mps-mlas-to-donate-month-s-salary-for-kerala/639221.html,"tribune news service  chandigarh, august 18 all mps and mlas of the punjab congress, led by cm capt amarinder singh, will donate their one-month salary to support the kerala flood relief measures",lives,3,0,3,0,6,punjab
8/18/18,https://www.tribuneindia.com/news/punjab/cm-announces-rs-10-crore-for-flood-hit-kerala/638773.html,"tribune news servicenew delhi, august 17chief minister capt amarinder singh has announced rs 10 crore relief for flood-hit kerala",lives,3,0,5,0,8,punjab
8/18/18,https://www.tribuneindia.com/news/punjab/cm-announces-rs-10-crore-for-flood-hit-kerala/638773.html,he structural composition of the help include transfer of rs 5 crore from chief minister‚Äôs fund to kerala cm‚Äôs fund,lives,3,0,5,0,8,punjab
8/18/18,https://www.tribuneindia.com/news/punjab/cm-announces-rs-10-crore-for-flood-hit-kerala/638773.html,"e added that acting on the chief minister‚Äôs appeal, members of the punjab ias officers‚Äô association have decided to donate one day‚Äôs salary each to the cm‚Äôs relief fund to support the kerala relief measures",lives,3,0,5,0,8,punjab
6/22/18,https://www.tribuneindia.com/news/punjab/ahead-of-monsoon-drainage-cleaning-works-yet-to-take-off/608865.html," he said muktsar district, which is the worst affected by waterlogging, would get just about rs 3-4 crore for the entire works",lives,0,3,6,0,9,"barnala, faridkot, fazilka, ferozepur, moga, sri muktsar sahib"
3/15/18,https://www.tribuneindia.com/news/punjab/more-fury-than-fire-image-takes-a-hit/557888.html,"‚Äî¬†capt amarinder singh, chief minister  finance white paper and red entries what‚Äôs done  a white paper on the economy, as promised, has been brought out",lives,30,76,15,11,132,"amritsar, bathinda, jalandhar, ludhiana, moga, pathankot, patiala, sas nagar, sbs nagar, tarn taran"
3/15/18,https://www.tribuneindia.com/news/punjab/more-fury-than-fire-image-takes-a-hit/557888.html,"‚Äî manpreet singh badal, finance minister  sand mining as clock ticks, reputation slips what‚Äôs done  capt amarinder singh government should¬†be credited for using simple economics ‚Äî increasing the supply of minor minerals (sand and gravel) to bring down the cost of these basic construction materials",lives,30,76,15,11,132,"amritsar, bathinda, jalandhar, ludhiana, moga, pathankot, patiala, sas nagar, sbs nagar, tarn taran"
3/15/18,https://www.tribuneindia.com/news/punjab/more-fury-than-fire-image-takes-a-hit/557888.html,"‚Äî capt amarinder singh, who holds the charge of mining department  agriculture tale of drop in the ocean what‚Äôs done  small steps have been taken to ameliorate the suffering of indebted farmers through a crop-loan waiver scheme",lives,30,76,15,11,132,"amritsar, bathinda, jalandhar, ludhiana, moga, pathankot, patiala, sas nagar, sbs nagar, tarn taran"
3/15/18,https://www.tribuneindia.com/news/punjab/more-fury-than-fire-image-takes-a-hit/557888.html,"even for industry the cost becomes rs 6.5 to rs 6.7 per unit after levy of charges and duties, not rs 5 as promised",lives,30,76,15,11,132,"amritsar, bathinda, jalandhar, ludhiana, moga, pathankot, patiala, sas nagar, sbs nagar, tarn taran"
3/2/18,https://www.tribuneindia.com/news/punjab/pulanwala-baba-gifts-another-bridge/552088.html," while six bridges built by the baba are already operational, the seventh such bridge, costing rs 10 crore, will be opened for public at shahpur bela village, near kiratpur sahib, on saturday",lives,17,1,16,1,35,punjab
3/2/18,https://www.tribuneindia.com/news/punjab/pulanwala-baba-gifts-another-bridge/552088.html, earlier five such bridges ‚Äî four on the sutlej in the surrounding areas of anandpur sahib and one over the ghaggar in fatehabad district of haryana ‚Äî were built by him without any help from the state governments,lives,17,1,16,1,35,punjab
2/14/18,https://www.tribuneindia.com/news/punjab/roadmap-to-control-prices-of-veggies-soon-harsimrat/543722.html,"‚Äúthis will help improve food processing level to 20-30 per cent in the next two or three years from the current 10 per cent and decrease wastage,‚Äù she said",lives,0,9,1,0,10,punjab
1/5/18,https://www.tribuneindia.com/news/punjab/after-10-years-asafwala-bridge-repaired/523671.html,"our correspondent  abohar, january 4 after a 10-year-long wait, the asafwala bridge was finally renovated giving relief to hundreds of villagers",lives,4,3,10,0,17,punjab
1/5/18,https://www.tribuneindia.com/news/punjab/after-10-years-asafwala-bridge-repaired/523671.html,the bridge on the asafwala drain on the abohar-kandhwala amarkot road had been damaged for the last 10 years,lives,4,3,10,0,17,punjab
1/5/18,https://www.tribuneindia.com/news/punjab/after-10-years-asafwala-bridge-repaired/523671.html,"the issue was also raised before then chief minister parkash singh badal, who visited flood-affected areas in 2014, but to no avail",lives,4,3,10,0,17,punjab
1/5/18,https://www.tribuneindia.com/news/punjab/after-10-years-asafwala-bridge-repaired/523671.html,"about a month ago, when sdm poonam singh inspected some of the damaged bridges, she was told that hundreds of vehicles passed through 32 damaged bridges in the abohar subdivision",lives,4,3,10,0,17,punjab
10/18/17,https://www.tribuneindia.com/news/punjab/markfed-launches-kit-for-farmers/483799.html,"amra said markfed had always taken into account the interest of farmers, adding that one kit would provide solutions for controlling weeds, insects and diseases for 11 acres at the cost of 10 acres",lives,0,25,1,2,28,punjab
8/21/17,https://www.tribuneindia.com/news/punjab/floods-push-biharis-to-punjab/455235.html,"aman sood tribune news service rajpura, august 20  ‚Äúek roti aur aachaar pey hum do raat guzaarey hain (we survived two nights on a chapatti and some pickle),‚Äù said rani devi, seated in the tiny space adjacent to a train lavatory, tightly holding her two young children aged four and five",lives,7,11,14,0,32,"amritsar, bathinda, jalandhar, ludhiana, patiala"
8/21/17,https://www.tribuneindia.com/news/punjab/floods-push-biharis-to-punjab/455235.html,"‚Äúwe lost our house, two cows and a goat in the floods",lives,7,11,14,0,32,"amritsar, bathinda, jalandhar, ludhiana, patiala"
8/7/17,https://www.tribuneindia.com/news/punjab/how-centre-state-failed-farmers-on-insurance/448344.html,"but this mostly remains meaningless, as often the relief is rs 5,000, or even smaller amounts, paid by the state government for losses of up to rs 40,000-50,000 per acre",lives,5,121,20,12,158,"kapurthala, ludhiana"
8/7/17,https://www.tribuneindia.com/news/punjab/how-centre-state-failed-farmers-on-insurance/448344.html,"officially, nearly 20 per cent of the cropped area was damaged in floods that year as compared to 13 per cent and 10 per cent in 2009 (15 dead) and 1988 (200 dead), respectively",lives,5,121,20,12,158,"kapurthala, ludhiana"
8/7/17,https://www.tribuneindia.com/news/punjab/how-centre-state-failed-farmers-on-insurance/448344.html,"why pmfby doesn‚Äôt work  in its present avatar, the major flaw in the farm insurance scheme is that it comes into play only if there is 40 per cent crop damage in a village, which is counted as a single unit for availing any relief, says rajewal",lives,5,121,20,12,158,"kapurthala, ludhiana"
8/7/17,https://www.tribuneindia.com/news/punjab/how-centre-state-failed-farmers-on-insurance/448344.html,"unresponsive state govts  punjab‚Äôs reluctance to implement the pmfby also drew the attention of union agriculture minister radha mohan singh, who told the rajya sabha recently that the state should seriously consider implementing the scheme as it had neither sent a draft for drought relief nor done crop insurance in the past five years",lives,5,121,20,12,158,"kapurthala, ludhiana"
8/7/17,https://www.tribuneindia.com/news/punjab/india-set-for-record-kharif-crop-harvest/448343.html,"about 19 lakh hectare of crop area has been affected by floods across the country and farmers are likely to take up other kharif crops once the water recedes, he said, expressing concern about poor rain in some parts of karnataka",lives,0,38,2,0,40,punjab
7/31/17,https://www.tribuneindia.com/news/punjab/polls-probes-kept-officials-busy-flooding-may-be-the-price-to-pay/444763.html,there is no one to warn or help us,lives,0,18,10,0,28,"fatehgarh sahib, hoshiarpur, jalandhar, kapurthala, ludhiana, patiala, sas nagar, sbs nagar"
7/14/17,https://www.tribuneindia.com/news/punjab/two-gurdaspur-girls-drown-while-attempting-to-click-selfie/436583.html, the incident occurred at 5.30am and 30 minutes later half a dozen divers of district administration had started the rescue,lives,9,0,3,0,12,gurdaspur
7/6/17,https://www.tribuneindia.com/news/punjab/canal-cleaning-govt-laxity-to-cost-paddy-growers-dear/432290.html,"on june 28, a breach was reported at rodewala village in sangrur district affecting paddy fields",lives,0,16,14,2,32,"barnala, gurdaspur, mansa, sangrur"
7/3/17,https://www.tribuneindia.com/news/punjab/crops-on-3k-acres-submerged/430876.html," farmers claim to have suffered losses of crops on above 3,000 acres due to inundation of their fields",lives,3,86,30,2,121,barnala
5/20/17,https://www.tribuneindia.com/news/punjab/flood-protection-works-may-suffer-due-to-fund-cut/409758.html,"archit watts tribune news service muktsar, may 19 the annual cleaning and desilting of drains in districts hit by waterlogging may get affected this rainy season as the state government is set to decrease the budget from rs 40 crore to rs 25 crore for these works",lives,4,0,3,0,7,"fazilka, sri muktsar sahib"
3/31/17,https://www.tribuneindia.com/news/courts/mandi-board-sat-on-u-khand-flood-relief-for-3-years-cag/384905.html,mandi board sat on u‚Äôkhand flood relief for 3 years: cag,lives,2,2,7,1,12,punjab
3/31/17,https://www.tribuneindia.com/news/courts/mandi-board-sat-on-u-khand-flood-relief-for-3-years-cag/384905.html,"amaninder pal tribune news service chandigarh, march 30 almost four years ago, the punjab state agricultural marketing board (mandi board) collected rs23 lakh as relief meant for victims of the 2013 uttarakhand floods after deducting one-day salary of around 3,000 employees of the board and market committees associated with it",lives,2,2,7,1,12,punjab
3/31/17,https://www.tribuneindia.com/news/courts/mandi-board-sat-on-u-khand-flood-relief-for-3-years-cag/384905.html,"in its report tabled in the assembly yesterday, the cag observed, ‚Äúthough more than three years had lapsed, the funds collected were not remitted to the authorities concerned for utilisation as flood relief in uttarakhand",lives,2,2,7,1,12,punjab
3/31/17,https://www.tribuneindia.com/news/courts/mandi-board-sat-on-u-khand-flood-relief-for-3-years-cag/384905.html,"the cag observed, ‚Äúthe reply was not tenable because the contributions were not meant for the board‚Äôs use as these were separately collected for the specific purpose of contributing to the relief efforts in uttarakhand",lives,2,2,7,1,12,punjab
3/31/17,https://www.tribuneindia.com/news/courts/mandi-board-sat-on-u-khand-flood-relief-for-3-years-cag/384905.html,"now, after three years, how can the board management ensure that the money will reach the flood victims?‚Äù ",lives,2,2,7,1,12,punjab
3/7/17,https://www.tribuneindia.com/news/community/gaushalas-got-free-power-without-pserc-go-ahead/373881.html,"ush({ });  official sources said the pspcl allowed rs 4.7-crore subsidy to gaushalas, rs 11.17 crore to flood-affected villages and another rs 50 lakh to mushroom farmers in violation of the punjab state electricity regulatory commission (pserc) rules and the electricity act",lives,0,6,7,2,15,patiala
2/13/17,https://www.tribuneindia.com/news/community/20-000-punjabis-affected-as-california-dam-spillway-develops-cracks/363585.html,"20,000 punjabis affected as california dam spillway develops cracks",lives,33,3,26,2,64,jalandhar
2/13/17,https://www.tribuneindia.com/news/community/20-000-punjabis-affected-as-california-dam-spillway-develops-cracks/363585.html,"rachna khaira tribune news service jalandhar/new delhi, february 13  lakhs of people, including 20,000 punjabis residing in us counties of oroville, butte and sutter in northern california, were asked to evacuate on monday by the local authorities after the emergency spillway of the oroville dam developed cracks resulting in release of water from the lake",lives,33,3,26,2,64,jalandhar
2/13/17,https://www.tribuneindia.com/news/community/20-000-punjabis-affected-as-california-dam-spillway-develops-cracks/363585.html," according to jaswant singh bains, president of yuba city gurdwara, the evacuation announcement was made around 6.30 am¬†(local time) on sunday¬†when huge number of devotees was present in the gurdwara to pay obeisance on ‚Äòsangrand‚Äô",lives,33,3,26,2,64,jalandhar
2/13/17,https://www.tribuneindia.com/news/community/20-000-punjabis-affected-as-california-dam-spillway-develops-cracks/363585.html," he added that though evacuation was only recommended in yuba city, around 20,000 punjabis got stuck in the three counties where the evacuation was ordered following the potential threat of uncontrolled flood waters flowing down to low-lying areas",lives,33,3,26,2,64,jalandhar
2/13/17,https://www.tribuneindia.com/news/community/20-000-punjabis-affected-as-california-dam-spillway-develops-cracks/363585.html," he said though the damage to the spillway was reported around four days ago, it was only late¬†sunday¬†night that the evacuation was ordered",lives,33,3,26,2,64,jalandhar
2/13/17,https://www.tribuneindia.com/news/community/20-000-punjabis-affected-as-california-dam-spillway-develops-cracks/363585.html,"do not travel north toward oroville!!!!!‚Äù¬†¬†   the california department of water resources also issued an emergency evacuation order on facebook that reads, ‚Äúofficials are anticipating a failure of the auxiliary spillway at oroville dam within the next 60 minutes",lives,33,3,26,2,64,jalandhar
1/31/17,https://www.tribuneindia.com/news/politics/tota-singh-on-sticky-wicket-in-dharamkot/357293.html," kaka, considered close to congress‚Äô cm face capt amarinder singh, had lost to tota singh in the 2012 assembly elections by a little over 2,000 votes",lives,2,5,4,2,13,moga
12/17/16,https://www.tribuneindia.com/news/community/note-ban-nris-cancelling-trips/337887.html,"sanjeev singh bariana tribune news service chandigarh, december 16  affected by a flood of images of people queuing up outside banks and atm kiosks to withdraw money following demonetisation, nris are cancelling travel plans to their homeland punjab this winter",lives,2,5,4,7,18,"hoshiarpur, jalandhar"
9/30/16,https://www.tribuneindia.com/news/community/panic-grips-punjab-border-villages/302713.html,"ravi dhaliwal &anirudh gupta tribune news service gurdaspur/ferozepur, sept 29  the gurdaspur district administration has got people evacuated from villages located up to 10 km from the international border",lives,11,0,25,0,36,"ferozepur, gurdaspur, pathankot"
9/29/16,https://www.tribuneindia.com/news/community/gurdaspur-activates-disaster-management-plan-for-evacuating-villages/302408.html,"ravi dhaliwal tribune news service gurdaspur, september 29¬† ¬† the gurdaspur district administration on thursday activated the ‚Äòdisaster management plan‚Äô evacuating scores of villages located in the 10 km periphery of the international border",lives,12,0,21,0,33,"gurdaspur, pathankot"
9/3/16,https://www.tribuneindia.com/news/community/water-supply-to-gang-canal-slashed/289502.html,"122, farmers were assisting scores of labourers in the repair of the damaged sidewalls near burji numbers 140 and 144, but the strips used for patrolling had also got damaged during the recent rains",lives,1,12,11,0,24,ferozepur
8/13/16,https://www.tribuneindia.com/news/community/iaf-rescues-villagers-affected-by-floods/279983.html,"our correspondent abohar, august 12  indian air force helicopters, which left the suratgarh air station in sriganganagar today, rescued eight persons who were trapped in flood-affected bansar village",lives,19,1,11,0,31,sas nagar
8/13/16,https://www.tribuneindia.com/news/community/iaf-rescues-villagers-affected-by-floods/279983.html, he said the rescue and relief teams of the 3 grenadiers and engineering regiment were carrying operations in other 50 flood-affected villages in west rajasthan,lives,19,1,11,0,31,sas nagar
5/31/16,https://www.tribuneindia.com/news/community/govt-takes-measures-to-ensure-potable-water-in-muktsar-fazilka/244559.html,"archit watts tribune news service muktsar, may 30  the state government has directed the superintending engineer (water quality), mohali, to change his base to muktsar in an effort to improve the functioning of the water supply and sanitation department in waterlogging-affected muktsar and fazilka districts",lives,4,0,4,0,8,"fazilka, sas nagar, sri muktsar sahib"
3/29/16,https://www.tribuneindia.com/news/community/rti-muktsar-and-bathinda-get-lion-s-share-from-cm-relief-fund/214797.html,"deepkamal kaur tribune news service jalandhar, march 28  it seems that chief minister parkash singh badal is more benevolent towards his and his daughter-in-law‚Äôs constituencies when it comes to the distribution of his discretionary relief fund",lives,0,2,9,0,11,"amritsar, barnala, bathinda, fatehgarh sahib, fazilka, ferozepur, gurdaspur, hoshiarpur, jalandhar, kapurthala, ludhiana, mansa, moga, sangrur, sbs nagar, sri muktsar sahib, tarn taran"
3/29/16,https://www.tribuneindia.com/news/community/rti-muktsar-and-bathinda-get-lion-s-share-from-cm-relief-fund/214797.html,"gurdaspur and sangrur followed with a relief amount of rs89.52 lakh and rs75.18 lakh, respectively",lives,0,2,9,0,11,"amritsar, barnala, bathinda, fatehgarh sahib, fazilka, ferozepur, gurdaspur, hoshiarpur, jalandhar, kapurthala, ludhiana, mansa, moga, sangrur, sbs nagar, sri muktsar sahib, tarn taran"
3/29/16,https://www.tribuneindia.com/news/community/rti-muktsar-and-bathinda-get-lion-s-share-from-cm-relief-fund/214797.html,the five districts collectively got 65 per cent of the total relief amount,lives,0,2,9,0,11,"amritsar, barnala, bathinda, fatehgarh sahib, fazilka, ferozepur, gurdaspur, hoshiarpur, jalandhar, kapurthala, ludhiana, mansa, moga, sangrur, sbs nagar, sri muktsar sahib, tarn taran"
3/29/16,https://www.tribuneindia.com/news/community/rti-muktsar-and-bathinda-get-lion-s-share-from-cm-relief-fund/214797.html," during the same period, the government allocated from its budget an amount of rs2 crore for j&k and uttarakhand for flood relief",lives,0,2,9,0,11,"amritsar, barnala, bathinda, fatehgarh sahib, fazilka, ferozepur, gurdaspur, hoshiarpur, jalandhar, kapurthala, ludhiana, mansa, moga, sangrur, sbs nagar, sri muktsar sahib, tarn taran"
12/8/15,https://www.tribuneindia.com/news/governance/clear-pending-irrigation-projects-quickly-state-to-centre/168056.html,"a functionary of the state government said the pending projects flagged during the meeting were worth rs 5,237 crore, including the re-lining of rajasthan and sirhind feeders at a cost of rs 2,126 crore",lives,1,0,1,1,3,"amritsar, gurdaspur"
12/8/15,https://www.tribuneindia.com/news/governance/clear-pending-irrigation-projects-quickly-state-to-centre/168056.html,"the chief minister batted for the immediate release of rs 1,375 crore for the project of rehabilitation, renovation and modernisation of various distributaries along with allied works in the punjab ubdc system in border districts of amritsar and gurdaspur",lives,1,0,1,1,3,"amritsar, gurdaspur"
11/9/15,https://www.tribuneindia.com/news/community/won-t-grow-basmati-again-farmers/156256.html,"ush({ });  ‚Äúwe will sow parmal paddy in the future as growing basmati proved to be costly,‚Äù said farmer jawinder singh of nurpura village, who grew basmati on 8 acres",lives,0,61,3,3,67,fazilka
10/12/15,https://www.tribuneindia.com/news/community/basmati-unlikely-to-fetch-better-price/144893.html, ‚Äúthe imposition of tax is likely to affect the equilibrium price of the market driven 1121 variety of paddy as the buying cost will increase,lives,1,39,5,4,49,fazilka
8/25/15,https://www.tribuneindia.com/news/crime/boy-s-death-four-booked/124069.html,"tarn taran girl missing a teenage girl of dilavalpur village, 30 km from here, has been missing for over three weeks",lives,11,4,4,0,19,"amritsar, sas nagar, tarn taran"
8/25/15,https://www.tribuneindia.com/news/crime/boy-s-death-four-booked/124069.html,"the mother of the girl, who is a class x student, said her daughter had been missing from july 30-31 night, when the other family members were sleeping",lives,11,4,4,0,19,"amritsar, sas nagar, tarn taran"
7/24/15,https://www.tribuneindia.com/news/community/govt-strengthens-muktsar-drains-to-tackle-waterlogging/110605.html,the estimated cost of these two projects is nearly rs 4 crore,lives,4,0,14,1,19,sri muktsar sahib
7/18/15,https://www.tribuneindia.com/news/community/swan-in-spate-fields-inundated/108177.html,"on the recommendation of the survey, a proposal to construct a new ‚Äòbundh‚Äô at lodhipur (costing rs 13.43 crore) was submitted to the government, but nothing has been done so far",lives,2,11,15,3,31,amritsar
7/18/15,https://www.tribuneindia.com/news/community/swan-in-spate-fields-inundated/108177.html," ropar xen, drainage, dalip singh said they had taken up flood protection measures in the district at a cost of rs 1.5 crore",lives,2,11,15,3,31,amritsar
7/18/15,https://www.tribuneindia.com/news/community/swan-in-spate-fields-inundated/108177.html,he said eight drains were cleared before the monsoon at a cost of rs 80 lakh at bhangala and rs 20 lakh was spent on the burj downstream revetment,lives,2,11,15,3,31,amritsar
5/29/15,https://www.tribuneindia.com/news/governance/focus-on-key-pockets-not-on-all-round-development/86517.html,bathinda  harsimrat kaur badal (sad) questions asked: ---  mp lad funds utilised: rs 3.53 crore attendance: --- initiatives taken¬†  revival of new delhi-bathinda shatabdi express rs 136 crore food park at dabwala kalan in fazilka¬† participated in parlance for rs 5 lakh relief to 1984 riot victims played important role in getting an aiims for the state completion of ring road phase ii connecting bathinda-malout road with bathinda-badal road¬†  unkept promises(adsbygoogle = window,lives,22,24,22,1,69,"amritsar, bathinda, fatehgarh sahib, fazilka, ferozepur, gurdaspur, jalandhar, pathankot, sangrur, sas nagar"
5/29/15,https://www.tribuneindia.com/news/governance/focus-on-key-pockets-not-on-all-round-development/86517.html,"ush({ });  no flights started from bathinda airport even after two years of its completion no steps taken to check pollution in the ghaggar, which is posing serious health problems to residents of sardulgarh failed to get relief for farmers hit by crop loss mann village, adopted by her, yet to get a vet hospital, health centre and a bank grievances of old-age pensioners not resolved   strengthening her mass base, harsimrat is spending considerable time in her constituency, meeting people and listening to their grievances",lives,22,24,22,1,69,"amritsar, bathinda, fatehgarh sahib, fazilka, ferozepur, gurdaspur, jalandhar, pathankot, sangrur, sas nagar"
5/29/15,https://www.tribuneindia.com/news/governance/focus-on-key-pockets-not-on-all-round-development/86517.html,"opposition‚Äôs take  sucha singh chottepur, aap state convener, says: ‚Äúwhen nearly 20 punjabi boys went missing in iraq, khanna did not bother to get in touch with the families",lives,22,24,22,1,69,"amritsar, bathinda, fatehgarh sahib, fazilka, ferozepur, gurdaspur, jalandhar, pathankot, sangrur, sas nagar"
5/29/15,https://www.tribuneindia.com/news/governance/focus-on-key-pockets-not-on-all-round-development/86517.html,he failed to take up the matter of re-introduction of freight equalisation policy which is implemented will provide big relief to batala industrialists,lives,22,24,22,1,69,"amritsar, bathinda, fatehgarh sahib, fazilka, ferozepur, gurdaspur, jalandhar, pathankot, sangrur, sas nagar"
5/29/15,https://www.tribuneindia.com/news/governance/focus-on-key-pockets-not-on-all-round-development/86517.html," jalandhar  chaudhary santokh singh (cong) questions asked: 18 attendance: 97%  mp lad funds utilised: rs 1.75 crore initiatives taken  sanctioned funds for construction of girls‚Äô toilets at government schools¬† adopted ganna village in phillaur under the centre‚Äôs village adoption programme took up the matter of levy of 12.36 per cent service tax on remittances by nris with the directorate general of service tax demanded construction of railway over-bridges at guru nanakpura, ram nagar, goraya-rurka road and phillaur-numahal stretch supported cantonment residents seeking abolition of octroi¬†  unkept promises  no steps taken to provide relief to the sports industry a cluster for hand tool industry still awaited dry port project in doaba region failed to take off did nothing for revival of punjab institute of medical sciences¬† no improvement in civic amenities in the city   representing jalandhar where the sc population is as high as 33 per cent, the mp has been consistently raising the matter pertaining to ‚Äúdiversion‚Äù of funds for dalits for other purposes by the state government",lives,22,24,22,1,69,"amritsar, bathinda, fatehgarh sahib, fazilka, ferozepur, gurdaspur, jalandhar, pathankot, sangrur, sas nagar"
5/11/15,https://www.tribuneindia.com/news/community/works-to-check-waterlogging-reviewed/78824.html,"muktsar, may 10  a three-member team of the irrigation department, led by ks pannu, secretary, irrigation, today visited waterlogging-affected muktsar and fazilka districts and reviewed the ongoing works of cleaning and strengthening drains",lives,0,1,1,1,3,"fazilka, sri muktsar sahib"
5/11/15,https://www.tribuneindia.com/news/community/works-to-check-waterlogging-reviewed/78824.html, ‚Äúthe drainage department is doing anti-waterlogging and flood protection works at a cost of rs 200 crore in muktsar and fazilka,lives,0,1,1,1,3,"fazilka, sri muktsar sahib"
4/13/15,https://www.tribuneindia.com/news/punjab/implement-crop-insurance-scheme-cm-to-centre/66646.html," badal demanded that the compensation amount be enhanced to rs 10,000 per acre for farmers affected by natural calamities",lives,2,87,29,3,121,"fazilka, sri muktsar sahib"
4/13/15,https://www.tribuneindia.com/news/punjab/implement-crop-insurance-scheme-cm-to-centre/66646.html,ush({ });  ‚Äúit is unfortunate that wheat crop over thousands of acres has been damaged due to untimely rain,lives,2,87,29,3,121,"fazilka, sri muktsar sahib"
4/13/15,https://www.tribuneindia.com/news/punjab/implement-crop-insurance-scheme-cm-to-centre/66646.html,"had sought higher relief from upa  badal, in august 2013 when the upa was in power, had sought a compensation of rs 20,000 per acre for flood-ravaged regions of the state",lives,2,87,29,3,121,"fazilka, sri muktsar sahib"
4/7/15,https://www.tribuneindia.com/news/community/haryana-to-get-more-water-from-bhakra/63910.html,"‚Äúthis will help the haryana irrigation department to get its due share of 1,450 cusecs,‚Äù he said",lives,1,16,5,2,24,"patiala, sangrur"
3/18/15,https://www.tribuneindia.com/news/punjab/punjab-budget-speech-text/55244.html,the steps and policies outlined in the budget for 2015-16 presented by me reflect the commitment of our government to put the state economy on the path of sustained high economic growth the benefits of which will reach all sections of the society,lives,#N/A,#N/A,#N/A,#N/A,#N/A,#N/A
3/18/15,https://www.tribuneindia.com/news/punjab/punjab-budget-speech-text/55244.html,economic growth 5,lives,#N/A,#N/A,#N/A,#N/A,#N/A,#N/A
3/18/15,https://www.tribuneindia.com/news/punjab/punjab-budget-speech-text/55244.html,this situation though is set to take a better turn now with the latest 14th¬†finance commission recommendations which has resulted in increased devolution albeit at the cost of reduced plan allocation,lives,#N/A,#N/A,#N/A,#N/A,#N/A,#N/A
3/18/15,https://www.tribuneindia.com/news/punjab/punjab-budget-speech-text/55244.html," agriculture is the mainstay of¬†punjab‚Äôs economy, providing livelihood to over 60% of the population in the state",lives,#N/A,#N/A,#N/A,#N/A,#N/A,#N/A
3/18/15,https://www.tribuneindia.com/news/punjab/punjab-budget-speech-text/55244.html, i am pleased to share with the house that the world bank 11 has approved the 2nd¬†punjab rural water supply and sanitation project spread over six years (2015-16 to 2020-21) with a total cost of rs 2200 crore,lives,#N/A,#N/A,#N/A,#N/A,#N/A,#N/A
3/18/15,https://www.tribuneindia.com/news/punjab/punjab-budget-speech-text/55244.html,this scheme will provide protection to around 1.50 crore population of economically weaker households from financial liabilities arising out of health shocks that involve hospitalization,lives,#N/A,#N/A,#N/A,#N/A,#N/A,#N/A
3/18/15,https://www.tribuneindia.com/news/punjab/punjab-budget-speech-text/55244.html,"the free power supplied to the farmers at a cost of about rs 4,778 crore has proved vital in this regard",lives,#N/A,#N/A,#N/A,#N/A,#N/A,#N/A
3/18/15,https://www.tribuneindia.com/news/punjab/punjab-budget-speech-text/55244.html,rs 94 crore have been distributed during 2012-14 covering 4688 families affected by farmers‚Äô suicides from 2000-2011,lives,#N/A,#N/A,#N/A,#N/A,#N/A,#N/A
3/18/15,https://www.tribuneindia.com/news/punjab/punjab-budget-speech-text/55244.html,¬∑¬†¬†¬†¬†¬†¬†¬†¬†¬†rs 100 crore-for installation of ro systems to provide drinking water in heavy metal affected districts of¬†punjab,lives,#N/A,#N/A,#N/A,#N/A,#N/A,#N/A
3/18/15,https://www.tribuneindia.com/news/punjab/punjab-budget-speech-text/55244.html,the important schemes are: ¬∑¬†¬†¬†¬†¬†¬†¬†¬†¬†rs 134 crore - for relining of rajasthan feeder project (project cost is rs 952 crore to be completed in 4 year from 2015-19),lives,#N/A,#N/A,#N/A,#N/A,#N/A,#N/A
3/18/15,https://www.tribuneindia.com/news/punjab/punjab-budget-speech-text/55244.html,¬∑¬†¬†¬†¬†¬†¬†¬†¬†¬†rs 100 crore ‚Äì for relining of sirhind feeder project (project cost is rs 614 crore to be completed in 4 year from 2015-19),lives,#N/A,#N/A,#N/A,#N/A,#N/A,#N/A
3/18/15,https://www.tribuneindia.com/news/punjab/punjab-budget-speech-text/55244.html,¬∑¬†¬†¬†¬†¬†¬†¬†¬†¬†rs 50 crore ‚Äì for construction of shahpurkandi dam project (project cost is rs 2286 crore including power component to be completed in three year from 2015-18),lives,#N/A,#N/A,#N/A,#N/A,#N/A,#N/A
3/18/15,https://www.tribuneindia.com/news/punjab/punjab-budget-speech-text/55244.html,¬†¬† rs 30 crore ‚Äì for construction of field channels of kotla branch part-ii (project cost is rs 950 crore to be completed in 3 years from 2015-18),lives,#N/A,#N/A,#N/A,#N/A,#N/A,#N/A
3/18/15,https://www.tribuneindia.com/news/punjab/punjab-budget-speech-text/55244.html,punbus is purchasing 1800 electronic machines at a cost of rs 3.25 crores for installing gps devices in 300 buses to curb leakage of revenue,lives,#N/A,#N/A,#N/A,#N/A,#N/A,#N/A
3/18/15,https://www.tribuneindia.com/news/punjab/punjab-budget-speech-text/55244.html,"in another major initiative, the government has launched the 104 medical helpline to provide 24x7 medical advice, grievances redressal, and counselling services",lives,#N/A,#N/A,#N/A,#N/A,#N/A,#N/A
3/18/15,https://www.tribuneindia.com/news/punjab/punjab-budget-speech-text/55244.html,chief minister cancer relief fund provides assistance of rs 1.5 lakh for cashless treatment of cancer in various governments and empanelled private hospitals,lives,#N/A,#N/A,#N/A,#N/A,#N/A,#N/A
3/18/15,https://www.tribuneindia.com/news/punjab/punjab-budget-speech-text/55244.html,¬∑¬†¬†¬†¬†¬†¬†¬†¬†¬†rs 39 crore - for providing emergency response services (108-ambulance services) medical helpline (104) in the state,lives,#N/A,#N/A,#N/A,#N/A,#N/A,#N/A
3/18/15,https://www.tribuneindia.com/news/punjab/punjab-budget-speech-text/55244.html,¬∑¬†¬†¬†¬†¬†¬†¬†¬†¬†rs 25 crore - for treatment of cancer patients under cm cancer relief fund,lives,#N/A,#N/A,#N/A,#N/A,#N/A,#N/A
3/18/15,https://www.tribuneindia.com/news/punjab/punjab-budget-speech-text/55244.html," sir, a major infrastructure development programme for tourism is under implementation with adb support at a cost of rs 398 crore",lives,#N/A,#N/A,#N/A,#N/A,#N/A,#N/A
3/18/15,https://www.tribuneindia.com/news/punjab/punjab-budget-speech-text/55244.html," the state government has started important initiatives like punjab police helpline (dial 181), saanjh kendras and rapid rural response system",lives,#N/A,#N/A,#N/A,#N/A,#N/A,#N/A
3/18/15,https://www.tribuneindia.com/news/punjab/punjab-budget-speech-text/55244.html,"under the dial 181 helpline, 86,937 complaints have been received since the time of its inception",lives,#N/A,#N/A,#N/A,#N/A,#N/A,#N/A
3/18/15,https://www.tribuneindia.com/news/punjab/punjab-budget-speech-text/55244.html,¬∑¬†¬†¬†¬†¬†¬†¬†¬†¬†rs 3 crore- for grants-in-aid to punjab defence and security relief fund,lives,#N/A,#N/A,#N/A,#N/A,#N/A,#N/A
3/18/15,https://www.tribuneindia.com/news/punjab/punjab-budget-speech-text/55244.html,¬∑¬†¬†¬†¬†¬†¬†¬†¬†¬†e-tendering has been implemented with online mode of payments in 41 departments/ organizations to bring transparency and cost savings in procurement,lives,#N/A,#N/A,#N/A,#N/A,#N/A,#N/A
3/19/15,https://www.tribuneindia.com/news/punjab/dhindsa-takes-safe-route-shies-away-from-imposing-fresh-taxes/55207.html,"  the plan allocation has been increased by rs 1,929 crore in social services; rs 758 crore in general economic services (construction of buildings, school and college infrastructure; untied funds of chief minister and deputy chief minister; development of kandi and border area, etc); rs 500 crore in agriculture; rs 330 crore in irrigation and flood control; and by rs 846 crore in the power sector",lives,0,2,1,2,5,punjab
3/3/15,https://www.tribuneindia.com/news/community/3-of-family-die-in-roof-collapse/48956.html,only three members could be rescued by the police and local residents,lives,11,2,8,0,21,"patiala, sas nagar"
10/27/19,https://www.tribuneindia.com/news/punjab/dengue-scare-in-ludhiana-10-year-old-girl-dies/852773.html,"besides, a four-year-old girl ananya of new durga colony had died on monday after she suffered from dengue shock syndrome as per the report of pgimer, chandigarh",lives,18,0,2,0,20,ludhiana
10/27/19,https://www.tribuneindia.com/news/punjab/dengue-scare-in-ludhiana-10-year-old-girl-dies/852773.html,"besides, my seven-year-old daughter is also suffering from dengue and is currently under treatment at esi hospital",lives,18,0,2,0,20,ludhiana
9/23/19,https://www.tribuneindia.com/news/punjab/direct-paddy-sowing-saves-62-lakh-litres-water/836624.html,"of which, irrigation with the help of 14 lakh tubewells is done on 29.54 lakh hectares while canal water is used to irrigate just 11.16 lakh hectares if baldev's claims are to be believed, punjab could save rs 770 crore on power by sowing paddy directly on 28 lakh hectares",lives,1,42,2,0,45,moga
9/9/19,https://www.tribuneindia.com/news/punjab/online-transfer-policy-for-non-teaching-staff-singla/829755.html,"sangrur, september 8  punjab pwd (b&r) and education minister vijay inder singla today attended the bhog of freedom fighter gurdial singh (97) at nankiana sahib gurdwara and assured all help to his family",lives,1,0,0,0,1,sangrur
9/1/19,https://www.tribuneindia.com/news/punjab/floods-take-toll-on-houses-villagers-staying-outdoors/825853.html,"mundi shehrian/mandala channa, august 31¬†  as many as 3,000 houses and other buildings have been damaged in the district due to floods in the past fortnight",lives,10,9,60,0,79,punjab
9/1/19,https://www.tribuneindia.com/news/punjab/floods-take-toll-on-houses-villagers-staying-outdoors/825853.html," with about 10 villages (seven of them still inundated) severely affected by the floods, officials said it would take at least a month to assess the total damage",lives,10,9,60,0,79,punjab
9/1/19,https://www.tribuneindia.com/news/punjab/floods-take-toll-on-houses-villagers-staying-outdoors/825853.html,"  more than 50 buildings ‚Äîmany of them kutcha houses or huts ‚Äî have been damaged in dhakka basti in gatta mundi kasu village, which is one of the completely washed out and cut-off areas",lives,10,9,60,0,79,punjab
9/1/19,https://www.tribuneindia.com/news/punjab/floods-take-toll-on-houses-villagers-staying-outdoors/825853.html,"  as per the administration, 50 villages (30 severely affected) in the district are inundated ‚Äî all have an average of 200 to 250 houses, many of which have developed cracks",lives,10,9,60,0,79,punjab
9/1/19,https://www.tribuneindia.com/news/punjab/floods-take-toll-on-houses-villagers-staying-outdoors/825853.html,"  as per the norms, rs 95,100 shall be paid to fully damaged pucca/kutcha houses, for partial (15%) damage rs 5,200 for pucca and rs 3,200 for kutcha houses; and rs 4,100 shall be paid for damaged huts and rs 2,100 for cattle sheds",lives,10,9,60,0,79,punjab
9/1/19,https://www.tribuneindia.com/news/punjab/floods-take-toll-on-houses-villagers-staying-outdoors/825853.html,"¬†¬†  dc varinder kumar sharma said, ‚Äúaround 3,000 houses and other buildings have been damaged",lives,10,9,60,0,79,punjab
8/26/19,https://www.tribuneindia.com/news/punjab/inflow-from-pak-still-on-army-ndrf-on-alert/822775.html,"anirudh gupta ferozepur, august 25  over 17 villages, situated between the right bank of overflowing sutlej and indo-pakistan border, continue to remain at risk of getting flooded following a part of the embankment along tendiwala village got severely damaged due to the strong current of water coming from kasur (pakistan)",lives,16,10,27,1,54,ferozepur
8/26/19,https://www.tribuneindia.com/news/punjab/inflow-from-pak-still-on-army-ndrf-on-alert/822775.html,"at the request of the dc, hundreds of villagers, along with their tractor-trailers, have extended a helping hand to prevent around 50-ft-long portion of the ditch-cum-bundh from collapse",lives,16,10,27,1,54,ferozepur
8/26/19,https://www.tribuneindia.com/news/punjab/inflow-from-pak-still-on-army-ndrf-on-alert/822775.html," mehtab singh of tendiwala said if the bundh was washed away, several villages would be affected",lives,16,10,27,1,54,ferozepur
8/26/19,https://www.tribuneindia.com/news/punjab/inflow-from-pak-still-on-army-ndrf-on-alert/822775.html," muktiar, a villager helping army jawans in carrying out the rescue work, said his crop was damaged two years ago as well, but the compensation was still awaited",lives,16,10,27,1,54,ferozepur
8/26/19,https://www.tribuneindia.com/news/punjab/inflow-from-pak-still-on-army-ndrf-on-alert/822775.html,‚Äúalready six villagers have died while crossing the river on a ‚Äòbera‚Äô that got damaged,lives,16,10,27,1,54,ferozepur
8/26/19,https://www.tribuneindia.com/news/punjab/inflow-from-pak-still-on-army-ndrf-on-alert/822775.html,villagers extend help for bundh repair  the sutlej bundh along tendiwala village damaged due to the strong current of water coming from pakistan,lives,16,10,27,1,54,ferozepur
8/23/19,https://www.tribuneindia.com/news/punjab/2-500-in-38-camps-enough-food-but-no-facilities/821304.html,"sardarwala/mundi chohlian, august 22 with over 38 camps in jalandhar and kapurthala districts sheltering nearly 2,500 persons, the camps which have one doctor on an average face lack of tarpaulins and mattresses with displaced people sleeping on floors ‚Äî in classrooms or in open ‚Äî at night",lives,19,3,15,0,37,"jalandhar, kapurthala"
8/23/19,https://www.tribuneindia.com/news/punjab/2-500-in-38-camps-enough-food-but-no-facilities/821304.html,nearly 500 persons displaced in lohian have been housed at the relief camp at lohian khas alone,lives,19,3,15,0,37,"jalandhar, kapurthala"
8/21/19,https://www.tribuneindia.com/news/punjab/one-month-on-muktsar-village-still-swamped/820165.html,"ush({ });  balraj singh, an elderly resident of the village, said: ‚Äúin 2013, the village was badly affected during monsoon but floodwater was drained out in just 15 days",lives,5,2,20,0,27,sri muktsar sahib
8/20/19,https://www.tribuneindia.com/news/punjab/over-60-jalandhar-villages-inundated/819821.html,  crops in thousands of acres were submerged and at least 200 people were safely evacuated from jalandhar and kapurthala in relief operations launched by the administration and villagers,lives,21,29,37,0,87,"jalandhar, kapurthala"
8/20/19,https://www.tribuneindia.com/news/punjab/over-60-jalandhar-villages-inundated/819821.html,"while crops in 11,400 acres were destroyed in phillaur alone, the administration was assessing the damage in the remaining areas",lives,21,29,37,0,87,"jalandhar, kapurthala"
8/20/19,https://www.tribuneindia.com/news/punjab/over-60-jalandhar-villages-inundated/819821.html,"  with water flooding mao sahib bhaini and mianwal villages early this morning, the administration along with ndrf and sdrf teams started rescue operations and evacuated 70 persons in phillaur",lives,21,29,37,0,87,"jalandhar, kapurthala"
8/20/19,https://www.tribuneindia.com/news/punjab/over-60-jalandhar-villages-inundated/819821.html,"after the breaches in shahkot at 3 pm, the relief efforts were shifted there",lives,21,29,37,0,87,"jalandhar, kapurthala"
8/20/19,https://www.tribuneindia.com/news/punjab/over-60-jalandhar-villages-inundated/819821.html,until now seven persons have been evacuated from shahkot,lives,21,29,37,0,87,"jalandhar, kapurthala"
8/20/19,https://www.tribuneindia.com/news/punjab/over-60-jalandhar-villages-inundated/819821.html,we rescued at least 15 to 20 persons from deras (fields houses) before the administration stepped in,lives,21,29,37,0,87,"jalandhar, kapurthala"
8/19/19,https://www.tribuneindia.com/news/punjab/most-rivers-in-spate-evacuation-begins-in-35-ropar-villages/819440.html,"most rivers in spate, evacuation begins in 35 ropar villages",lives,12,3,33,0,48,punjab
8/19/19,https://www.tribuneindia.com/news/punjab/most-rivers-in-spate-evacuation-begins-in-35-ropar-villages/819440.html,"keeping in view the deteriorating situation, the district administration has ordered evacuation from 35 villages and other locations on the banks of the budhki and sarsa rivers",lives,12,3,33,0,48,punjab
8/12/19,https://www.tribuneindia.com/news/punjab/sutlej-in-spate-damages-crops-on-1-000-acres-in-moga/816574.html,"sutlej in spate, damages crops on 1,000 acres in moga",lives,4,17,21,0,42,moga
8/12/19,https://www.tribuneindia.com/news/punjab/sutlej-in-spate-damages-crops-on-1-000-acres-in-moga/816574.html,"‚Äúpaddy, fodder and vegetables have been damaged on more than 1,000 acres in at least six villages,‚Äù he said",lives,4,17,21,0,42,moga
8/9/19,https://www.tribuneindia.com/news/punjab/3-weeks-on-fields-still-inundated-in-muktsar/814993.html,"  meanwhile, the district administration has informed the state government that crops on 24,975 acres have been damaged due to rain",lives,4,23,20,0,47,sri muktsar sahib
8/3/19,https://www.tribuneindia.com/news/punjab/sutlej-tributary-floods-dozen-ropar-villages/812093.html,"notably, the villagers have been facing weather vagaries since 2010, when 1,000-feet stretch of lodhipur bundh was damaged in floods",lives,2,11,27,1,41,amritsar
8/3/19,https://www.tribuneindia.com/news/punjab/sutlej-tributary-floods-dozen-ropar-villages/812093.html,"on the basis of the survey, a proposal to construct a new bundh at lodhipur (costing rs 13.43 crore) was submitted to the government, nut to no avail",lives,2,11,27,1,41,amritsar
8/3/19,https://www.tribuneindia.com/news/punjab/sutlej-tributary-floods-dozen-ropar-villages/812093.html,"meanwhile, additional deputy commissioner jagvinderjeet singh garewal, who along with the officials of the drainage, irrigation and revenue departments visited the affected villages, said the situation had improved as the flow of water in the swan reduced to 11,000 cusecs by friday evening",lives,2,11,27,1,41,amritsar
7/26/19,https://www.tribuneindia.com/news/punjab/decide-representation-or-pay-rs-50k-rules-hc/807726.html,"  in an attempt to prevent the petitioner from possibly undergoing the trauma of a protracted legal battle, justice rawal asserted: ‚Äúin case, representation is not decided within specified time, there shall be costs of rs 50, 000 to be paid by the officer concerned to the petitioner‚Äù",lives,1,0,1,2,4,punjab
7/24/19,https://www.tribuneindia.com/news/punjab/will-take-up-ghaggar-issue-with-centre-cm/806748.html," five days after a 100-feet breach flooded thousands of acres of agricultural fields and villages, the sangrur administration with the help the ndrf, sdrf, army and locals today completely plugged the breach",lives,3,28,14,4,49,"patiala, sangrur"
7/24/19,https://www.tribuneindia.com/news/punjab/will-take-up-ghaggar-issue-with-centre-cm/806748.html," the cm, who flew over rajpura, ghanaur and shatrana, before stopping at moonak in sangrur, said about 50,000 acres of crop had been lost in patiala and another 10,000 acres in sangrur due to the breach in ghaggar",lives,3,28,14,4,49,"patiala, sangrur"
7/24/19,https://www.tribuneindia.com/news/punjab/will-take-up-ghaggar-issue-with-centre-cm/806748.html,"we will try to complete it as soon as the water recedes and immediately release compensation after receiving the report,‚Äù he said, adding that he had ordered the dc to pay compensation for damage to 28 houses (three of them completely) as a result of flooding",lives,3,28,14,4,49,"patiala, sangrur"
7/24/19,https://www.tribuneindia.com/news/punjab/will-take-up-ghaggar-issue-with-centre-cm/806748.html,"tns  compensation soon  about 50,000 acres of crop has been lost in patiala and another 10,000 acres in sangrur due to breach in the ghaggar",lives,3,28,14,4,49,"patiala, sangrur"
7/23/19,https://www.tribuneindia.com/news/punjab/crops-over-21k-acres-hit-govt-steps-up-relief-ops/806121.html,"crops over 21k acres hit, govt steps up relief ops",lives,0,33,11,0,44,sangrur
7/23/19,https://www.tribuneindia.com/news/punjab/crops-over-21k-acres-hit-govt-steps-up-relief-ops/806121.html," as per the latest report, the overflowing ghaggar has affected standing crop on 21,775 acres",lives,0,33,11,0,44,sangrur
7/23/19,https://www.tribuneindia.com/news/punjab/crops-over-21k-acres-hit-govt-steps-up-relief-ops/806121.html,"of this, crop on 15,569 acres was affected due to the breach in the river in the last five days",lives,0,33,11,0,44,sangrur
7/23/19,https://www.tribuneindia.com/news/punjab/crops-over-21k-acres-hit-govt-steps-up-relief-ops/806121.html,"  the flooding has affected crops such as paddy, vegetables, cotton, maize and fodder over 7,392 acres in moonak, 920 bhundar bhaini, 567 surjan bhaini, 1,883 salegarh and 1,622 phullad village",lives,0,33,11,0,44,sangrur
7/23/19,https://www.tribuneindia.com/news/punjab/crops-over-21k-acres-hit-govt-steps-up-relief-ops/806121.html,"apart from ghaggar, rain has also affected 6206 acres of standing crops in lehragaga, andana,sunam, dhuri and sangrur blocks",lives,0,33,11,0,44,sangrur
7/22/19,https://www.tribuneindia.com/news/punjab/govt-blames-haryana-as-it-struggles-to-tame-ghaggar/805535.html,"rajmeet singh tribune news service chandigarh, july 21  the state government has blamed haryana for the damage caused in patiala and sangrur districts due to the overflowing ghaggar",lives,7,7,17,0,31,"amritsar, mansa, patiala, sangrur"
7/22/19,https://www.tribuneindia.com/news/punjab/govt-blames-haryana-as-it-struggles-to-tame-ghaggar/805535.html," the river had caused huge damage in patiala, sangrur and mansa districts in 1988, 2010 and 2015",lives,7,7,17,0,31,"amritsar, mansa, patiala, sangrur"
7/17/19,https://www.tribuneindia.com/news/punjab/fields-in-moga-flooded-as-sutlej-swells/803033.html," sarpanch of sanghera village balkar singh claimed that paddy, green fodder and mint crops were damaged on more than 1,500 acres of land inside the dhusi bundh in at least six villages and human settlements",lives,1,21,18,0,40,moga
7/15/19,https://www.tribuneindia.com/news/punjab/use-direct-paddy-seeding-to-save-water-suggests-study/802069.html,"kulwinder sandhu tribune news service moga, july 14 pushing for sustainable agriculture practices, the union government is carrying out a study with the help of the state agriculture department in moga and its adjoining districts to substantiate the worth of directly sowing paddy without puddling the fields",lives,2,54,2,0,58,moga
7/15/19,https://www.tribuneindia.com/news/punjab/use-direct-paddy-seeding-to-save-water-suggests-study/802069.html,"of which, irrigation with the help of 14-lakh tubewells was done on 29.54 lakh hectares while canal water was used on just 11.16 lakh hectares",lives,2,54,2,0,58,moga
7/14/19,https://www.tribuneindia.com/news/punjab/cases-worth-rs-2-76-cr-settled/801634.html,"tns ropar  seven labourers rescued  paddy crop on 500 acres was affected due to sudden increase of the water level in¬† the sarsa, which flooded fields in aaspur kotan, ranjit pura, manguwal diwari, sarsa nangal, kotbala, majri gujran, batarla, and dahirpur villages on saturday",lives,2,10,5,0,17,"amritsar, barnala, bathinda, faridkot, fatehgarh sahib, fazilka, gurdaspur, hoshiarpur, jalandhar"
2/1/19,https://www.tribuneindia.com/news/punjab/amrita-s-works-reflect-partition-pangs-prof/721877.html,"it reignited memories of the great calcutta killings of 1946 and the sufferings of millions of refugees, who flooded the city in the aftermath of partition",lives,6,1,1,0,8,patiala
12/23/18,https://www.tribuneindia.com/news/punjab/on-punjab-mining-expert-s-advice-meghalaya-approaches-coal-india/702922.html,"shillong, december 21  former mining engineer and award-winning rescuer jaswant singh gill, who visited illegal coal pit in meghalaya where 15 men are stuck since december 13, has advised the state government to seek help from coal india",lives,11,0,3,0,14,amritsar
12/23/18,https://www.tribuneindia.com/news/punjab/on-punjab-mining-expert-s-advice-meghalaya-approaches-coal-india/702922.html, operations to rescue the trapped miners entered its 10th day on saturday,lives,11,0,3,0,14,amritsar
12/23/18,https://www.tribuneindia.com/news/punjab/on-punjab-mining-expert-s-advice-meghalaya-approaches-coal-india/702922.html,"‚Äî pti rescue operation enters 10th day  on december 13, around 20 miners entered the 370-foot mine at about 8 am after reaching the bottom of the pit, the miners entered the horizontal manholes often termed as ‚Äòrat-holes‚Äô, each manhole just about fits one person to get in at a time five persons managed to climb out of the mine, one of whom has been arrested villagers say one of the diggers could have accidentally punctured the cave wall and river water gushed in immediately ",lives,11,0,3,0,14,amritsar
12/11/18,https://www.tribuneindia.com/news/punjab/monetary-help-pours-in-for-calligraphy-prodigy/696756.html," secretary (education) krishan kumar said more than 100 teaching, non-teaching employees and ngos had called him and expressed desire to help the child",lives,4,0,1,0,5,"amritsar, gurdaspur, sas nagar, tarn taran"
9/25/18,https://www.tribuneindia.com/news/punjab/car-swept-away-6-of-family-rescued/658399.html,"car swept away, 6 of family rescued",lives,24,4,10,0,38,hoshiarpur
9/25/18,https://www.tribuneindia.com/news/punjab/car-swept-away-6-of-family-rescued/658399.html,"tribune news service  hoshiarpur, september 24 three vehicles were swept away in the district on monday, but all persons on board were rescued",lives,24,4,10,0,38,hoshiarpur
9/25/18,https://www.tribuneindia.com/news/punjab/car-swept-away-6-of-family-rescued/658399.html,the five-day-old baby was the first one to be rescued,lives,24,4,10,0,38,hoshiarpur
9/25/18,https://www.tribuneindia.com/news/punjab/car-swept-away-6-of-family-rescued/658399.html,the driver lost control of the bus that had seven to eight girls on board,lives,24,4,10,0,38,hoshiarpur
9/15/18,https://www.tribuneindia.com/news/punjab/staff-seek-exemption-from-poll-duty/653177.html, teachers in many districts alleged that they had to suffer due to the poll-related duties as they had to attend two rehearsals on their off days,lives,6,2,1,0,9,"ludhiana, patiala"
7/28/18,https://www.tribuneindia.com/news/punjab/how-ait-scam-fell-flat-after-a-decade/627817.html," it calculated the entire costing and earning of veer coloniser and builders private limited, amritsar, in purchasing, developing and selling 32.1 acres of ‚Äòcontroversial‚Äô land exempted from acquisition",lives,1,24,3,4,32,"amritsar, jalandhar, sas nagar"
7/28/18,https://www.tribuneindia.com/news/punjab/how-ait-scam-fell-flat-after-a-decade/627817.html," trashing the charge of causing rs 60-crore loss to the ait through the development of veer enclave, the vb observed that the private developer not only benefitted the farmers, whose land it purchased at a higher rate than offered by the ait, but also helped the public, whom it sold residential and commercial sites at a lesser price than that offered by ait",lives,1,24,3,4,32,"amritsar, jalandhar, sas nagar"
7/22/18,https://www.tribuneindia.com/news/punjab/muktsar-dc-releases-rs-4-lakh-for-draining-out-water-from-fields/624470.html,"besides, nearly rs 7 lakh will be released within a short period under the disaster relief fund",lives,1,22,8,0,31,sri muktsar sahib
6/18/18,https://www.tribuneindia.com/news/punjab/relief-from-dust-but-streets-flooded/607003.html,"our correspondent  abohar, june 17 rains that lashed abohar and neighbouring segments on sunday gave relief from dust, but disrupted power supply and left streets inundated",lives,0,0,4,0,4,sas nagar
5/15/18,https://www.tribuneindia.com/news/punjab/minister-monitors-sampling-of-highway-material-in-abohar/589406.html,the state will contribute 40 per cent share in the total cost,lives,2,1,1,1,5,punjab
11/3/17,https://www.tribuneindia.com/news/punjab/vacant-posts-petty-politics-bane-of-education/491513.html,"after helping his father in early-morning chores, he starts for school at 6 am",lives,0,3,29,2,34,"amritsar, fatehgarh sahib, fazilka, ferozepur, gurdaspur, mansa, pathankot, sas nagar, tarn taran"
11/3/17,https://www.tribuneindia.com/news/punjab/vacant-posts-petty-politics-bane-of-education/491513.html,fazilka ‚Äòupgraded‚Äô schools worst-affected   the upgrade of high schools to senior secondary in august 2016 has largely been only on paper,lives,0,3,29,2,34,"amritsar, fatehgarh sahib, fazilka, ferozepur, gurdaspur, mansa, pathankot, sas nagar, tarn taran"
11/3/17,https://www.tribuneindia.com/news/punjab/vacant-posts-petty-politics-bane-of-education/491513.html,"as per official sources, 21 posts of history, 20 of political science, 19 of punjabi, 10 of economics and six of biology are vacant in 68 senior secondary schools of the district",lives,0,3,29,2,34,"amritsar, fatehgarh sahib, fazilka, ferozepur, gurdaspur, mansa, pathankot, sas nagar, tarn taran"
10/12/17,https://www.tribuneindia.com/news/punjab/to-ensure-green-diwali-ppcb-writes-to-dist-heads/480972.html," ‚Äúlast year on diwali, the peak air quality index had reached to severe quality zone of 497, which has respiratory affect on every human being",lives,1,1,2,0,4,"ludhiana, patiala"
9/18/17,https://www.tribuneindia.com/news/punjab/sarhad-rolls-out-border-tourism-package/468737.html,"gs paul tribune news service amritsar, september 17 sarhad restaurant, famous for amritsari-lahori cuisine, has introduced a free-of-cost border tour package",lives,1,0,3,1,5,amritsar
8/3/17,https://www.tribuneindia.com/news/punjab/canal-breach-in-fazilka-fields-flooded/446349.html,"the owner of the factory, sanjeev nagpal, claimed to have suffered a loss of about rs 1.5 crore",lives,4,12,6,0,22,fazilka
7/27/17,https://www.tribuneindia.com/news/punjab/stubble-burning-s-too-stubborn-even-for-a-million-dollars/442924.html, progressive farmer kamaldeep singh of sultanpur lodhi says the high cost of a baler (rs 10-12 lakh) ‚Äî used to make bundles of straw ‚Äî is crippling,lives,0,64,2,7,73,"amritsar, bathinda, gurdaspur, jalandhar, ludhiana"
7/12/17,https://www.tribuneindia.com/news/punjab/flooded-drain-ruins-crops-relief-sought/435303.html,"nikhila pant dhawan tribune news service bathinda, july 11  the overflowing lower lasara drain has damaged crops in 450 acres in jethuke and kararwala villages of this district",lives,2,47,27,2,78,"barnala, bathinda, mansa"
7/12/17,https://www.tribuneindia.com/news/punjab/flooded-drain-ruins-crops-relief-sought/435303.html," farmers of the two villages claimed that their paddy, cotton, vegetables and fodder crops had been damaged as the water from the overflowing drain had inundated their fields and caused losses to them",lives,2,47,27,2,78,"barnala, bathinda, mansa"
7/2/17,https://www.tribuneindia.com/news/punjab/villagers-clash-over-draining-out-rainwater/430389.html,no one has suffered any serious injury,lives,27,4,16,0,47,barnala
6/8/17,https://www.tribuneindia.com/news/punjab/nh-flooded-commuters-harassed/419260.html,"the rain damaged the newly constructed road at many points on the 78-km stretch, disrupting vehicular movement",lives,2,2,5,0,9,"ludhiana, moga"
1/13/17,https://www.tribuneindia.com/news/community/on-fringes-they-vie-for-space/349723.html," to contest all 117 seats, he says, means helping akalis retain power",lives,5,2,1,0,8,patiala
1/12/17,https://www.tribuneindia.com/news/politics/disillusioned-with-aap-splinter-groups-out-to-redefine-political-narrative/349208.html,"to contest all 117 seats, he says, means helping akalis retain power",lives,5,2,1,0,8,patiala
9/24/16,https://www.tribuneindia.com/news/community/baba-farid-mela-concludes/299904.html,"he himself entered the mine and sent out the trapped miners before he returned last, after 6 hours of the rescue operation",lives,4,0,1,0,5,faridkot
9/8/16,https://www.tribuneindia.com/news/community/engineer-who-saved-65-miners-in-wb-selected-for-bhagat-puran-singh-award/291880.html,"he came out last after six hours of the rescue operation, said inderjeet",lives,1,0,1,0,2,faridkot
9/4/16,https://www.tribuneindia.com/news/community/cong-to-move-privilege-motion-against-dy-cm/289931.html," jakhar said sukhbir had announced in the assembly that rs 6,083 crore had been allocated for urban development and the amount would help improve civic amenities in 100-150 cities and towns of punjab in the next two-three months, but no development was seen till date",lives,2,3,2,0,7,"bathinda, jalandhar"
8/29/16,https://www.tribuneindia.com/news/community/canal-breach-leaves-fields-flooded-in-fazilka-abohar/286941.html,"tribune reporters fazilka/abohar, august 28  the badha minor canal suffered a 20-25 feet breach here today and inundated paddy crop in five acres of land, a government school and water works building in badha village on the outskirts of fazilka town",lives,8,13,13,0,34,"fazilka, sas nagar"
8/29/16,https://www.tribuneindia.com/news/community/canal-breach-leaves-fields-flooded-in-fazilka-abohar/286941.html," meanwhile in abohar, incessant rainfall since saturday evening has triggered a breach in the daulatpura minor (sub canal) near the abohar-sriganganagar highway, besides affecting hundreds of houses here",lives,8,13,13,0,34,"fazilka, sas nagar"
6/28/16,https://www.tribuneindia.com/news/community/water-mgmt-key-to-tackling-climate-change-says-expert/258028.html,"new delhi, june 27 at a time when climate change is set to impact rice production in asia, simple water management by farmers as an adaptation strategy will minimise the damage, an expert said",lives,0,25,6,1,32,punjab
6/27/16,https://www.tribuneindia.com/news/community/breach-in-fazilka-canal-floods-fields/257611.html,"agricultural plots spread over 50 acres were flooded due to a 65-foot-wide breach in a canal at theh kalandar village in fazilka district  farmers of the village said besides agricultural fields, the focal point of the village and a part of the state highway had been flooded due to the breach  the wild growth of water hyacinth has been choking a narrow bridge over the canal and causing breaches  ss dhaliwal, executive engineer, (irrigation), ferozepur division, said no damage had been caused to the standing crops and the breach was being plugged",lives,0,17,5,0,22,"fazilka, ferozepur"
6/27/16,https://www.tribuneindia.com/news/community/state-to-ensure-water-at-canal-tail-end-in-fazilka-abohar/257506.html,"archit watts tribune news service muktsar, june 26  the punjab government has now started making efforts to supply water at tail end of canals in abohar, fazilka areas without taking any help from rajasthan",lives,0,3,4,0,7,"faridkot, fazilka, sri muktsar sahib"
5/29/16,https://www.tribuneindia.com/news/crime/bhagat-singh-s-grandnephew-and-aap-activist-abhitej-killed-in-mishap/243788.html," abhitej was the son of abhey sandhu, who had contested the last punjab assembly election on the ppp ticket from nawanshahr in 2012, but lost",lives,13,4,3,0,20,"sas nagar, sbs nagar"
1/13/16,https://www.tribuneindia.com/news/community/idols-of-sikh-gurus-being-sold-in-market/182978.html,"¬†  the markets are flooded with idols costing between rs 50 and rs 1,500",lives,0,0,1,2,3,amritsar
12/1/15,https://www.tribuneindia.com/news/community/akal-takht-jathedar-warns-against-idols-of-sikh-gurus/165090.html,"ush({ });  costing between rs 50 and rs 1,500, these idols of sikh gurus, especially guru nanak dev, have flooded punjab‚Äôs markets",lives,1,0,1,1,3,"amritsar, sas nagar"
9/29/15,https://www.tribuneindia.com/news/community/60-cotton-crop-lost-punjab-offers-rs-600-cr-relief-package/139217.html,"60% cotton crop lost, punjab offers rs 600-cr relief package",lives,4,61,21,8,94,"bathinda, mansa"
9/29/15,https://www.tribuneindia.com/news/community/60-cotton-crop-lost-punjab-offers-rs-600-cr-relief-package/139217.html,"ruchika m khanna tribune news service chandigarh, september 28  faced with 60 per cent loss to cotton crop in the malwa region, the punjab government has okayed a rs 600-crore compensation package for the affected farmers",lives,4,61,21,8,94,"bathinda, mansa"
9/29/15,https://www.tribuneindia.com/news/community/60-cotton-crop-lost-punjab-offers-rs-600-cr-relief-package/139217.html, the report of a special girdawri ordered by the punjab government shows that 6.75 lakh acres under cotton crop have been affected in a whitefly attack,lives,4,61,21,8,94,"bathinda, mansa"
9/29/15,https://www.tribuneindia.com/news/community/60-cotton-crop-lost-punjab-offers-rs-600-cr-relief-package/139217.html,"ush({ });  though girdawri reports for two tehsils‚Äîgidderbaha and bathinda‚Äîare yet to come, the government has started releasing compensation to farmers to quell the disquiet among those affected",lives,4,61,21,8,94,"bathinda, mansa"
9/29/15,https://www.tribuneindia.com/news/community/60-cotton-crop-lost-punjab-offers-rs-600-cr-relief-package/139217.html,"sources said as special girdawri reports had started coming from affected districts, a decision was taken at a late night meeting yesterday to offer a rs 600-crore compensation package",lives,4,61,21,8,94,"bathinda, mansa"
9/29/15,https://www.tribuneindia.com/news/community/60-cotton-crop-lost-punjab-offers-rs-600-cr-relief-package/139217.html," till today, rs 520 crore (rs 8,000 per acre) had been sanctioned for disbursal among affected farmers",lives,4,61,21,8,94,"bathinda, mansa"
9/29/15,https://www.tribuneindia.com/news/community/60-cotton-crop-lost-punjab-offers-rs-600-cr-relief-package/139217.html," ‚Äúwe are also giving relief to farmers whose crop loss is between 26 and 33% (rs 2,000 per acre) from the state government‚Äôs own funds",lives,4,61,21,8,94,"bathinda, mansa"
9/29/15,https://www.tribuneindia.com/news/community/60-cotton-crop-lost-punjab-offers-rs-600-cr-relief-package/139217.html,"though the centre gives a compensation of rs 5,400 per acre under the disaster relief fund (for damage between 33-75%), punjab is giving additional rs 2,600 per acre as aid from its own kitty, in case the crop loss is between 76 and 100%",lives,4,61,21,8,94,"bathinda, mansa"
9/29/15,https://www.tribuneindia.com/news/community/60-cotton-crop-lost-punjab-offers-rs-600-cr-relief-package/139217.html,"this aims at ensuring that farmers who have suffered over 75% loss get rs 8,000 an acre as compensation,‚Äù said a senior officer",lives,4,61,21,8,94,"bathinda, mansa"
9/29/15,https://www.tribuneindia.com/news/community/60-cotton-crop-lost-punjab-offers-rs-600-cr-relief-package/139217.html,"with some of them getting compensation cheques for just rs 80-150, the government‚Äôs relief efforts are being mocked at.",lives,4,61,21,8,94,"bathinda, mansa"
9/3/15,https://www.tribuneindia.com/news/community/whitefly-eats-up-40-cotton-crop-in-fazilka/128052.html,"praful chander nagpalfazilka, september 2  about 40 per cent of the standing cotton crop has been affected by the whitefly attack in fazilka making it one of the worst-hit districts of the state",lives,4,61,33,3,101,"fazilka, sri muktsar sahib"
9/3/15,https://www.tribuneindia.com/news/community/whitefly-eats-up-40-cotton-crop-in-fazilka/128052.html,"official sources said out of the total 2.5 lakh acres under cotton cultivation, about 99,000 acres have been damaged partially or substantially due to the attack",lives,4,61,33,3,101,"fazilka, sri muktsar sahib"
9/3/15,https://www.tribuneindia.com/news/community/whitefly-eats-up-40-cotton-crop-in-fazilka/128052.html,  farmers ploughed out the completely damaged standing cotton crop in over 700 acres of land in different villages,lives,4,61,33,3,101,"fazilka, sri muktsar sahib"
9/3/15,https://www.tribuneindia.com/news/community/whitefly-eats-up-40-cotton-crop-in-fazilka/128052.html,"  deputy commissioner, fazilka, ravinder singh, said revenue officials had conducted a special girdawri of 700 acres of ploughed fields for providing compensation to the affected farmers",lives,4,61,33,3,101,"fazilka, sri muktsar sahib"
9/3/15,https://www.tribuneindia.com/news/community/whitefly-eats-up-40-cotton-crop-in-fazilka/128052.html,"‚Äúin the first phase, the temporary girdawri to assess damage on the standing crop will be conducted from september 7 to 25, followed by the final assessment of loss,‚Äù he said",lives,4,61,33,3,101,"fazilka, sri muktsar sahib"
9/3/15,https://www.tribuneindia.com/news/community/whitefly-eats-up-40-cotton-crop-in-fazilka/128052.html,"  such awareness camps have been held in 74 badly affected villages and shall be held in 47 more villages, said the dc",lives,4,61,33,3,101,"fazilka, sri muktsar sahib"
9/3/15,https://www.tribuneindia.com/news/community/whitefly-eats-up-40-cotton-crop-in-fazilka/128052.html,"  rahuvir singh of mahuana bodla village said, ‚Äúthe standing cotton crop in my entire 3 acres of land has been completely damaged due to the whitefly attack",lives,4,61,33,3,101,"fazilka, sri muktsar sahib"
9/3/15,https://www.tribuneindia.com/news/community/whitefly-eats-up-40-cotton-crop-in-fazilka/128052.html,  the cotton crop in the district has suffered 30 to 35 per cent damage due to the whitefly attack,lives,4,61,33,3,101,"fazilka, sri muktsar sahib"
8/12/15,https://www.tribuneindia.com/news/community/house-gets-flooded-ex-dig-sits-on-dharna/118756.html,he further alleged crops on 5 acres got damaged,lives,3,14,11,0,28,punjab
8/12/15,https://www.tribuneindia.com/news/community/dy-cm-s-helpline-flooded-with-transfer-requests/118746.html,"archit watts tribune news service muktsar, august 11 the ‚Äú1905‚Äù toll-free helpline number launched by deputy chief minister sukhbir badal on may 13 is flooded with transfer requests",lives,3,0,1,0,4,sri muktsar sahib
8/12/15,https://www.tribuneindia.com/news/community/dy-cm-s-helpline-flooded-with-transfer-requests/118746.html,an executive of the helpline told the tribune that they were receiving five to six calls daily pertaining to transfer requests,lives,3,0,1,0,4,sri muktsar sahib
8/12/15,https://www.tribuneindia.com/news/community/dy-cm-s-helpline-flooded-with-transfer-requests/118746.html,"besides, ‚Äú181‚Äù helpline of the state police or whatsapp number ‚Äú7696181181‚Äù, excise department helpline number ‚Äú18002582580‚Äù for business community to register their grievances and suggestions has been launched",lives,3,0,1,0,4,sri muktsar sahib
8/12/15,https://www.tribuneindia.com/news/community/dy-cm-s-helpline-flooded-with-transfer-requests/118746.html,the power department has also launched ‚Äú1912‚Äù toll-free helpline number for power complaints,lives,3,0,1,0,4,sri muktsar sahib
8/12/15,https://www.tribuneindia.com/news/community/dy-cm-s-helpline-flooded-with-transfer-requests/118746.html,the local bodies department has recently started ‚Äú180018000172‚Äù helpline for municipality related complaints,lives,3,0,1,0,4,sri muktsar sahib
8/11/15,https://www.tribuneindia.com/news/community/fields-in-20-villages-flooded/118314.html,"crops on around 11,000 acres were damaged",lives,2,14,16,1,33,tarn taran
7/15/15,https://www.tribuneindia.com/news/community/irrigation-minister-blames-dept-poor-forecast/106823.html," however, when asked why no work was done earlier and affected farmers had alleged that corruption had led to poor cleaning work, the minister replied, ‚Äúi would look into it and seek a report,‚Äù he said",lives,2,19,5,0,26,"fatehgarh sahib, patiala"
7/14/15,https://www.tribuneindia.com/news/community/sirhind-choe-overflows-fields-in-100-villages-flooded/106407.html," crops on 2,000 acres damaged  patiala: crops, including paddy and vegetables, on nearly 2,000 acres in various parts of the district were damaged in heavy rain in the last two days",lives,7,46,30,0,83,"fatehgarh sahib, pathankot, patiala, sas nagar"
6/23/15,https://www.tribuneindia.com/news/community/breach-in-canal-100-acres-submerged/97302.html,ush({ });  boota singh jathedar of gobindpura village said the crop on 65 acres had been completely damaged,lives,2,16,18,0,36,bathinda
6/23/15,https://www.tribuneindia.com/news/community/breach-in-canal-100-acres-submerged/97302.html,"on may 11, a breach near bir talab village caused damage to cotton crops",lives,2,16,18,0,36,bathinda
6/22/15,https://www.tribuneindia.com/news/punjab/breach-in-sirhind-canal-water-enters-fields-houses/97053.html,"¬†  several major breaches had been registered in the past as on may 11, a breach near bir talab village caused damage to newly sown cotton crops and also destroyed the motors and tubewells installed in the fields near the canal",lives,4,16,23,0,43,"bathinda, sas nagar"
6/22/15,https://www.tribuneindia.com/news/punjab/breach-in-sirhind-canal-water-enters-fields-houses/97053.html," a major breach in the canal was reported on june 7, 2012, when a 25-foot breach in the canal was reported and water had rushed into the mini-zoo and also damaged the new boundary wall of the zoo",lives,4,16,23,0,43,"bathinda, sas nagar"
6/22/15,https://www.tribuneindia.com/news/punjab/breach-in-sirhind-canal-water-enters-fields-houses/97053.html,"on november 8, a 30-foot wide breach in the embankment of the canal affected several persons as the water gushed into houses and hutments on the outskirts of the city",lives,4,16,23,0,43,"bathinda, sas nagar"
6/18/15,https://www.tribuneindia.com/news/community/act-swiftly-on-judicial-matters-state-told/95221.html," justice jain also imposed exemplary cost of rs 50,000 on the state and other respondents for non-compliance of court orders",lives,0,0,1,2,3,punjab
6/14/15,https://www.tribuneindia.com/news/community/cotton-damaged-due-to-breach-in-canal/93587.html,"tribune news servicetalwandi sabo (bathinda), june 13a 50-feet-wide breach in a canal on the outskirts of talwandi sabo damaged cotton sown in over 10 acres of land this afternoon",lives,5,19,14,0,38,bathinda
6/12/15,https://www.tribuneindia.com/news/community/sewerage-issues-tall-claims-little-action-by-ruling-leaders-allege-abohar-residents/92827.html,"our correspondent   abohar, june 11 notwithstanding the tall claims made by the authorities about solving the sewerage problem in many localities, ward number 1 and 2 in abohar continue to suffer even as the people voted sad-bjp to victory once again in the civic body elections",lives,11,0,3,0,14,sas nagar
6/12/15,https://www.tribuneindia.com/news/community/sewerage-issues-tall-claims-little-action-by-ruling-leaders-allege-abohar-residents/92827.html," municipal council officials said the punjab water supply and sewerage board sub-divisional engineer had been asked to prepare an estimate to solve the problem of ward number 1 and 2, the sanitation inspector was also directed to visit the affected area",lives,11,0,3,0,14,sas nagar
6/9/15,https://www.tribuneindia.com/news/community/ruling-mps-on-job-oppn-sulks-over-fund-crunch/91378.html,"  villagers are also complaining about three basic facilities missing ‚Äî a primary health centre, a veterinary hospital and a bank branch.",lives,5,7,10,0,22,sri muktsar sahib
5/20/15,https://www.tribuneindia.com/news/courts/no-more-needless-adjournments-says-hc/82820.html,"dismissing the appeal, justice raina asserted: ‚Äúthe precious time of this court cannot be squandered or reduced to a farce by keeping afloat the appeal for five years without just cause or reasonable justification",lives,2,0,2,0,4,punjab
5/15/15,https://www.tribuneindia.com/news/community/investors-drive-a-hard-bargain-may-get-it/80558.html,"but the government, probably to avoid itself an embarrassment, is allowing extensions and concessions by simply asking the developers to contribute towards the cancer relief fund (up to rs50 lakh)",lives,0,3,2,2,7,"amritsar, jalandhar, ludhiana, sangrur, sas nagar"
2/28/15,https://www.tribuneindia.com/news/punjab/punjab-entrepreneurs-say-budget-has-no-goodies-for-sports-cycle-industry/48015.html," punjab's industry particularly msme sector had pinned big hopes from the union budget 2015-16, presented by finance minister arun jaitley on saturday, for announcing industry friendly steps to provide relief to old and cottage industry from the onslaught of cheap imports as well as reducing excise duty for enabling it to face stiff competition",lives,5,6,2,0,13,"jalandhar, ludhiana"
2/27/15,https://www.tribuneindia.com/news/community/farmers-threaten-to-launch-stir-over-canal-leakage/47312.html," the memorandum, also signed by former punjab agriculture minister chaudhary radha krishan and kamla devi, sarpanch of khuikhera village, said at least 1,000 acres of agriculture land had been affected by waterlogging near the canal",lives,0,36,13,0,49,"fazilka, ferozepur, sas nagar"
2/27/15,https://www.tribuneindia.com/news/community/farmers-threaten-to-launch-stir-over-canal-leakage/47312.html," the executive engineer of the drainage construction division, ferozepur, had prepared a project amounting to rs 250.15 lakh for constructing sub-surface drainage system for khuikhera village confirming that the area was badly affected by waterlogging",lives,0,36,13,0,49,"fazilka, ferozepur, sas nagar"
2/5/15,https://www.tribuneindia.com/news/punjab/vvip-visits-fail-to-provide-succour-to-cancer-village/38139.html," after finding out that 16 per cent of the population in mari mustafa is infected with hepatitis c (hcv), a chronic liver disease, and a large number of residents in the village are suffering from cancer, the village residents were flooded with ‚Äúsolace and sympathy‚Äù two months ago as political leaders made a beeline for mari mustafa",lives,33,0,17,0,50,"faridkot, moga"
2/5/15,https://www.tribuneindia.com/news/punjab/vvip-visits-fail-to-provide-succour-to-cancer-village/38139.html," instead of providing the affected residents treatment or holding a hepatitis c and cancer detection camp in the past two months, on world cancer day today the health department organised a camp to create awareness about the diseases, said gurtej singh, a resident of mari mustafa",lives,33,0,17,0,50,"faridkot, moga"
2/5/15,https://www.tribuneindia.com/news/punjab/vvip-visits-fail-to-provide-succour-to-cancer-village/38139.html," besides two deaths due to cancer in his family, there are four other members suffering with hepatitis c in gurtej‚Äôs family",lives,33,0,17,0,50,"faridkot, moga"
2/3/15,https://www.tribuneindia.com/news/courts/hc-sets-3-month-deadline-on-plea-for-flats-by-84-riot-victims/37255.html,hc sets 3-month deadline on plea for flats by ‚Äô84 riot victims,lives,18,0,5,0,23,sas nagar
2/3/15,https://www.tribuneindia.com/news/courts/hc-sets-3-month-deadline-on-plea-for-flats-by-84-riot-victims/37255.html,"saurabh malik tribune news service chandigarh, february 2  more than 30 years after they were displaced, 1984 riot victims are still struggling for a roof of their own",lives,18,0,5,0,23,sas nagar
2/3/15,https://www.tribuneindia.com/news/courts/hc-sets-3-month-deadline-on-plea-for-flats-by-84-riot-victims/37255.html," describing themselves as 1984 riot victims, the petitioners claimed that they had even been issued red cards by the state of punjab",lives,18,0,5,0,23,sas nagar
2/3/15,https://www.tribuneindia.com/news/courts/hc-sets-3-month-deadline-on-plea-for-flats-by-84-riot-victims/37255.html,"earlier also, the high court in march 2013 had set a two-month deadline for the state of punjab and its functionaries to redress the grievance of 1984 riot victims for handing over the possession of lig flats",lives,18,0,5,0,23,sas nagar
11/4/14,https://www.tribuneindia.com/news/punjab/breach-in-canal-floods-250-acres-farmers-demand-compensation/5300.html," those who had recently sown wheat in their fields have suffered a loss of rs 4,000 per acre",lives,4,48,21,3,76,mansa
11/4/14,https://www.tribuneindia.com/news/punjab/breach-in-canal-floods-250-acres-farmers-demand-compensation/5300.html,"some farmers in kera bhaika village have suffered a loss of rs 50,000 as their paddy crop was submerged",lives,4,48,21,3,76,mansa
11/4/14,https://www.tribuneindia.com/news/punjab/breach-in-canal-floods-250-acres-farmers-demand-compensation/5300.html,"they have lost more than rs 4,000 per acre",lives,4,48,21,3,76,mansa
11/4/14,https://www.tribuneindia.com/news/punjab/breach-in-canal-floods-250-acres-farmers-demand-compensation/5300.html," the government should provide a compensation of rs 5,000 per acre to the affected farmers while those who lost their paddy crop should be given rs 50,000",lives,4,48,21,3,76,mansa
9/9/19,https://www.tribuneindia.com/news/punjab/4-booked-for-damaging-sdm-s-car/829763.html,4 booked for damaging sdm‚Äôs car,lives,10,4,6,0,20,ferozepur
9/6/19,https://www.tribuneindia.com/news/punjab/speed-up-work-on-corridor-says-ex-minister/828400.html,"it is reported that floods have cost the state rs 2,000 crore",lives,0,2,6,1,9,punjab
7/11/19,https://www.tribuneindia.com/news/punjab/india-fully-committed-to-kartapur-sahib-corridor-says-mea-over-pakistan-s-allegations/800554.html,the total cost of the project is rs 177.5 crore,lives,3,2,2,1,8,gurdaspur
7/3/19,https://www.tribuneindia.com/news/punjab/illegal-mining-poses-threat-to-electricity-supply-in-150-villages/796179.html,it is apprehended that these towers with damaged foundations can be washed away during the monsoon and plunge nearly 150 villages into the dark,lives,0,2,20,0,22,punjab
7/3/19,https://www.tribuneindia.com/news/punjab/illegal-mining-poses-threat-to-electricity-supply-in-150-villages/796179.html,"he said two new towers would be set up, one each on both sides of the river, so that the flooding of the river does not damages the towers",lives,0,2,20,0,22,punjab
2/25/19,https://www.tribuneindia.com/news/punjab/start-relining-of-canals-before-ls-polls-ngo/734246.html,"the centre had claimed that the projects would help address the problem of flooding in 84,800 hectares in muktsar, faridkot, ferozepur and fazilka",lives,1,3,1,0,5,"faridkot, fazilka, ferozepur, sas nagar, sri muktsar sahib"
2/25/19,https://www.tribuneindia.com/news/punjab/start-relining-of-canals-before-ls-polls-ngo/734246.html,"finance minister arun jaitley had said the projects would help improve irrigation in 98,739 hectares in rajasthan and 69,086 hectares in punjab",lives,1,3,1,0,5,"faridkot, fazilka, ferozepur, sas nagar, sri muktsar sahib"
9/26/18,https://www.tribuneindia.com/news/punjab/centre-grants-rs-825-crore-for-relining-of-sirhind-and-rajasthan-feeder-canals/659137.html," a government statement said the projects would help address the problem of flooding in 84,800 hectare of land in muktsar, faridkot and ferozpur districts in southwest punjab",lives,1,10,6,1,18,"faridkot, sri muktsar sahib"
9/26/18,https://www.tribuneindia.com/news/punjab/centre-grants-rs-825-crore-for-relining-of-sirhind-and-rajasthan-feeder-canals/659137.html," the statement said the projects would help improve irrigation in 98,739 hectares of land in rajasthan and 69,086 hectares in punjab",lives,1,10,6,1,18,"faridkot, sri muktsar sahib"
9/26/18,https://www.tribuneindia.com/news/punjab/no-excess-water-to-be-released-from-pong-dam/658851.html,"the revenue, rehabilitation and disaster management department has set up a five-member state disaster response cell to monitor the situation",lives,0,1,3,0,4,punjab
7/5/18,https://www.tribuneindia.com/news/punjab/rain-pours-misery-in-malwa-5-dead/615378.html,"while one electricity tower fell in the fields, the other got partially damaged, disrupting the power supply",lives,20,27,30,0,77,"patiala, sas nagar, sri muktsar sahib"
7/5/18,https://www.tribuneindia.com/news/punjab/rain-pours-misery-in-malwa-5-dead/615378.html," meanwhile, the district administration announced a relief of rs 1 lakh each to the next of kin of deceased",lives,20,27,30,0,77,"patiala, sas nagar, sri muktsar sahib"
5/21/18,https://www.tribuneindia.com/news/punjab/shahkot-public-issues-take-a-backseat-amid-mud-slinging/592362.html,"deepkamal kaur tribune news service jalandhar, may 20  amid allegations and counter-allegations between the two main parties, the sad and the congress, the real issues affecting residents of the bypoll-bound shahkot assembly constituency seem to have taken a backseat",lives,3,19,23,0,45,"jalandhar, ludhiana"
5/21/18,https://www.tribuneindia.com/news/punjab/shahkot-public-issues-take-a-backseat-amid-mud-slinging/592362.html,"farmers rue that despite huge damage, no one bothered to assess their loss or given any assurance to them for providing relief",lives,3,19,23,0,45,"jalandhar, ludhiana"
5/21/18,https://www.tribuneindia.com/news/punjab/shahkot-public-issues-take-a-backseat-amid-mud-slinging/592362.html," vicky bajwa of bajwa kalan village, 10 km from roopewal, said: ‚Äúmuskmelon growers here have been badly affected",lives,3,19,23,0,45,"jalandhar, ludhiana"
5/21/18,https://www.tribuneindia.com/news/punjab/shahkot-public-issues-take-a-backseat-amid-mud-slinging/592362.html,"muskmelon growers‚Äô plight  the constituency houses roopewal, one of the largest muskmelon markets in asia, which has lost almost all its fruit this year after the recent hailstorm",lives,3,19,23,0,45,"jalandhar, ludhiana"
10/4/16,https://www.tribuneindia.com/news/community/on-visit-to-border-villages-badal-comes-under-fire/304559.html," badal first visited tindiwala village, situated along the zero line, to take stock of the situation in the aftermath of surgical strikes and the subsequent evacuation of border villages",lives,5,14,18,1,38,ferozepur
7/12/16,https://www.tribuneindia.com/news/community/pontoon-gates-to-rid-harike-wetland-of-silt/264585.html,"varinder singh tribune news service chandigarh, july 11 the solution to silt accumulation in harike lake ‚Äî the largest wetland in north india ‚Äî is finally in sight with the help of pontoon gates",lives,2,5,3,1,11,punjab
7/12/16,https://www.tribuneindia.com/news/community/pontoon-gates-to-rid-harike-wetland-of-silt/264585.html, rust had damaged the old gates that these could not be removed for over six decades,lives,2,5,3,1,11,punjab
3/26/16,https://www.tribuneindia.com/news/community/punjabi-restaurateur-going-great-guns-in-ghana/213441.html," ‚Äúi did not meet the women but we were told that the food that was supplied to us was brought by the association and their leader is the one who owns the kohinoor restaurants,‚Äù ama konadu, one of the victims who received the support, said",lives,5,3,4,1,13,punjab
1/30/16,https://www.tribuneindia.com/news/community/after-iit-m-mohali-turns-to-pec-to-check-waterlogging/189677.html," the areas affected are phase 3b1, 3b2, 4, 5 and 11, and sectors 70, 71 and 65-c",lives,3,0,6,0,9,sas nagar
8/28/15,https://www.tribuneindia.com/news/community/breach-in-ropar-thermal-plant-channel/125408.html,"while the power generation was stopped at one of the units, farmers in the affected villages of ranjitpura, avankot and aaspur said their crops worth lakhs of rupees had been hit due to the leakage of hot water from the channel",lives,0,7,6,2,15,punjab
7/16/15,https://www.tribuneindia.com/news/punjab/haryana-not-letting-us-tame-ghaggar-govt/107290.html,"the canal was built in 2007 at a cost of rs 400 crore, but it couldn‚Äôt be put to use",lives,1,9,5,1,16,"patiala, sangrur, sas nagar"
5/28/15,https://www.tribuneindia.com/news/community/mps-allocate-funds-but-fail-to-lobby-for-state-s-interests/86280.html," ¬†  ¬†  patiala dharamvira gandhi (aap)  ¬†  questions asked: 15 mplad funds utilised: rs 5 crore attendance: 70% ¬†  initiatives taken  bagged rs 1,720-crore project for electrification of rajpura-bathinda rail track got six out of nine wildlife sanctuaries fenced instrumental in getting patiala chosen as a smart city disbursed rs 18 lakh from pmo relief fund among poor patients sanctioned rs 20 lakh for nabha fire brigade¬†  unkept promises  failed to take any measure to tame the ghaggar failed to connect rajpura with chandigarh via rail couldn‚Äôt provide 40% of the city population access to potable water  dr dharamvira gandhi, who is a reputed cardiologist, was the leader of the aam aadmi party in parliament till about a month ago",lives,15,16,13,2,46,"amritsar, bathinda, faridkot, ferozepur, hoshiarpur, jalandhar, ludhiana, moga, patiala, sas nagar"
5/28/15,https://www.tribuneindia.com/news/community/mps-allocate-funds-but-fail-to-lobby-for-state-s-interests/86280.html,"the mp, nevertheless, participated in a number of debates including, right to fair compensation and transparency in land acquisition, rehabilitation and resettlement (amendment) bill 2015 and the railway budget",lives,15,16,13,2,46,"amritsar, bathinda, faridkot, ferozepur, hoshiarpur, jalandhar, ludhiana, moga, patiala, sas nagar"
5/28/15,https://www.tribuneindia.com/news/community/mps-allocate-funds-but-fail-to-lobby-for-state-s-interests/86280.html,"despite having its alliance partner ruling at the centre, no thought was spared to develop a special economic zone here, which could have given a boost to the development and generated employment opportunities",lives,15,16,13,2,46,"amritsar, bathinda, faridkot, ferozepur, hoshiarpur, jalandhar, ludhiana, moga, patiala, sas nagar"
5/22/15,https://www.tribuneindia.com/news/punjab/entry-tax-fallout-sugar-prices-up-by-rs-2-per-kg/83797.html,"with just 9.5 per cent sugar recovery from cane, the sugar mill owners in the state were claiming that the cost of production of sugar was around rs 3,500 per quintal",lives,0,17,2,3,22,punjab
5/22/15,https://www.tribuneindia.com/news/punjab/entry-tax-fallout-sugar-prices-up-by-rs-2-per-kg/83797.html,"as a result, the cost of production of sugar in up is around rs 2,800 per quintal, as they were paying farmers just rs 240 per quintal for sugarcane",lives,0,17,2,3,22,punjab
11/1/19,https://www.tribuneindia.com/news/punjab/-ngt-order-ignored/854589.html,"on january 31, the four-member principal bench of the ngt had asked a joint committee, comprising members of the central pollution control board, punjab director mining, and punjab state pollution control board (ppcb), to take remedial measures to stop illegal mining and assess damage",lives,0,2,7,0,9,punjab
9/2/19,https://www.tribuneindia.com/news/punjab/1-lakh-cattle-on-the-loose-claim-100-lives-a-year-in-punjab/826294.html, another eight lives have been lost in sangrur in august,lives,18,26,4,2,50,"patiala, sangrur"
9/2/19,https://www.tribuneindia.com/news/punjab/1-lakh-cattle-on-the-loose-claim-100-lives-a-year-in-punjab/826294.html, another eight lives were lost in sangrur in august,lives,18,26,4,2,50,"patiala, sangrur"
8/22/19,https://www.tribuneindia.com/news/punjab/bhakra-water-level-to-be-reduced-by-5-ft/820722.html,"this includes allocation of rs 220 crore for undertaking a study and related works under phase-2 of the dam rehabilitation and improvement project that would cover structural, hydrological, seismic and geo-physical aspects",lives,0,0,3,0,3,punjab
8/14/19,https://www.tribuneindia.com/news/punjab/rains-15-below-average-in-state/817448.html,"ush({ });  in 13 districts, the rain has been below average, of which nine districts and some border areas are among those severely affected",lives,0,1,3,0,4,"amritsar, barnala, bathinda, faridkot, fazilka, ferozepur, hoshiarpur, jalandhar, kapurthala, patiala, sangrur, sri muktsar sahib, tarn taran"
8/13/19,https://www.tribuneindia.com/news/punjab/cotton-growers-rent-boom-sprayers-for-pest-control/817060.html,it costs rs 90 per acre as spraying expenses against rs 150 being spent by the farmers with the help of outsourced manual labour,lives,1,44,1,6,52,"ludhiana, moga"
8/13/19,https://www.tribuneindia.com/news/punjab/cotton-growers-rent-boom-sprayers-for-pest-control/817060.html," several studies carried in the recent past by agro experts suggest that 40 to 50 per cent of the pesticide is wasted with manual spray, which not only adds to the cost of production, but also is environmentally hazardous and create imbalance in the natural ecosystem",lives,1,44,1,6,52,"ludhiana, moga"
8/13/19,https://www.tribuneindia.com/news/punjab/cotton-growers-rent-boom-sprayers-for-pest-control/817060.html,"save time, labour¬†  boom sprayers save time, labour and cost of operation as well as reduces drudgery of the spraying operation¬† the field capacity of the sprayer is approximately 10 acres per hour it costs  rs 90 per acre as spraying expenses against  rs 150 being spent by farmers with the help of outsourced manual labour  ",lives,1,44,1,6,52,"ludhiana, moga"
8/1/19,https://www.tribuneindia.com/news/punjab/-2-day-session-to-cost-exchequer-rs-3-5-crore/810883.html,‚Äò2-day‚Äô session to cost exchequer rs 3.5 crore,lives,1,2,2,2,7,ferozepur
7/22/19,https://www.tribuneindia.com/news/punjab/-missing-sidhu-posters/805575.html,"with sidhu‚Äôs photograph at the centre, the poster says, ‚Äúupset over not being made the cm, he has gone missing",lives,10,2,7,0,19,"amritsar, bathinda, fatehgarh sahib, jalandhar"
7/22/19,https://www.tribuneindia.com/news/punjab/-missing-sidhu-posters/805575.html,he has been missing for the last one and a half month,lives,10,2,7,0,19,"amritsar, bathinda, fatehgarh sahib, jalandhar"
7/17/19,https://www.tribuneindia.com/news/punjab/gushing-ghaggar-floods-patiala-villages/803050.html,"now public as well as private property and paddy on hundreds of acres is getting affected,‚Äù said mukhtiar singh of maru village",lives,12,10,36,0,58,patiala
7/17/19,https://www.tribuneindia.com/news/punjab/gushing-ghaggar-floods-patiala-villages/803050.html,residents said more than 300 people were affected,lives,12,10,36,0,58,patiala
7/12/19,https://www.tribuneindia.com/news/punjab/cut-in-coal-supply-costs-state-rs-600-cr-per-year/800611.html,cut in coal supply costs state rs 600 cr per year,lives,2,1,4,4,11,bathinda
7/12/19,https://www.tribuneindia.com/news/punjab/cut-in-coal-supply-costs-state-rs-600-cr-per-year/800611.html,"ruchika m khanna  tribune news service  chandigarh, july 11  the punjab government is suffering a loss of rs 600 crore each year on account of the union government‚Äôs policy of cutting down on the coal allocation to the state",lives,2,1,4,4,11,bathinda
7/4/19,https://www.tribuneindia.com/news/punjab/mining-ops-shut-sand-prices-soar/796824.html,"at the same time, it will not pose any difficulty to big builders, who use pathankot sand (which is 60-70%costlier as it has more strength).",lives,5,5,8,1,19,"ludhiana, pathankot"
6/27/19,https://www.tribuneindia.com/news/punjab/farmers-in-doaba-unsure-of-sowing-water-guzzling-paddy/793506.html,"ush({ });  satnam singh sahni, a farmer from kapurthala district, said he had sown paddy over 10 acres, out of which 4 acres were damaged because of excessive heat",lives,1,68,7,1,77,"jalandhar, kapurthala, sbs nagar"
6/18/19,https://www.tribuneindia.com/news/punjab/pre-monsoon-showers-elude-region-punjab-worst-hit/789367.html,"faridkot, with a deficiency of 29 per cent, is the least affected",lives,0,0,4,0,4,"barnala, faridkot, fatehgarh sahib, ferozepur, mansa, moga, patiala, sangrur, sas nagar, tarn taran"
6/8/19,https://www.tribuneindia.com/news/punjab/villagers-claim-crop-damage-by-swelling-sutlej-admn-denies/784817.html,"sanghera village sarpanch balkar singh along with other residents claimed that paddy nurseries, fodder and mint crops on more than 750 acres had been damaged in six villages",lives,13,19,30,0,62,moga
2/16/19,https://www.tribuneindia.com/news/punjab/work-on-bridge-for-island-villages-to-begin-today/729611.html,"deepkamal kaur tribune news service jalandhar, february 15 set to provide a major relief to the residents of 16 island villages falling in the mand area of sultanpur lodhi, the work to construct a permanent bridge to connect them to the mainland is set to start on saturday",lives,5,8,13,1,27,jalandhar
2/16/19,https://www.tribuneindia.com/news/punjab/work-on-bridge-for-island-villages-to-begin-today/729611.html,the pwd will get the bridge constructed at a cost of rs 9.83 crore,lives,5,8,13,1,27,jalandhar
12/15/18,https://www.tribuneindia.com/news/punjab/sukhbir-guilty-of-misleading-house-report/698597.html,the report said the five-member committee took help of the home department and the police to check cctv footage as regards any entry of daduwal‚Äôs vehicle into the official residence of the chief minister,lives,2,2,7,0,11,punjab
12/14/18,https://www.tribuneindia.com/news/punjab/2-day-session-day-1-11-minutes-at-rs-70-lakh/698206.html,"  ¬† ¬†the mlas will get rs 1,500 as daily allowance, travelling allowance at rs 15 per km, plus the fuel cost for security vehicles escorting them",lives,2,1,4,4,11,punjab
12/14/18,https://www.tribuneindia.com/news/punjab/2-day-session-day-1-11-minutes-at-rs-70-lakh/698206.html, the per day cost of a house session works out at rs 70 lakh on an average,lives,2,1,4,4,11,punjab
12/9/18,https://www.tribuneindia.com/news/punjab/pass-resolution-in-assembly-in-support-of-women-s-bill-rahul-to-capt/695907.html,"while the opponents of the bill have cast doubts on the ability of women to affect change, the leadership role taken by women after the 73rd and 73th constitutional amendments have proved the detractors wrong,"" he said in his letter",lives,2,0,2,0,4,punjab
11/12/18,https://www.tribuneindia.com/news/punjab/each-year-paddy-farce-only-grows-worse/681459.html,"punjab is paying more than rs 200 crore every month to the centre towards what has been declared as dues (plus interest) on account of ‚Äòmissing paddy‚Äô, mostly procured during sad-bjp rule",lives,4,54,3,4,65,punjab
9/26/18,https://www.tribuneindia.com/news/punjab/govt-tells-farmers-to-drain-out-excess-water-from-fields/658871.html,"kulwinder sandhu tribune news service moga, september 25  the state agriculture department has advised farmers to drain out excess water from low-lying areas which got stagnated due to heavy rains in the past few days to prevent damage to cotton, paddy, maize and horticultural crops",lives,2,51,5,0,58,"barnala, bathinda, mansa, moga"
9/26/18,https://www.tribuneindia.com/news/punjab/govt-tells-farmers-to-drain-out-excess-water-from-fields/658871.html,"the farmers who had gone for early planting of paddy may suffer losses but overall, it will be beneficial for those who opted for late planting as per the government‚Äôs schedule",lives,2,51,5,0,58,"barnala, bathinda, mansa, moga"
9/25/18,https://www.tribuneindia.com/news/punjab/state-in-excess-rainfall-category-now/658397.html," in just two days between saturday and monday morning, the state received 110 mm rain, which helped it recover from deficient monsoon category",lives,0,0,2,0,2,"amritsar, gurdaspur, ludhiana, pathankot, patiala"
9/14/18,https://www.tribuneindia.com/news/punjab/outlet-blocked-village-turns-pond/652677.html,"ush({ });  nearly 60 per cent of the households are affected by the scourge of water which, in turn, leads to various vector-borne diseases",lives,11,6,20,0,37,"gurdaspur, sas nagar"
9/14/18,https://www.tribuneindia.com/news/punjab/outlet-blocked-village-turns-pond/652677.html," irked with no response from the administration, the villagers collected rs 3,000 and drained out water from the streets with the help of a diesel pump",lives,11,6,20,0,37,"gurdaspur, sas nagar"
8/3/18,https://www.tribuneindia.com/news/punjab/3-diarrhoea-cases-reported-in-moga/631305.html,"moga, august 2  at least three patients affected with diarrhoea have been admitted to the district hospital here",lives,7,0,3,0,10,moga
7/23/18,https://www.tribuneindia.com/news/punjab/centre-rushing-through-gst-laws-says-manpreet/625025.html,"ruchika m khanna tribune news service chandigarh, july 22  finance minister manpreet singh badal has opposed the centre‚Äôs ‚Äúhasty framing of laws‚Äù related to the goods and services tax (gst), touted by the saffron party as its biggest economic reform",lives,0,0,1,1,2,punjab
7/21/18,https://www.tribuneindia.com/news/punjab/fields-inundated-dept-awaits-funds-for-water-lifting-pumps/624105.html,"archit watts tribune news service pakki tibbi (muktsar), july 20 more than two weeks have passed since a huge chunk of agricultural land at pakki tibbi village in the lambi assembly segment was inundated with rainwater, the drainage department is awaiting funds under the state disaster relief fund (sdrf) to expedite the work to drain out water",lives,5,13,20,1,39,sri muktsar sahib
7/19/18,https://www.tribuneindia.com/news/punjab/notice-to-state-on-msp-pil/622773.html,"it is expected that two bills related to farmers, one on debt relief and another on hike in msp to  rs 2,250, will be tabled in parliament",lives,0,45,2,0,47,punjab
5/26/18,https://www.tribuneindia.com/news/punjab/beas-spill-food-scarcity-to-hit-dolphins-gharials/595164.html," starting from the upstream, an extensive survey is being done to determine the most-affected stretch of the river between harike and karmuwal",lives,3,8,6,0,17,amritsar
2/7/18,https://www.tribuneindia.com/news/punjab/state-groundwater-most-contaminated/539909.html,"vijay mohan tribune news service chandigarh, february 6  while making up less than 2 per cent of india‚Äôs landmass, punjab accounts for 88 per cent of the total habitations in the country that are adversely affected with the presence of heavy metals in groundwater",lives,0,1,19,0,20,"amritsar, barnala, bathinda, fatehgarh sahib, ferozepur, gurdaspur, kapurthala, ludhiana, mansa, patiala, sangrur, sas nagar, sri muktsar sahib, tarn taran"
2/7/18,https://www.tribuneindia.com/news/punjab/state-groundwater-most-contaminated/539909.html," the total number of affected villages in the country, according to the data compiled by the central ground water board (cgwb) is 2,420, which includes 273 in west bengal, seven in assam and one in karnataka",lives,0,1,19,0,20,"amritsar, barnala, bathinda, fatehgarh sahib, ferozepur, gurdaspur, kapurthala, ludhiana, mansa, patiala, sangrur, sas nagar, sri muktsar sahib, tarn taran"
2/7/18,https://www.tribuneindia.com/news/punjab/state-groundwater-most-contaminated/539909.html," heavy metals: 2,139 villages hit hard  punjab accounts for 88 per cent of the total habitations in the country that are adversely affected with the presence of heavy metals in groundwater",lives,0,1,19,0,20,"amritsar, barnala, bathinda, fatehgarh sahib, ferozepur, gurdaspur, kapurthala, ludhiana, mansa, patiala, sangrur, sas nagar, sri muktsar sahib, tarn taran"
2/7/18,https://www.tribuneindia.com/news/punjab/state-groundwater-most-contaminated/539909.html,"the total number of affected villages in the country, according to the data compiled by the central ground water board (cgwb) is 2,420, which includes 273 in west bengal, seven in assam and one in karnataka",lives,0,1,19,0,20,"amritsar, barnala, bathinda, fatehgarh sahib, ferozepur, gurdaspur, kapurthala, ludhiana, mansa, patiala, sangrur, sas nagar, sri muktsar sahib, tarn taran"
10/22/17,https://www.tribuneindia.com/news/punjab/actual-cleaning-not-clean-chits-needed/485447.html,"an important aspect the most powerful and undisputed congress leader in the state may want to watch out for is this: one minister‚Äôs reputation does not affect the repute of a government much; but the day it begins to rub off on the top leader, the consequences can be unhappy",lives,1,0,2,0,3,gurdaspur
7/17/17,https://www.tribuneindia.com/news/punjab/rs-210-cr-for-channelising-swan-river/437771.html,"‚Äúto ameliorate the sufferings of farmers, the government is going to spend a sum of rs 210 crore to channelise the swan river,‚Äù he said, adding that the project would start in september and the swan river from agampur to santokhgarh would be channelised in two years",lives,6,12,1,0,19,punjab
7/7/17,https://www.tribuneindia.com/news/punjab/sand-gravel-prices-set-to-rise-further/432868.html,"going by the available material and the auction bids, the cost of material comes to rs 710 per tonne",lives,2,7,1,5,15,"amritsar, pathankot"
7/7/17,https://www.tribuneindia.com/news/punjab/sand-gravel-prices-set-to-rise-further/432868.html,add to it the processing charges and the cost rises to rs 921 per tonne,lives,2,7,1,5,15,"amritsar, pathankot"
7/7/17,https://www.tribuneindia.com/news/punjab/sand-gravel-prices-set-to-rise-further/432868.html,"thus, a tipper, which carries 30-tonne material, will cost around rs40,000 to the contractor",lives,2,7,1,5,15,"amritsar, pathankot"
7/7/17,https://www.tribuneindia.com/news/punjab/sand-gravel-prices-set-to-rise-further/432868.html," aap leader and rti activist advocate dinesh chadha said to recover their cost and make profit, contractors would mine thousands of acres beyond the contract area, cutting mountains in the process",lives,2,7,1,5,15,"amritsar, pathankot"
7/7/17,https://www.tribuneindia.com/news/punjab/sand-gravel-prices-set-to-rise-further/432868.html,"at this price, it will cost the contractor more than¬†rs¬†70,000 per¬†tipper after including transportation charges ",lives,2,7,1,5,15,"amritsar, pathankot"
6/20/17,https://www.tribuneindia.com/news/punjab/no-action-on-illegal-mining-near-chandbhan-drain/424955.html," notably, in 2013, when the rains had inundated a large number of fields, this drain had proved much helpful in draining the water",lives,5,6,3,0,14,"faridkot, fazilka, ferozepur, sri muktsar sahib"
6/12/17,https://www.tribuneindia.com/news/punjab/mining-mess-soaring-sand-prices-ground-claims/421039.html,"it had cost rs 1,400 to rs 1,500 a few months ago",lives,4,20,4,4,32,"ludhiana, moga, pathankot, patiala, sri muktsar sahib"
6/12/17,https://www.tribuneindia.com/news/punjab/mining-mess-soaring-sand-prices-ground-claims/421039.html," ‚Äútill two years ago, if somebody wanted to construct a 250 sq yd two-storied house in patiala and ordered sand and gravel from pathankot, it cost him just rs 1.5 lakh for three tippers of gravel and four of sand (including transportation cost)",lives,4,20,4,4,32,"ludhiana, moga, pathankot, patiala, sri muktsar sahib"
6/12/17,https://www.tribuneindia.com/news/punjab/mining-mess-soaring-sand-prices-ground-claims/421039.html,"now, the same will cost him anything between rs 2.8 lakh and rs 3 lakh,‚Äù claimed a real estate developer",lives,4,20,4,4,32,"ludhiana, moga, pathankot, patiala, sri muktsar sahib"
2/13/17,https://www.tribuneindia.com/news/community/no-govt-help-nangal-villagers-collect-money-to-repair-bridge/363373.html,"ush({ });as the bridge has been damaged badly, they will require at least rs5 lakh for its repair, say villagers",lives,17,5,19,3,44,punjab
12/31/16,https://www.tribuneindia.com/news/politics/caste-has-key-role-to-play-in-phillaur/344100.html,"in the 2007 elections, santokh had lost to the sad‚Äôs sarwan singh phillaur by 273 votes",lives,5,4,9,0,18,jalandhar
12/29/16,https://www.tribuneindia.com/news/community/stones-damaged-in-ropar-probe-on/343145.html,"but before he could that, the stone was damaged.",lives,5,5,16,0,26,punjab
12/24/16,https://www.tribuneindia.com/news/community/cheema-lays-stone-for-bridge-on-choe/341170.html,"he said the tenders for the bridge, to be built at a cost of rs 6.5 crore, had been floated",lives,0,0,4,1,5,punjab
12/7/16,https://www.tribuneindia.com/news/community/roads-fine-what-else-asks-ropar/333424.html,"he admits that the congress‚Äô successive defeats (2007 and 2012) have affected the area residents, even though some development has taken place in recent months",lives,23,7,13,0,43,punjab
11/30/16,https://www.tribuneindia.com/news/community/basically-it-s-about-basics-in-muktsar/330233.html," the gates built at all entrances to the town in memory of the 40 mukte (liberated ones) ‚Äî the sikhs who attained martyrdom during guru gobind singh‚Äôs last battle against the mughals here in 1705 ‚Äî are also a picture of neglect, with some pieces of red marble missing",lives,14,0,9,0,23,sri muktsar sahib
11/17/16,https://www.tribuneindia.com/news/politics/nothing-western-about-jalandhar-west/324441.html," encompassing seven areas set up during the mughal era and including several congested localities associated with the economically weaker sections, jalandhar west is categorised as an ‚Äúurban‚Äù constituency",lives,23,11,9,1,44,"jalandhar, kapurthala"
11/17/16,https://www.tribuneindia.com/news/politics/nothing-western-about-jalandhar-west/324441.html,"whichever community has two candidates representing the main political parties will suffer as the votes will get divided and the third one will have an edge,‚Äù a local politician claims",lives,23,11,9,1,44,"jalandhar, kapurthala"
9/29/16,https://www.tribuneindia.com/news/community/ravi-flows-into-pak-as-centre-reviews-treaty/302232.html," the ravi water was to be pooled at the proposed balancing reservoir by raising the dam with an estimated cost of rs 800 crore at shahpur kandi, about 11 km downstream the ranjit sagar dam",lives,0,2,1,1,4,pathankot
9/23/16,https://www.tribuneindia.com/news/community/dengue-spreads-tentacles-in-state-count-reaches-2-218/299424.html," following mohali, amritsar is the worst-affected district with 393 cases",lives,0,0,5,0,5,"amritsar, barnala, ludhiana, patiala, sangrur, sas nagar"
9/23/16,https://www.tribuneindia.com/news/community/dengue-spreads-tentacles-in-state-count-reaches-2-218/299424.html," in sangrur, where 208 confirmed cases of dengue have been reported, sherpur block is the worst-affected area from where around 135 cases have been reported",lives,0,0,5,0,5,"amritsar, barnala, ludhiana, patiala, sangrur, sas nagar"
9/22/16,https://www.tribuneindia.com/news/community/prolonged-monsoon-led-to-rise-in-dengue-cases-says-expert/299015.html," with 578 cases reported so far, mohali is the worst-affected district with dengue epidemic in the state followed by 357 cases in amritsar, 168 in paitala, 152 in ludhiana, 155 in jalandhar and 142 in sangrur",lives,1,1,2,0,4,"amritsar, jalandhar, ludhiana, sangrur, sas nagar"
9/8/16,https://www.tribuneindia.com/news/community/cong-mla-to-propose-farm-debt-waiver-bill/291894.html,"the bill submitted with the speaker has been titled ‚Äúpunjab agricultural debt waiver and debt relief bill, 2016‚Äù",lives,0,20,2,0,22,punjab
8/25/16,https://www.tribuneindia.com/news/community/gurdaspur-residents-seek-road-repair/285186.html,"for the last four months, the road has been in a dilapidated condition with pwd officials claiming that ‚Äúthey are helpless as they cannot spray tar due to the rainy season",lives,8,0,1,0,9,gurdaspur
8/24/16,https://www.tribuneindia.com/news/community/shopkeepers-block-road-in-gurdaspur-for-3-hours/284830.html,for the last four months the road has been lying in a dilapidated condition with pwd officials claiming that ‚Äúthey are helpless as they cannot spray tar due to the rainy season,lives,4,0,2,0,6,gurdaspur
7/4/16,https://www.tribuneindia.com/news/community/post-rains-power-supply-improves/260792.html," ‚Äúanother 700 mw from the western sector and 500 mw from short-term power purchase will help us reach around 11,000 mw",lives,0,17,2,0,19,patiala
6/16/16,https://www.tribuneindia.com/news/community/paddy-growers-cheer-as-rain-deficit-narrows/252325.html,"amaninder pal tribune news service chandigarh, june 15  much to the relief of farmers and agriculture officials, showers that hit 13 districts of the state early this morning has reduced rainfall deficit in punjab by 67 percentage points",lives,0,14,3,0,17,"ferozepur, moga, sri muktsar sahib, tarn taran"
6/14/16,https://www.tribuneindia.com/news/governance/50-ft-canal-breach-plugged-in-abohar/251452.html,"our correspondent  abohar, june 13  the 50-feet-wide breach in a canal that had yesterday inundated hundreds of acres of land in three villages here has now been plugged with the help of jcb machines and farmers",lives,2,9,5,0,16,punjab
6/9/16,https://www.tribuneindia.com/news/community/paddy-sowing-power-dept-gears-up-to-meet-11-000-mw-demand/248918.html,"ush({ });  ‚Äúfurther 700 mw from western sector and 500 mw from short term power purchase will help us reach around 11,000 mw",lives,0,11,1,0,12,patiala
6/1/16,https://www.tribuneindia.com/news/community/growing-paddy-takes-heavy-toll-on-groundwater-table/245071.html,"ush({ });  in the waterlogging-affected districts of south punjab in muktsar, the shallowest water depth is 1.40 m in malout block while the deepest is 6.70 m in lambi",lives,3,13,3,0,19,"barnala, faridkot, ferozepur, hoshiarpur, patiala, sangrur, sri muktsar sahib"
3/19/16,https://www.tribuneindia.com/news/community/state-keen-to-implement-crop-insurance-scheme/210777.html,it is estimated that 5-7 per cent of the wheat crop has been affected and the government is still assessing the extent of loss,lives,0,38,8,0,46,ludhiana
3/19/16,https://www.tribuneindia.com/news/community/dhindsa-announces-more-sops/210768.html,"tribune news service  chandigarh march 18 concluding the debate on his budget proposals for 2016-17, punjab finance minister parminder singh dhindsa today announced three more incentives in the house: 50 per cent subsidy for fencing of fields in kandi areas to prevent damage of crops by wild animals; making turmeric vat-free and reducing vat (value-added tax) on other spices from 6.5 to 4 per cent; and setting aside rs 50-crore corpus for self-sustainable sewa kendras that the government proposes to set up this year",lives,0,12,10,2,24,punjab
3/19/16,https://www.tribuneindia.com/news/community/dhindsa-announces-more-sops/210768.html,"addressing the house after the four congress mlas, including leader of the opposition charanjit singh channi, staged a walkout, dhindsa termed the budget for 2016-17 as a step towards boosting the state‚Äôs economy",lives,0,12,10,2,24,punjab
3/19/16,https://www.tribuneindia.com/news/community/dhindsa-announces-more-sops/210768.html,"dhindsa added that to compensate the peasantry, the state government had already released rs 800 crore as damages towards crops hit by heavy rain, including rs 112 crore for february, march and april 2015; rs 670 crore for the damaged cotton crop; and rs 54 crore for crops affected by heavy monsoon rain and hailstorms",lives,0,12,10,2,24,punjab
2/18/16,https://www.tribuneindia.com/news/community/water-level-in-reservoirs-satisfactory/197823.html,"patiala, february 17  despite a deficit monsoon in 2015, the farming community in punjab and the neighbouring states of haryana and rajasthan can heave a sigh of relief as various reservoirs, including bhakra and pong dams, continue to have a high level of water this year",lives,0,2,2,0,4,patiala
2/16/16,https://www.tribuneindia.com/news/community/despite-odds-grain-produce-to-be-higher/196926.html,"vibha sharma tribune news service new delhi, february 15 india‚Äôs foodgrain production during the 2015-16 crop year (july to june) will be higher than the overall production during the preceding crop year 2014-15 in spite of adversities suffered by the sector throughout the year",lives,2,16,2,0,20,punjab
2/14/16,https://www.tribuneindia.com/news/community/to-serve-people-he-bridges-gaps-in-development/196012.html,"after the inauguration of the 670-feet bridge, built at a cost of over rs 7 crore, the distance between anandpur sahib and nurpur bedi has been reduced from 22 km to a just 7 km",lives,4,0,7,1,12,punjab
9/29/15,https://www.tribuneindia.com/news/courts/train-investigating-agencies-to-be-sensitive-prompt-in-rape-cases-hc/139196.html," dismissing vishal appeal against seven years rigorous imprisonment sentence, justice r",lives,3,0,3,0,6,ludhiana
9/29/15,https://www.tribuneindia.com/news/courts/train-investigating-agencies-to-be-sensitive-prompt-in-rape-cases-hc/139196.html,nagrath asserted the story of three-four unidentified boys surrounding the girls along with the two accused was propounded by the investigating agency either to blackmail some more boys or to help the accused during the trial,lives,3,0,3,0,6,ludhiana
9/28/15,https://www.tribuneindia.com/news/punjab/revise-basmati-price-or-face-stir-farmer-unions-warn-govt/138834.html,"but many farmers have already sold off their produce at prices ranging from rs 900-1,200 which is much less than their actual input cost",lives,2,62,7,3,74,ferozepur
9/28/15,https://www.tribuneindia.com/news/punjab/revise-basmati-price-or-face-stir-farmer-unions-warn-govt/138834.html,"""the farmers who had sown 1509 are feeling dejected as they will not be able to recover even their input costs",lives,2,62,7,3,74,ferozepur
9/28/15,https://www.tribuneindia.com/news/punjab/revise-basmati-price-or-face-stir-farmer-unions-warn-govt/138834.html,"  another farmer nihal singh of machibugra village said that he had sown basmati 1509 on his five-acre land which cost him around rs 16,000 per acre",lives,2,62,7,3,74,ferozepur
9/28/15,https://www.tribuneindia.com/news/punjab/revise-basmati-price-or-face-stir-farmer-unions-warn-govt/138834.html," ""we farmers expect at least rs 2,000 profit to survive and sustain our family",lives,2,62,7,3,74,ferozepur
9/23/15,https://www.tribuneindia.com/news/punjab/farmers-worried-as-heavy-rain-lashes-punjab-haryana/136794.html,"chandigarh, september 23    heavy rain has lashed vast swathes of punjab and some parts of haryana since yesterday, raising fears of damage to paddy crop, which is ready for harvesting",lives,1,24,9,0,34,"amritsar, gurdaspur, hoshiarpur, ludhiana, moga, patiala, sangrur, sas nagar, tarn taran"
9/23/15,https://www.tribuneindia.com/news/punjab/farmers-worried-as-heavy-rain-lashes-punjab-haryana/136794.html," after untimely rain and hailstorm in march-april this year caused heavy damage to crops in the two leading agrarian states, heavy showers at the fag end of the monsoon have again increased the woes of the farmers",lives,1,24,9,0,34,"amritsar, gurdaspur, hoshiarpur, ludhiana, moga, patiala, sangrur, sas nagar, tarn taran"
9/18/15,https://www.tribuneindia.com/news/community/monsoon-session-of-pb-assembly-begins-cong-calls-it-a-mere-formality/134751.html," though the state government had released close to rs 10 crore for the payment to cotton growers affected by whitefly attack, congress is up in arms against the sad-bjp combine for the ""meagre"" payment",lives,0,7,3,0,10,punjab
9/10/15,https://www.tribuneindia.com/news/punjab/punjab-govt-approves-bailout-package-for-sugar-mills/131383.html,"chandigarh, september 10  the punjab government today approved a loan of rs 200 crore and interest subvention scheme for ailing sugar mills to help them clear cane arrears of farmers in the state",lives,1,16,2,2,21,punjab
9/10/15,https://www.tribuneindia.com/news/punjab/punjab-govt-approves-bailout-package-for-sugar-mills/131383.html,"ush({ });  in view of the sugar mills where the cost of production was higher than the whole sale price of sugar, the government would be paying about rs 50 per quintal of sugarcane and the sugar mills would provide rs 245 per quintal to the cane growers, he said",lives,1,16,2,2,21,punjab
8/20/15,https://www.tribuneindia.com/news/community/burj-village-cut-off-as-swollen-sutlej-erodes-approach-road-to-bridge/121891.html,"tribune news service anandpur sahib, august 19  a bridge constructed by baba labh singh recently at burj village was damaged badly due to heavy flow of water in sutlej, leaving hundreds of people stranded here today",lives,9,3,11,0,23,punjab
8/4/15,https://www.tribuneindia.com/news/community/natural-drains-in-moga-choked-with-weed-silt/115211.html,"it has been stated that groundwater withdrawal has exceeded natural recharge by more than 200 per cent in these blocks, severely affecting small and marginal farmers",lives,6,3,10,0,19,moga
8/3/15,https://www.tribuneindia.com/news/community/monsoon-at-peak-drains-yet-to-be-cleaned-in-muktsar/114868.html, chauntra village had suffered badly during rains in 2013,lives,9,7,15,1,32,sri muktsar sahib
7/15/15,https://www.tribuneindia.com/news/punjab/waterlogging-unfinished-work-worries-farmers/106825.html,"similarly, 97 villages in neighbouring fazilka district are affected by waterlogging",lives,2,19,21,0,42,"fazilka, sri muktsar sahib"
7/15/15,https://www.tribuneindia.com/news/punjab/waterlogging-unfinished-work-worries-farmers/106825.html," farmers from bhundar, lundewala villages said, ‚Äúour crops get damaged if it rains for around three days",lives,2,19,21,0,42,"fazilka, sri muktsar sahib"
7/13/15,https://www.tribuneindia.com/news/community/civic-system-collapses-leaving-residents-in-the-lurch/106010.html,"gs paul tribune news service amritsar, july 12  around 60 per cent of the city‚Äôs population suffers during rains as the modern civil line areas get submerged due to poor drainage system",lives,7,0,3,0,10,amritsar
7/9/15,https://www.tribuneindia.com/news/community/just-11-of-483-village-ponds-cleaned-in-muktsar-dist-this-year/104247.html,"archit watts tribune news service muktsar, july 8  the authorities have neither cleaned nor dewatered the village ponds even though the district is hit by waterlogging and suffers huge losses during monsoon",lives,4,1,15,0,20,sri muktsar sahib
6/26/15,https://www.tribuneindia.com/news/punjab/ludhiana-authorities-not-clear-about-project-goals/98762.html," badish k jindal, chairman of the federation of association of small industries of india (fasii), said, ‚Äúa smart city means 24-hour water supply, uninterrupted power, no heaps of garbage, pollution at a considerable low, well-carpeted roads, no traffic congestion, basic amenities to all residents, rehabilitation of slum dwellers, industry getting a boost, a state-of-the-art airport and, above all, the cleaning of the buddha nullah which is playing havoc with the lives of the residents",lives,14,0,1,1,16,ludhiana
6/26/15,https://www.tribuneindia.com/news/punjab/ludhiana-authorities-not-clear-about-project-goals/98762.html,its estimated cost will be around rs 100 crore,lives,14,0,1,1,16,ludhiana
6/24/15,https://www.tribuneindia.com/news/punjab/monsoon-arrives-early-brings-cheers/97808.html,"sarbjit dhaliwal tribune news service chandigarh, june 23  the arrival of monsoon about a week ahead of the expected schedule has brought relief to residents from the scorching heat and cheers to farmers who are busy transplanting paddy",lives,2,10,4,0,16,punjab
6/14/15,https://www.tribuneindia.com/news/community/81-ft-khanda-set-up-at-anandpur-sahib/93586.html,it cost rs 22 lakh to build the 3-tonne khanda,lives,0,0,1,1,2,moga
6/2/15,https://www.tribuneindia.com/news/community/monsoon-ahead-but-drains-in-muktsar-yet-to-be-desilted/88370.html, senior officials of the drainage wing said the drains having a length of about 425 km were to be cleaned in muktsar district with an estimated cost of about rs 4.25 crore,lives,3,4,4,1,12,sri muktsar sahib
6/2/15,https://www.tribuneindia.com/news/community/monsoon-ahead-but-drains-in-muktsar-yet-to-be-desilted/88370.html,"ush({ });  despite the recommendations of a state-level committee of experts on waterlogging to carve out some new drains and that too with the help of 0.5-m interval contours, the work has not be started as yet",lives,3,4,4,1,12,sri muktsar sahib
5/27/15,https://www.tribuneindia.com/news/community/pond-not-cleaned-villagers-blame-govt/85856.html,"at least 20 cattle had been rescued as they slipped into¬†  the pond, gaushala workers claimed",lives,10,2,14,1,27,punjab
5/14/15,https://www.tribuneindia.com/news/community/connecting-people-pulanwala-baba-builds-sixth-bridge-costing-rs-5-cr/80273.html,connecting people: ‚Äòpulanwala baba‚Äô builds sixth bridge costing rs 5 cr,lives,5,0,9,4,18,punjab
3/3/15,https://www.tribuneindia.com/news/community/wheat-crop-in-moga-flattened/48955.html,"kulwinder sandhu and archit watts  tribune news service moga, march 2  wheat crop on at least 25,000 acres has been damaged in moga district because of high-speed winds and rain",lives,5,56,26,2,89,"bathinda, fatehgarh sahib, moga, sri muktsar sahib"
3/3/15,https://www.tribuneindia.com/news/community/wheat-crop-in-moga-flattened/48955.html,"the chairman of the market committee of fatehgarh panchtoor, joginder singh, has demanded 90 per cent subsidy on maize and moong seed so that the affected farmers can sow these short-duration crops and save themselves from heavy losses",lives,5,56,26,2,89,"bathinda, fatehgarh sahib, moga, sri muktsar sahib"
3/3/15,https://www.tribuneindia.com/news/community/wheat-crop-in-moga-flattened/48955.html," muktsar: six months ago, monsoon rains flattened cotton and paddy crops in muktsar district and damaged houses",lives,5,56,26,2,89,"bathinda, fatehgarh sahib, moga, sri muktsar sahib"
3/3/15,https://www.tribuneindia.com/news/community/wheat-crop-in-moga-flattened/48955.html,"  shingara singh mann, bathinda district president, bhartiya kisan union, said: ‚Äúin the district, more than 50 per cent farmers who had sown early variety of wheat have been affected",lives,5,56,26,2,89,"bathinda, fatehgarh sahib, moga, sri muktsar sahib"
1/21/15,https://www.tribuneindia.com/news/governance/low-waterlogging-relief-upsets-cotton-farmers/32510.html," the district administration has sought rs5,000 per acre compensation for complete crop loss, rs3,000 for 75 per cent damage and rs2,000 for 50 per cent loss",lives,4,73,38,4,119,mansa
1/21/15,https://www.tribuneindia.com/news/governance/low-waterlogging-relief-upsets-cotton-farmers/32510.html,"the figures show 3,554 acres of land with 75 to 100 per cent damage, 2,274 acres in 50-75 per cent category, 502 acres with 25-50 per cent and 257 acres with less than 25 per cent losses",lives,4,73,38,4,119,mansa
1/21/15,https://www.tribuneindia.com/news/governance/low-waterlogging-relief-upsets-cotton-farmers/32510.html," but the villagers contended that crop on more than 15,000 acres was damaged",lives,4,73,38,4,119,mansa
1/21/15,https://www.tribuneindia.com/news/governance/low-waterlogging-relief-upsets-cotton-farmers/32510.html," the department has shown below-75 per cent damage on 54 acres of land, belonging to 15 farmers, in musa village even though sarpanch avtar singh claimed the affected area was over 200 acres",lives,4,73,38,4,119,mansa
1/21/15,https://www.tribuneindia.com/news/governance/low-waterlogging-relief-upsets-cotton-farmers/32510.html," in chehlanwala village, the government record showed losses below-50 per cent losses on 70 acres and 50-75 per cent damage on 85 acres",lives,4,73,38,4,119,mansa
1/8/15,https://www.tribuneindia.com/news/community/govt-fails-to-double-prize-money-for-livestock-championship/27492.html," the stadium suffered a lot of damage in 2013 monsoon rains, when water accumulated in nearby residential areas was pumped into it",lives,3,9,3,4,19,sri muktsar sahib
10/5/19,https://www.tribuneindia.com/news/punjab/rain-damages-crops/842702.html,prem chand said they were expecting a bumper paddy crop this season but the hailstorm had damaged 30-40 per cent of the crops,lives,1,31,15,1,48,fazilka
7/29/19,https://www.tribuneindia.com/news/punjab/woman-killed-as-roof-collapses-due-to-rain/809305.html, the sdm said today rs 4 lakh had been approved as compensation to the affected family,lives,7,4,16,2,29,"bathinda, sas nagar"
7/25/19,https://www.tribuneindia.com/news/punjab/drain-line-still-clogged-in-muktsar/807330.html,"archit watts  tribune news service  muktsar, july 24  the recent rains have caused widespread damage to crops and buildings in muktsar district",lives,2,8,13,0,23,sri muktsar sahib
4/21/19,https://www.tribuneindia.com/news/punjab/arrivals-pick-up-pace-govt-expects-highest-ever-yield/761311.html,"tribune news service  chandigarh, april 20 post widespread rainfall in different parts of the state earlier this week, which damaged crop in certain areas, wheat arrivals have picked up in mandis over the last two days",lives,0,17,6,0,23,punjab
4/21/19,https://www.tribuneindia.com/news/punjab/arrivals-pick-up-pace-govt-expects-highest-ever-yield/761311.html,farmers and officers are hoping that increase in temperature will help in the recovery of the grain and the loss may not be more than 2 per cent,lives,0,17,6,0,23,punjab
4/18/19,https://www.tribuneindia.com/news/punjab/wheat-crop-flattened-capt-orders-girdawari/759813.html,"tribune reporters chandigarh, april 17  following reports of damage to wheat crop in various parts of the state due to rain and dust storm, chief minister capt amarinder singh today ordered a special girdawari for the assessment of crop loss",lives,8,60,26,3,97,"patiala, sangrur, sas nagar, sri muktsar sahib"
4/18/19,https://www.tribuneindia.com/news/punjab/wheat-crop-flattened-capt-orders-girdawari/759813.html," in abohar, farmers‚Äô efforts to plug breaches that developed yesterday in six sub-canals emanating from gang (bikaner) canal suffered a jolt as hailstorm and heavy rain lashed the border district for the third consecutive day on wednesday",lives,8,60,26,3,97,"patiala, sangrur, sas nagar, sri muktsar sahib"
4/18/19,https://www.tribuneindia.com/news/punjab/wheat-crop-flattened-capt-orders-girdawari/759813.html," the pspcl claimed to have utilised rs 24.5 crore funds to upgrade its grid sub-stations, besides the 220 kv main station, but consumers had no relief",lives,8,60,26,3,97,"patiala, sangrur, sas nagar, sri muktsar sahib"
10/12/18,https://www.tribuneindia.com/news/punjab/rain-hailstorm-ravage-paddy/666935.html,"kulwinder sandhu tribune news service moga, october 11  unseasonal rain, coupled with hailstorm, during the past 24 hours in the state has caused widespread damage to paddy crop, which is almost ready to harvest in amritsar, gurdaspur, patiala, ropar, fatehgarh sahib, mohali, hoshiarpur, kapurthala, tarn taran and some parts of moga district",lives,0,31,18,1,50,"amritsar, fatehgarh sahib, gurdaspur, hoshiarpur, kapurthala, moga, patiala, sas nagar, tarn taran"
10/12/18,https://www.tribuneindia.com/news/punjab/rain-hailstorm-ravage-paddy/666935.html," while confirming this to the tribune, dr jasbir singh bains, director, agriculture department, said about 2,500 acres of standing paddy crop had been affected in the anandpur sahib block of ropar district, 1,500 acres in khera and 500 acres in the khamano blocks of fatehgarh sahib district",lives,0,31,18,1,50,"amritsar, fatehgarh sahib, gurdaspur, hoshiarpur, kapurthala, moga, patiala, sas nagar, tarn taran"
9/22/18,https://www.tribuneindia.com/news/punjab/widespread-rain-in-punjab-haryana-may-damage-paddy-crop/657125.html,"chandigarh, september 22   widespread rain across punjab, haryana and chandigarh on saturday brought misery to farmers as the untimely showers have affected the standing paddy crop in the agrarian states",lives,1,28,11,0,40,"fatehgarh sahib, sas nagar"
8/10/18,https://www.tribuneindia.com/news/punjab/missing-forest-officer-s-body-found/634940.html,"our correspondent hoshiarpur, august 9  the body of missing forest range officer vijay kumar was found in a forest on thursday",lives,7,0,3,0,10,hoshiarpur
4/20/18,https://www.tribuneindia.com/news/punjab/farmers-seek-relief-for-crop-damage/576802.html,"sukhdev singh kokri, general secretary, bku (ekta), claimed that thousands of farmers in the state had suffered losses due to rain and fires",lives,4,36,15,2,57,"amritsar, faridkot, gurdaspur, moga, patiala, sangrur"
4/20/18,https://www.tribuneindia.com/news/punjab/farmers-seek-relief-for-crop-damage/576802.html,"ush({ });the farm union has claimed that more than 1,000 acres of wheat had already been damaged in fire incidents across the state and reports of such incidents were still coming daily",lives,4,36,15,2,57,"amritsar, faridkot, gurdaspur, moga, patiala, sangrur"
4/20/18,https://www.tribuneindia.com/news/punjab/farmers-seek-relief-for-crop-damage/576802.html,"however, officials of the agriculture department said the overall damage to wheat due to rain and hailstorm was limited in moga, faridkot and patiala districts with on the whole not more than 2 per cent losses",lives,4,36,15,2,57,"amritsar, faridkot, gurdaspur, moga, patiala, sangrur"
9/14/17,https://www.tribuneindia.com/news/punjab/dera-episode-casts-shadow-on-cotton-belt/466747.html,"ush({ });  crop loss in the entire cotton belt has been pegged at over 7,000 acres even as the punjab agriculture department is still assessing the damage",lives,2,21,8,1,32,"barnala, bathinda, faridkot, ferozepur, mansa, moga, sangrur, sri muktsar sahib"
7/19/17,https://www.tribuneindia.com/news/punjab/rain-ruins-cotton-crop-on-8-000-acres-in-mansa/438801.html,"the maximum damage has been reported from mansa district where cotton crop on over 8,000 acres has been ruined",lives,0,46,18,1,65,"barnala, bathinda, mansa"
7/19/17,https://www.tribuneindia.com/news/punjab/rain-ruins-cotton-crop-on-8-000-acres-in-mansa/438801.html,"experts said the maximum damage was caused by heavy rainfall in jhunir and mansa blocks of mansa district where more than 8,000 acres of standing cotton crop was submerged and had to be ploughed by farmers",lives,0,46,18,1,65,"barnala, bathinda, mansa"
7/19/17,https://www.tribuneindia.com/news/punjab/rain-ruins-cotton-crop-on-8-000-acres-in-mansa/438801.html,"in sehna, mahalkalan and barnala blocks of barnala district, 670 acres have been affected while about 200 acres of cotton crop was damaged in bathinda district",lives,0,46,18,1,65,"barnala, bathinda, mansa"
6/28/17,https://www.tribuneindia.com/news/community/300-stranded-at-attari-as-centre-blocks-pak-train/428830.html,300 stranded at attari as centre blocks pak train,lives,9,0,1,0,10,"amritsar, ferozepur"
6/28/17,https://www.tribuneindia.com/news/community/300-stranded-at-attari-as-centre-blocks-pak-train/428830.html,"chandigarh, june 28   nearly 300 pilgrims, mostly sikhs, from different parts of india were stranded at the attari railway station near amritsar on wednesday after the centre didn't allow a special train from pakistan that was to ferry them to that country to enter india",lives,9,0,1,0,10,"amritsar, ferozepur"
6/13/17,https://www.tribuneindia.com/news/punjab/rain-fury-3-farmers-die-canal-breaches-submerge-cotton/421481.html,"in hanumangarh, 850 poles and three transformers were damaged",lives,5,30,13,0,48,"fazilka, sas nagar"
6/13/17,https://www.tribuneindia.com/news/punjab/rain-fury-3-farmers-die-canal-breaches-submerge-cotton/421481.html," 130 acres inundated in fazilka  fazilka: saplings of paddy, maize, moong and vegetables on over 130 acres in mauzam village have been damaged due to canal breach that has remained unplugged for two consecutive days",lives,5,30,13,0,48,"fazilka, sas nagar"
6/7/17,https://www.tribuneindia.com/news/punjab/pleasant-wednesday-morning-after-rain-in-punjab-haryana/418802.html,"  chandigarh, june 7   there was moderate to heavy rain at several places in punjab and a few parts of haryana on wednesday, providing relief to people from the sweltering heat",lives,1,1,2,0,4,"jalandhar, ludhiana, patiala, sas nagar"
5/30/17,https://www.tribuneindia.com/news/punjab/storm-wreaks-havoc-2-dead/414744.html,"ush({ });about 60-year-old peepal tree that stood tall in the state bank of india main branch at abohar fell, due to which the boundary wall and a taxi stand shed near the complex were damaged",lives,9,4,9,0,22,"fazilka, sas nagar"
5/30/17,https://www.tribuneindia.com/news/punjab/storm-wreaks-havoc-2-dead/414744.html,hundreds of flex boards installed by political and religious activists were damaged,lives,9,4,9,0,22,"fazilka, sas nagar"
4/6/17,https://www.tribuneindia.com/news/community/heavy-rain-flattens-wheat-crop-in-sangrur/387732.html," as per its preliminary report, standing crop has suffered damage between 20 and 25 per cent at balial and retgarh villages and 10 per cent at bhattiwal village",lives,2,16,13,0,31,sangrur
4/5/17,https://www.tribuneindia.com/news/community/rain-forecast-worries-farmers/387240.html,"  at the same time, residents heaved a sigh of relief as unusual rise in temperatures during early april fell by 2-3 degrees",lives,2,16,3,0,21,"amritsar, bathinda, hoshiarpur, patiala"
3/16/17,https://www.tribuneindia.com/news/community/rain-hail-hit-crops-over-11-500-acres-in-barnala/377668.html,"parvesh sharma tribune news service sangrur, march 15  intermittent rain and hailstorm three days ago have damaged standing crops over 11,500 acres in barnala district",lives,5,49,22,3,79,"barnala, sangrur"
3/16/17,https://www.tribuneindia.com/news/community/rain-hail-hit-crops-over-11-500-acres-in-barnala/377668.html," as per the figures compiled by various teams of the agriculture department from the district, hailstorm and heavy rain have damaged standing crops over 11,500 acres out of which 10,879 acres are of wheat",lives,5,49,22,3,79,"barnala, sangrur"
3/16/17,https://www.tribuneindia.com/news/community/rain-hail-hit-crops-over-11-500-acres-in-barnala/377668.html, standing fodder over 530 acres have suffered damages between 75 to 90 per cent while the remaining acres are of various vegetables,lives,5,49,22,3,79,"barnala, sangrur"
3/16/17,https://www.tribuneindia.com/news/community/rain-hail-hit-crops-over-11-500-acres-in-barnala/377668.html," karnail singh, chief agriculture officer, barnala, said they had detected damage to standing crops over 11,500 acres during their assessment and sent the report to the senior authorities",lives,5,49,22,3,79,"barnala, sangrur"
3/10/17,https://www.tribuneindia.com/news/community/farmers-hit-as-rain-flattens-wheat-crop/375260.html,"‚Äúif there is no fresh rainfall in the next two days and wind speed too remains normal, then there will be no affect on the yield,‚Äù added beant singh",lives,0,68,21,1,90,"bathinda, faridkot, moga, sri muktsar sahib"
3/10/17,https://www.tribuneindia.com/news/community/farmers-hit-as-rain-flattens-wheat-crop/375260.html," the meteorological department has forecast high possibility of rain and thundershowers accompanied by high-velocity winds in the next two days in this area, raising fears of damage to wheat and mustard crops",lives,0,68,21,1,90,"bathinda, faridkot, moga, sri muktsar sahib"
8/29/16,https://www.tribuneindia.com/news/community/jakhar-calls-for-relief-measures/287087.html,"abohar, august 28  as rain trigerred a canal breach and damaged houses in abohar, congress state vice-president and local mla sunil jakhar slammed the bjp-ruled municipal council for not gearing up to meet the foreseen challenges of the heavy rainfall",lives,6,2,17,0,25,punjab
8/29/16,https://www.tribuneindia.com/news/community/jakhar-calls-for-relief-measures/287087.html,  jakhar said rs 1.52 crore was released in april for abohar subdivision to compensate people who had submitted claims against damage to their houses due to heavy rain last year but the eligible families were still waiting for the same,lives,6,2,17,0,25,punjab
8/29/16,https://www.tribuneindia.com/news/community/jakhar-calls-for-relief-measures/287087.html,  the mla spoke to deputy commissioner isha kalia over phone and sought relief measures,lives,6,2,17,0,25,punjab
7/2/16,https://www.tribuneindia.com/news/community/heavy-rain-in-punjab-haryana-brings-relief-from-sultry-weather/260152.html,"  chandigarh, july 2  heavy rains lashed parts of punjab and haryana, giving relief to people reeling under sultry conditions",lives,2,3,4,0,9,"amritsar, ludhiana, patiala"
6/10/16,https://www.tribuneindia.com/news/community/two-killed-as-tree-falls-on-tent-in-hp/249267.html, rajesh is survived by his wife and a two-year-old daughter,lives,14,7,2,1,24,jalandhar
6/10/16,https://www.tribuneindia.com/news/community/two-killed-as-tree-falls-on-tent-in-hp/249267.html,ush({ });  relief of rs4.5 lakh has been given to the families of the deceased by the shimla dc and the cost of the treatment of the injured would be borne by the government,lives,14,7,2,1,24,jalandhar
3/15/16,https://www.tribuneindia.com/news/community/bku-for-special-girdawari/209169.html," sukhdev singh kokri, general secretary of the farmers' union, said the government must also give minimum compensation of rs 40,000 per acre for heavy crop loss (75 to 100 per cent) to the affected farmers",lives,2,23,9,1,35,moga
3/15/16,https://www.tribuneindia.com/news/community/central-govt-seeks-report-from-hailstorm-hit-states/209168.html,"new delhi, march 14  the central government today sought reports from states on crops damaged due to heavy rain and hailstorm in parts of northern india, hours after congress vice-president rahul gandhi demanded compensation for the affected farmers",lives,1,24,15,2,42,punjab
3/15/16,https://www.tribuneindia.com/news/community/central-govt-seeks-report-from-hailstorm-hit-states/209168.html, singh said the affected states had said it would take them three to four days to make an assessment,lives,1,24,15,2,42,punjab
9/23/15,https://www.tribuneindia.com/news/punjab/as-harvesting-time-nears-it-s-raining-trouble-for-farmers/136620.html,"perneet singh tribune news service amritsar, september 22  with a heavy spell of shower lashing the region throughout the day, the woes of the farming community are set to multiply as their standing basmati and paddy crop, which is ready for harvesting, may get severely damaged",lives,4,68,16,1,89,"amritsar, tarn taran"
9/23/15,https://www.tribuneindia.com/news/punjab/rain-storm-leave-10-hurt-in-moga/136603.html,major singh sarpanch of bhoenpur village said over 80 per cent of the paddy crop had been damaged in his village,lives,5,13,35,1,54,moga
9/23/15,https://www.tribuneindia.com/news/punjab/rain-storm-leave-10-hurt-in-moga/136603.html,hundreds of tarpaulins were also dispatched to the affected villages.,lives,5,13,35,1,54,moga
8/18/15,https://www.tribuneindia.com/news/community/crops-on-2-000-acres-damaged/120993.html,"crops on 2,000 acres damaged",lives,4,56,22,1,83,punjab
8/18/15,https://www.tribuneindia.com/news/community/crops-on-2-000-acres-damaged/120993.html,"arun sharma tribune news service ropar, august 17  an old breach in lodhipur bundh has cost the farmers in this area dear",lives,4,56,22,1,83,punjab
8/18/15,https://www.tribuneindia.com/news/community/crops-on-2-000-acres-damaged/120993.html,"the sutlej water which has been rising since july 17 has destroyed standing crops on more than 2,000 acres in the area",lives,4,56,22,1,83,punjab
8/18/15,https://www.tribuneindia.com/news/community/crops-on-2-000-acres-damaged/120993.html," a survey by the agriculture department revealed that paddy, maize, fodder and poplar plantation in 1,990 acres in villages of anandpur sahib block were completely destroyed after remaining inundated for more than a month",lives,4,56,22,1,83,punjab
8/18/15,https://www.tribuneindia.com/news/community/crops-on-2-000-acres-damaged/120993.html,ush({ });  paddy crop over 637 acres and maize over 917 acres was damaged completely,lives,4,56,22,1,83,punjab
8/18/15,https://www.tribuneindia.com/news/community/crops-on-2-000-acres-damaged/120993.html,fodder on 375 acres and poplar plantation on 61 acres also suffered 100 per cent loss in these villages,lives,4,56,22,1,83,punjab
8/18/15,https://www.tribuneindia.com/news/community/crops-on-2-000-acres-damaged/120993.html,anandpur sahib sdm amarjit bains claimed the sutlej water affected crops on 180 acres,lives,4,56,22,1,83,punjab
8/17/15,https://www.tribuneindia.com/news/punjab/bhakra-floodgates-to-be-re-opened/120192.html," this relief was short-lived as the inflow started increasing with 64,000 cusec around 6 am and reaching 83,000 cusec in the afternoon",lives,1,15,10,0,26,"amritsar, jalandhar"
8/17/15,https://www.tribuneindia.com/news/punjab/bhakra-floodgates-to-be-re-opened/120192.html,"the breach took place around 11 am and within minutes, its size increased to about 250 ft, unleashing heavy damage spl girdawari sought  amritsar: punjab congress general secretary harminder singh gill has demanded that the state government should order special girdawari to assess the loss of crops on 10,000 acres downstream of the confluence of the beas and satluj in hathar area",lives,1,15,10,0,26,"amritsar, jalandhar"
8/9/15,https://www.tribuneindia.com/news/community/pong-dam-floodgates-to-be-opened-today/117532.html," up to 50,000 cusec water can be released from the dam, which might affect areas in himachal pradesh and punjab",lives,0,1,2,0,3,"amritsar, faridkot, fatehgarh sahib, gurdaspur, hoshiarpur, jalandhar, kapurthala, ludhiana, mansa, moga, pathankot, sbs nagar, sri muktsar sahib, tarn taran"
7/27/15,https://www.tribuneindia.com/news/community/1-dies-3-injured-in-mishaps-due-to-rain/111819.html,"neighbours rushed for help, removed debris and rescued our three children who were sleeping,‚Äù he said",lives,8,1,7,0,16,sas nagar
6/28/15,https://www.tribuneindia.com/news/punjab/hundreds-of-hemkund-sahib-pilgrims-evacuated/99493.html,hundreds of hemkund sahib pilgrims evacuated,lives,17,10,13,0,40,"amritsar, sas nagar"
6/28/15,https://www.tribuneindia.com/news/punjab/hundreds-of-hemkund-sahib-pilgrims-evacuated/99493.html,"sarbjit dhaliwal tribune news service chandigarh, june 27  about 1,200 pilgrims stranded at gurdwara gobind dham were evacuated by the civil administration and the army today",lives,17,10,13,0,40,"amritsar, sas nagar"
6/28/15,https://www.tribuneindia.com/news/punjab/hundreds-of-hemkund-sahib-pilgrims-evacuated/99493.html, pilgrims were stranded as bridges on various rivers were washed away due to heavy rain that lashed the area between june 24 and june 26,lives,17,10,13,0,40,"amritsar, sas nagar"
6/28/15,https://www.tribuneindia.com/news/punjab/hundreds-of-hemkund-sahib-pilgrims-evacuated/99493.html," hundreds of pilgrims were still stranded at gobind dham, but they were safe and there was nothing to worry about them, sources said",lives,17,10,13,0,40,"amritsar, sas nagar"
6/28/15,https://www.tribuneindia.com/news/punjab/hundreds-of-hemkund-sahib-pilgrims-evacuated/99493.html," when contacted on phone, sewa singh said by making a temporary bridge on a river near bhandra village, the army evacuated about 1,000 pilgrims from gurdwara gobind dham",lives,17,10,13,0,40,"amritsar, sas nagar"
6/14/15,https://www.tribuneindia.com/news/community/victims-blame-govt-say-tragedy-was-avoidable/93599.html," weather to the rescue  despite five persons losing their lives and around 190 affected by ammonia gas leak, the local residents were seen thanking the weather gods for coming to their rescue",lives,13,0,2,0,15,ludhiana
5/25/15,https://www.tribuneindia.com/news/punjab/to-stem-rot-wheat-being-refilled-into-new-gunny-bags-in-bathinda/84960.html," purchased and provided by the state government, each gunny bag costs about rs 22",lives,0,29,8,1,38,bathinda
3/31/15,https://www.tribuneindia.com/news/community/farmers-seek-crop-loan-waiver/60801.html,"our correspondentabohar, march 30as hailstorm preceded by heavy rain lashed hanumangarh district last night for about 15 minutes, hundreds of farmers on monday organised protest and demanded that loans be waived off besides providing other relief measures",lives,0,30,8,3,41,punjab
3/31/15,https://www.tribuneindia.com/news/community/farmers-seek-crop-loan-waiver/60801.html,"the memorandum said different companies had collected rs 300 crore as premium under the state-supported crop insurance scheme, but not even a rupee was paid as claim money to the affected farmers",lives,0,30,8,3,41,punjab
3/31/15,https://www.tribuneindia.com/news/community/farmers-seek-crop-loan-waiver/60801.html,"the farmers resented that no efforts were made to tackle waterlogging menace and demanded rs 20,000 as compensation for each bigha of the affected land",lives,0,30,8,3,41,punjab
3/17/15,https://www.tribuneindia.com/news/community/6-killed-in-abohar-sriganganagar/54631.html," thick carpet of hail covered the sriganganagar-srikaranpur road near mirzewala where at least 70 per cent of the wheat and mustard crop has been damaged, lal chand, sarpanch, told kailash chander sharma, sub divisional magistrate, who conducted a survey in the area today",lives,9,12,11,0,32,sas nagar
3/5/15,https://www.tribuneindia.com/news/community/rain-hit-villagers-protest-govt-apathy-in-abohar/49732.html," gram sudhar samiti president ravinder kumar said earlier three ponds on panchayat land helped in draining out rainwater, but these were now encroached upon.",lives,9,1,4,0,14,punjab
3/4/15,https://www.tribuneindia.com/news/community/woman-dies-in-roof-collapse/49459.html,"none of the officials has visited the affected area where wheat, green fodder and vegetable crops were submerged",lives,5,23,16,0,44,sas nagar
3/2/15,https://www.tribuneindia.com/news/punjab/rain-high-speed-winds-damage-crops-in-malwa/48704.html,"kulwinder sandhu tribune news service moga, march 1  it is feared that widespread rain accompanied by high-velocity winds may have caused damage to the wheat crop in parts of moga, ferozepur, fazilka, faridkot, muktsar and barnala districts in the malwa belt",lives,0,33,21,0,54,"barnala, faridkot, fazilka, ferozepur, moga, sri muktsar sahib"
3/2/15,https://www.tribuneindia.com/news/punjab/rain-high-speed-winds-damage-crops-in-malwa/48704.html," two weeks ago, a hailstorm had caused damage to the wheat crop",lives,0,33,21,0,54,"barnala, faridkot, fazilka, ferozepur, moga, sri muktsar sahib"
12/14/14,https://www.tribuneindia.com/news/community/heavy-rain-lashes-chandigarh-parts-of-punjab-haryana/18047.html,"chandigarh, december 14   ending the prolonged dry spell, many parts of punjab and haryana received moderate to heavy rainfall for the second day today, which is likely to bring relief to the farmers",lives,1,8,3,0,12,"amritsar, jalandhar, ludhiana, patiala, sas nagar"
8/1/10,https://www.dainiktribuneonline.com/2010/08/‡§¨‡§æ‡§∞‡§ø‡§∂-‡§∏‡•á-‡§Æ‡§ï‡§æ‡§®-‡§ï‡•Ä-‡§õ‡§§-‡§ó‡§ø‡§∞‡•Ä-‡§∏‡§≠/,hoshiarpur july 31 the roof of the house of a poor family collapsed due to heavy rains in nisak village sakrooli last night but the house has been damaged,lives,3,2,17,0,22,hoshiarpur
8/1/10,https://www.dainiktribuneonline.com/2010/08/%e0%a4%9d%e0%a4%ae%e0%a4%be%e0%a4%9d%e0%a4%ae-%e0%a4%ac%e0%a4%b0%e0%a4%b8%e0%a4%be%e0%a4%a4-%e0%a4%b8%e0%a5%87-%e0%a4%9c%e0%a4%a8%e0%a4%9c%e0%a5%80%e0%a4%b5%e0%a4%a8-%e0%a4%b9%e0%a5%81%e0%a4%86/,he temperature has also come down due to this not only this people got relief from the humidity due to rain for many days some 27 mm rainfall was recorded in leichandigarh today,lives,5,0,3,0,8,punjab
8/23/10,https://www.dainiktribuneonline.com/2010/08/‡§ò‡§ó‡•ç‡§ó‡§∞-‡§Æ‡•á‡§Ç-‡§ú‡§≤-‡§∏‡•ç‡§§‡§∞-‡§¨‡§¢‡§©‡•á-‡§∏‡•á-‡§ï/,t has increased because once he has suffered the floods last month and his expenditure of thousands of rupees has come to restore the paddy crop,lives,2,9,4,2,17,sangrur
9/25/10,https://www.dainiktribuneonline.com/2010/09/%e0%a4%ac%e0%a4%be%e0%a4%a2%e0%a4%bc-%e0%a4%aa%e0%a5%8d%e0%a4%b0%e0%a4%ad%e0%a4%be%e0%a4%b5%e0%a4%bf%e0%a4%a4-%e0%a4%95%e0%a4%bf%e0%a4%b8%e0%a4%be%e0%a4%a8%e0%a5%8b%e0%a4%82-%e0%a4%95%e0%a5%8b-27/,budhlada 24 september s village of floodaffected tehsil sardulgarh bhagwanpur higan ranjitgarh bandran mirpur kala mirpur khurd sardulewala kahanadar lohgarh roorkee ahluwalia heerke chaus mandi sadhu wala sardulgarh baran jhanda khurd tibi hari singh fatehpur and machhohar alias modhunh gorla village budha and tehsils,lives,0,5,6,3,14,punjab
8/21/11,https://www.dainiktribuneonline.com/2011/08/40-%e0%a4%b9%e0%a4%9c%e0%a4%be%e0%a4%b0-%e0%a4%8f%e0%a4%95%e0%a4%a1%e0%a4%bc-%e0%a4%ad%e0%a5%82%e0%a4%ae%e0%a4%bf-%e0%a4%ac%e0%a4%be%e0%a4%a2%e0%a4%bc-%e0%a4%95%e0%a5%80-%e0%a4%9a%e0%a4%aa%e0%a5%87/,ue to the continuous rains flooding the darya beas the manger has disturbed the condition of the farmers and floods in the district have damaged 40 thousand acres of crops with water running up to 8 feet and fresh water level in darya beas from the fresh water level,lives,6,34,28,0,68,"kapurthala, tarn taran"
8/21/11,https://www.dainiktribuneonline.com/2011/08/40-%e0%a4%b9%e0%a4%9c%e0%a4%be%e0%a4%b0-%e0%a4%8f%e0%a4%95%e0%a4%a1%e0%a4%bc-%e0%a4%ad%e0%a5%82%e0%a4%ae%e0%a4%bf-%e0%a4%ac%e0%a4%be%e0%a4%a2%e0%a4%bc-%e0%a4%95%e0%a5%80-%e0%a4%9a%e0%a4%aa%e0%a5%87/,he land has been in the grip of beas boom; the same crop has been damaged in 15 thousand acres in dozens of villages of begowalanadaladhilwa hyderia beas rapid rise in water level is alarming and indicates continuous release of water from pong dam,lives,6,34,28,0,68,"kapurthala, tarn taran"
8/21/11,https://www.dainiktribuneonline.com/2011/08/40-%e0%a4%b9%e0%a4%9c%e0%a4%be%e0%a4%b0-%e0%a4%8f%e0%a4%95%e0%a4%a1%e0%a4%bc-%e0%a4%ad%e0%a5%82%e0%a4%ae%e0%a4%bf-%e0%a4%ac%e0%a4%be%e0%a4%a2%e0%a4%bc-%e0%a4%95%e0%a5%80-%e0%a4%9a%e0%a4%aa%e0%a5%87/,he main reason for the flooding of the dariya bayas is that 25 thousand acres of crop area has been destroyed within the sultanpur lodhi mand dhussi dam in flood water since four days,lives,6,34,28,0,68,"kapurthala, tarn taran"
8/21/11,https://www.dainiktribuneonline.com/2011/08/40-%e0%a4%b9%e0%a4%9c%e0%a4%be%e0%a4%b0-%e0%a4%8f%e0%a4%95%e0%a4%a1%e0%a4%bc-%e0%a4%ad%e0%a5%82%e0%a4%ae%e0%a4%bf-%e0%a4%ac%e0%a4%be%e0%a4%a2%e0%a4%bc-%e0%a4%95%e0%a5%80-%e0%a4%9a%e0%a4%aa%e0%a5%87/,the crop of submerged paddy has been destroyed village chuldha sarpanch buta singh sukhwinder singh chitrapur daljit singh sarpanch channa sher singh said that the crops within dam no 2 which was tied in the year 2000 have taken water tomb,lives,6,34,28,0,68,"kapurthala, tarn taran"
8/21/11,https://www.dainiktribuneonline.com/2011/08/40-%e0%a4%b9%e0%a4%9c%e0%a4%be%e0%a4%b0-%e0%a4%8f%e0%a4%95%e0%a4%a1%e0%a4%bc-%e0%a4%ad%e0%a5%82%e0%a4%ae%e0%a4%bf-%e0%a4%ac%e0%a4%be%e0%a4%a2%e0%a4%bc-%e0%a4%95%e0%a5%80-%e0%a4%9a%e0%a4%aa%e0%a5%87/,aali kalan sarpanch kashmir singh ahli khurd sarpanch harbans singh etc says that the flood has damaged the crop of 25 thousand acres of land in dozens of villages; sarpanch salwinder singhsarpanch of village mandpur baupur kuldeep simhanambardar surinder of sangra village singh etc told that the water level of darya beas is constantly increasing and the clouds of danger are hovering over his head.,lives,6,34,28,0,68,"kapurthala, tarn taran"
8/24/11,https://www.dainiktribuneonline.com/2011/08/%e0%a4%b8%e0%a4%a4%e0%a4%b2%e0%a5%81%e0%a4%9c-%e0%a4%a4%e0%a4%a5%e0%a4%be-%e0%a4%ac%e0%a5%8d%e0%a4%af%e0%a4%be%e0%a4%b8-%e0%a4%a8%e0%a5%87-%e0%a4%a4%e0%a4%ac%e0%a4%be%e0%a4%b9%e0%a5%80-%e0%a4%ae/,n the state of satjul and beas in hundreds of villages has penetrated and the paddy crop has been destroyed in thousands of acres due to cracks in dhusi bandh a chaud of chak patti balu bahadur village of sultanpur lodhi,lives,4,7,6,0,17,sas nagar
8/24/11,https://www.dainiktribuneonline.com/2011/08/%e0%a4%b8%e0%a4%a4%e0%a4%b2%e0%a5%81%e0%a4%9c-%e0%a4%a4%e0%a4%a5%e0%a4%be-%e0%a4%ac%e0%a5%8d%e0%a4%af%e0%a4%be%e0%a4%b8-%e0%a4%a8%e0%a5%87-%e0%a4%a4%e0%a4%ac%e0%a4%be%e0%a4%b9%e0%a5%80-%e0%a4%ae/,he manalileh road was blocked due to landslides on rohtang pass hundreds of tourists and local people are stranded near rahni nala border road,lives,4,7,6,0,17,sas nagar
8/4/13,https://www.dainiktribuneonline.com/2013/08/%e0%a4%ac%e0%a4%be%e0%a4%a2%e0%a4%bc-%e0%a4%b8%e0%a5%87-%e0%a4%ae%e0%a4%82%e0%a4%a1-%e0%a4%95%e0%a5%8d%e0%a4%b7%e0%a5%87%e0%a4%a4%e0%a5%8d%e0%a4%b0-%e0%a4%95%e0%a5%87-19-%e0%a4%97%e0%a4%be%e0%a4%82/,he told that crops of about 19 villages in the tapunuma region have been destroyed by submergence village residence related to bhim kadim bandhu kadim mand bandhu kadim akalpur kishanpur ghadka mand karamuwal sille etc,lives,4,15,19,0,38,"ferozepur, jalandhar, kapurthala"
8/12/13,https://www.dainiktribuneonline.com/2013/08/%e0%a4%ac%e0%a4%be%e0%a4%a2%e0%a4%bc-%e0%a4%b8%e0%a5%87-22-%e0%a4%97%e0%a4%be%e0%a4%82%e0%a4%b5%e0%a5%8b%e0%a4%82-%e0%a4%ae%e0%a5%87%e0%a4%82-%e0%a4%ae%e0%a4%9a%e0%a5%80-%e0%a4%a4%e0%a4%ac%e0%a4%be/,he crop of thousands of acres of land in 22 villages has been destroyed due to flooding and rising water level poses a huge threat to the advance,lives,9,30,20,1,60,kapurthala
8/12/13,https://www.dainiktribuneonline.com/2013/08/%e0%a4%ac%e0%a4%be%e0%a4%a2%e0%a4%bc-%e0%a4%b8%e0%a5%87-22-%e0%a4%97%e0%a4%be%e0%a4%82%e0%a4%b5%e0%a5%8b%e0%a4%82-%e0%a4%ae%e0%a5%87%e0%a4%82-%e0%a4%ae%e0%a4%9a%e0%a5%80-%e0%a4%a4%e0%a4%ac%e0%a4%be/,t is being demanded that the government should take appropriate steps to protect the dam and the affected areas should be provided with 30 boats tarpaul along with food and animal feed and the farmers should be given compensation,lives,9,30,20,1,60,kapurthala
8/6/13,https://www.dainiktribuneonline.com/2013/08/‡§µ‡§∞‡•ç‡§∑‡§æ-‡§∏‡•á-‡§≤‡•Å‡§ß‡§ø‡§Ø‡§æ‡§®‡§æ-‡§Æ‡•á‡§Ç-‡§¨‡§æ‡§¢/,ut even after the engine was flooded about one hundred cars twowheelers were damaged there,lives,6,1,3,0,10,ludhiana
8/13/13,https://www.dainiktribuneonline.com/2013/08/%e0%a4%95%e0%a4%be%e0%a4%b2%e0%a5%80-%e0%a4%ac%e0%a5%87%e0%a4%88%e0%a4%82-%e0%a4%95%e0%a5%80-%e0%a4%ac%e0%a4%be%e0%a4%a2%e0%a4%bc-%e0%a4%b8%e0%a5%87-%e0%a4%aa%e0%a4%be%e0%a4%a8%e0%a5%80-%e0%a4%ae/,flood affected house of sultanpur lodhi manjar kapurthala 13 august floods in nis dariya beas caused havoc on dozens of villages including village rampur gora in mand area and now started moving towards sultanpur lodhi town in the ravaged in hyderabad,lives,9,0,7,0,16,kapurthala
8/16/17,https://www.dainiktribuneonline.com/2017/08/‡§¨‡§æ‡§¢‡§º-‡§ï‡•Ä-‡§ö‡§™‡•á‡§ü-‡§Æ‡•á‡§Ç-9-‡§∞‡§æ‡§ú‡•ç‡§Ø-100-‡§ï‡•Ä/,women cooking in the open in the floodravaged morigaon of assam  9 states are in the grip of floods due to heavy rains and water released from nepal;100 people are also reported to be killed in bihar and eastern up ndrf is bad on wednesday.4 additional teams airlift from bathinda punjab to patna bihar assam up west bengal himachal pradesh arunach 113 teams of ndrf have been deployed in disaster affected areas of the state of gujarat rajasthan and tripura rescuing,lives,5,1,2,0,8,bathinda
8/16/17,https://www.dainiktribuneonline.com/2017/08/‡§¨‡§æ‡§¢‡§º-‡§ï‡•Ä-‡§ö‡§™‡•á‡§ü-‡§Æ‡•á‡§Ç-9-‡§∞‡§æ‡§ú‡•ç‡§Ø-100-‡§ï‡•Ä/,bout 3000 people trapped in floods during the campaign and bringing 37000 people to safe places in bihar ndrf has deployed 27 teams while assam 18 and 11 teams have been deployed in uttar pradesh for relief and rescue operations,lives,5,1,2,0,8,bathinda
8/26/10,https://www.dainiktribuneonline.com/2010/08/%e0%a4%aa%e0%a4%82%e0%a4%9c%e0%a4%be%e0%a4%ac-%e0%a4%b9%e0%a4%b0%e0%a4%bf%e0%a4%af%e0%a4%be%e0%a4%a3%e0%a4%be-%e0%a4%a6%e0%a4%bf%e0%a4%b2%e0%a5%8d%e0%a4%b2%e0%a5%80-%e0%a4%95%e0%a5%87-%e0%a4%95/,70 foot crack along ludhiana sutlej threatens 75 villages; seeks army help,lives,2,3,5,0,10,"kapurthala, ludhiana"
5/27/17,https://www.amarujala.com/photo-gallery/chandigarh/flood-in-bathinda-due-to-canal-breaking?pageId=2,as many as 200 houses in sai nagar were flooded by two to three feet due to a 50foot crack in the rajwawa passing behind ganpati colony in bathinda city and several acres of farmers' bg cotton crop was destroyed.,lives,0,7,3,0,10,"bathinda, sas nagar"
8/12/13,https://www.ndtv.com/video/news/news/video-story-286470,water level of sutlej river in fazilka punjab is continuously increasing due to which water has started filling in the villages along the river and about 1200 acres of crop was destroyed is.,lives,0,4,5,0,9,fazilka
8/18/08,https://www.ndtv.com/video/news/news/14-perish-as-flood-wreaks-havoc-in-punjab-36255,jalandhar ferozepur moga bhatinda sangroor and ropar have been the worst affected where more than 200 villages have been evacuated so far.,lives,3,1,4,0,8,"ferozepur, jalandhar, moga"
8/22/13,https://timesofindia.indiatimes.com/city/chandigarh/Satluj-continues-to-flood-villages-in-Ferozepur-Fazilka/articleshow/21969055.cms,with water levels in the river increasing the flood waters reached our village and completely damaged our fields said shinder singh a resident of tendiwala village near the indopak border,lives,14,32,52,1,99,"fazilka, ferozepur"
8/22/13,https://timesofindia.indiatimes.com/city/chandigarh/Satluj-continues-to-flood-villages-in-Ferozepur-Fazilka/articleshow/21969055.cms,standing crop in thousands of acres of land has been destroyed we request the administration to offer whatever compensation they can to people whose houses have collapsed said shinder singh,lives,14,32,52,1,99,"fazilka, ferozepur"
8/22/13,https://timesofindia.indiatimes.com/city/chandigarh/Satluj-continues-to-flood-villages-in-Ferozepur-Fazilka/articleshow/21969055.cms,in ferozepur over 50000 acres of farm area has been submerged affecting around 50 villages affected villages like nihale lavera muthianwala jhuge nihangwali gatti rajjoke tindiwala bhakhra gatti kharunj sunder bhatti kaluwala palla megha bandala ruknewala kamalewala behak ratto ke and talli gulam have become cut off from rest of the district sources said,lives,14,32,52,1,99,"fazilka, ferozepur"
8/22/13,https://timesofindia.indiatimes.com/city/chandigarh/Satluj-continues-to-flood-villages-in-Ferozepur-Fazilka/articleshow/21969055.cms,in fazilka district over 15 villages and 20000 acres of land have been affected by floods the villages included maujam dona nanka ghurka and haskalan while mohar jamsher has been completely cut off from the main land several schools in these districts have also been closed due to the floods they said,lives,14,32,52,1,99,"fazilka, ferozepur"
8/22/13,https://timesofindia.indiatimes.com/city/chandigarh/Satluj-continues-to-flood-villages-in-Ferozepur-Fazilka/articleshow/21969055.cms,the district administration in ferozepur has called national disaster response force ndrf to launch flood relief operations on tuesday who have reportedly shifted nearly 300 people from flood affected areas to relief camps,lives,14,32,52,1,99,"fazilka, ferozepur"
8/22/13,https://timesofindia.indiatimes.com/city/chandigarh/Satluj-continues-to-flood-villages-in-Ferozepur-Fazilka/articleshow/21969055.cms,officials claimed to have arranged 20 boats to provide relief material including fodder for cattle medicines food and other articles to affected people,lives,14,32,52,1,99,"fazilka, ferozepur"
7/14/10,https://www.hindustantimes.com/chandigarh/rescue-work-on-in-flood-hit-mansa/story-m0YJTUQlvf57lbvPDH2hLP.html,Around 200 houses and standing crops on nearly 5000 acres have been damaged in the floods We have made all arrangements to provide packed food and water to the flood victims So far there has been no loss of life due to floods in Mansa he said,lives,5,20,21,0,46,mansa
7/14/10,https://www.hindustantimes.com/chandigarh/rescue-work-on-in-flood-hit-mansa/story-m0YJTUQlvf57lbvPDH2hLP.html,According to official figures crops on 271784 acres have been damaged in districts of Patiala Sangrur Mohali Ludhiana Fatehgarh Sahib Moga and Mansa,lives,5,20,21,0,46,mansa
7/14/10,https://www.hindustantimes.com/chandigarh/rescue-work-on-in-flood-hit-mansa/story-m0YJTUQlvf57lbvPDH2hLP.html,Army officials are working to plug the breaches in Ghaggar river that led to flooding in Sirsa Over 10000 acres of agricultural land submerged in three to four feet water and nearly one dozen villages are affected due to this We hope that situation will be under control by this evening said a senior official of the Sirsa administration here,lives,5,20,21,0,46,mansa
7/14/10,https://www.hindustantimes.com/chandigarh/rescue-work-on-in-flood-hit-mansa/story-m0YJTUQlvf57lbvPDH2hLP.html,As many as 33 people have lost their lives in floods in Punjab and Haryana.,lives,5,20,21,0,46,mansa
9/25/18, https://www.hindustantimes.com/punjab/flood-threat-looms-in-patiala-as-ghaggar-in-spate/story-YD1VnN3c8eKDBf6IET3zDM.html,he added he said that district epidemiologist dr gurmeet singh has been appointed as the nodal officer of the district control room farmers worried  the incessant showers in the past three days pose threat of excessive damage to the paddy crop which is largely in the last stage of maturation many reports of crop being submerged in kneedeep water and flattening of fields are pouring in from across district ,lives,17,25,25,0,67,"patiala, sangrur"
9/25/18, https://www.hindustantimes.com/punjab/flood-threat-looms-in-patiala-as-ghaggar-in-spate/story-YD1VnN3c8eKDBf6IET3zDM.html,a municipality official pleading anonymity said that there was a big drain  from model colony to ghulad mandi colony‚Äî responsible for disposing off half of the city‚Äôs rainwater but over 70% of it is encroached due to which it is impossible to clean it similar is the situation of a nullah passing through hathi khana colony and dulladdi gate waterlogging issue can be solved after at least 50% of the drain is evacuated he added ,lives,17,25,25,0,67,"patiala, sangrur"
7/16/10,https://www.hindustantimes.com/india/central-team-to-visit-flood-hit-punjab-on-july-20/story-sLAIRBOObnLfrT0KEOJrgJ.html,a central team will visit the three districts of punjab on july 20 for two days to assess the damage caused by the floods ,lives,3,9,9,0,21,"bathinda, patiala, sangrur"
7/16/10,https://www.hindustantimes.com/india/central-team-to-visit-flood-hit-punjab-on-july-20/story-sLAIRBOObnLfrT0KEOJrgJ.html,e issued instructions to provide relief to every affected farmer and family within 7 days and asked deputy commissioners to personally monitor relief disbursement ,lives,3,9,9,0,21,"bathinda, patiala, sangrur"
7/29/10,https://www.hindustantimes.com/india/punjab-to-allow-amendments-in-crop-damage-relief-norms/story-WKT3L4Nu2xsMXFnT33qzAJ.html,ccording to the amended instructions crop damage relief was rs 5000 per acre for losses exceeding 75 per cent rs 3000 per acre for losses between 5075 per cent and rs 2000 per acre for losses between 2550 per cent,lives,0,26,14,0,40,"mansa, patiala"
12/31/15,https://www.hindustantimes.com/punjab/at-last-hope-for-waterlogged-areas-of-southwest-punjab/story-wrmDIUnM6CSLhzRJs9D1GM.html,though a project cost of rs 918 crore has been approved by the cwc for the remaining three canals so far there is no allocation of funds from the central ministry,lives,0,1,0,1,2,"amritsar, bathinda, faridkot, ferozepur, gurdaspur, pathankot, sri muktsar sahib, tarn taran"
12/31/15,https://www.hindustantimes.com/punjab/at-last-hope-for-waterlogged-areas-of-southwest-punjab/story-wrmDIUnM6CSLhzRJs9D1GM.html,a rs 1375 crore project of rehabilitation modernisation and renovation of various distributaries and minors along with allied works of upper bari doab canal is under the consideration of the cwc for technical approval,lives,0,1,0,1,2,"amritsar, bathinda, faridkot, ferozepur, gurdaspur, pathankot, sri muktsar sahib, tarn taran"
10/21/19,https://reliefweb.int/node/3365543,"review of flood situation in the country by mha on the direction of hon‚Äôble home minister, minister of state (home) took a meeting on 09.08.2019 to review and take stock of the flood situation of affected state and rescue and relief operations being carried out by ndrf, army, air force, navy and icg",lives,10,10,39,0,59,punjab
10/21/19,https://reliefweb.int/node/3365543,"‚û¢ union home minister, shri amit shah undertook an aerial survey of flood affected areas of belgavi district of karnataka and sangli& kolhapur of maharashtra on 11.08.2019",lives,10,10,39,0,59,punjab
10/21/19,https://reliefweb.int/node/3365543,"review of flood situation by national crisis management committee (ncmc) review meeting of ncmc on 08.08.2019 ncmc chaired by cabinet secretary on 08.08.2019 took stock of the flood situation, preparedness, rescue and relief operations and directed that immediate assistance, as sought by the states, be provided to meet the crisis",lives,10,10,39,0,59,punjab
10/21/19,https://reliefweb.int/node/3365543,"review meeting of ncmc on 20.08.2019 ncmc meeting chaired by cabinet secretary held on 20.08.2019reviewed the prevailing flood situation in the states of himachal pradesh, punjab, uttarakhand, haryana and delhi and took stock of the flood situation, preparedness, and rescue & relief operations and directed that immediate assistance, as sought by the states, be provided to meet the crisis",lives,10,10,39,0,59,punjab
10/21/19,https://reliefweb.int/node/3365543,"review meeting of ncmc on 15.09.2019 ncmc chaired by the cabinet secretary, on 15.09.2019took stock of the flood situation, preparedness, rescue and relief operations in the state of rajasthan and madhya pradesh",lives,10,10,39,0,59,punjab
10/21/19,https://reliefweb.int/node/3365543,"accordingly, ministry of home affairs has constituted inter ministerial central teams (imcts) for thirteen states affected by flood viz",lives,10,10,39,0,59,punjab
10/18/19,https://reliefweb.int/node/3354153,"as of 25 september 2019, 338 people lost their lives in maharashtra, 223 in west bengal, 181 in kerala, 170 in madhya pradesh, 150 in gujarat, 130 in bihar, 105 in karnataka, 96 in assam, 69 in uttarakhand, 58 in rajasthan, 52 in himachal pradesh, 18 in punjab, 14 in uttar pradesh, and 10 in odisha1",lives,16,2,21,1,40,punjab
10/18/19,https://reliefweb.int/node/3354153,"an assessment made by the disaster management division of the union home ministry indicates that over 2.2 million people have been evacuated so far and 8,700 relief camps set up across these states to provide temporary shelter to the displaced population2 ",lives,16,2,21,1,40,punjab
10/18/19,https://reliefweb.int/node/3354153,"more than 4,000 people, including women and children, were rescued from the flood-affected areas of patna on monday, 30 september as per ndrf report",lives,16,2,21,1,40,punjab
10/18/19,https://reliefweb.int/node/3354153,"the force said it has deployed five teams, with about 45 personnel in each, to conduct rescue and relief works in the city",lives,16,2,21,1,40,punjab
10/18/19,https://reliefweb.int/node/3354153,"as of 30 september, the situation remains critical in bihar and uttar pradesh as compared to the other affected states5.",lives,16,2,21,1,40,punjab
9/14/19,https://reliefweb.int/node/3303423,"the overflowing of brahmaputra, barak and jia bhoreli rivers caused flooding and landslides affecting 4.6 million people in 31 districts of assam: dhemaji, lakhimpur, biswanath, barpeta, chirang, golaghat, jorhat, sonitpur, darrang, nalbari, bongaigaon, morigaon, nagaon, majuli, baksa, kokrajhar, dhubri, south salmara, goalpara, kamrup, hojai, sivsagar, tinsukia, cachar, karbi-anglong, west karbi- anglong, hailakandi, karimganj, kamrup metro, dibrugarh and udalguri",lives,31,3,15,0,49,punjab
9/14/19,https://reliefweb.int/node/3303423,"in bihar, flood waters breaching the embankment on the kamla balan river in jhanjharpur, madhubani district and darbhanga, affected 2,000,000 people in 12 districts - sheohar, sitamarhi, east champaran, madhubani, araria, kishanganj, supaul, darbhanga and muzaffarpur",lives,31,3,15,0,49,punjab
9/14/19,https://reliefweb.int/node/3303423,"as of 22 july, floods in assam and bihar have claimed over 100 lives, affecting 11 million people with at least 130,000 displaced and sheltering in more than 600 relief camps and 240 relief distribution centres set up by district administrations",lives,31,3,15,0,49,punjab
9/14/19,https://reliefweb.int/node/3303423,"by 25 july, number of displaced people in assam seeking temporary shelters at camps set up by the government further increased to 147,000",lives,31,3,15,0,49,punjab
9/14/19,https://reliefweb.int/node/3303423,"in bihar, over 1 million people have been displaced by the flood waters in 55 blocks in 9 (sheohar, sitamarhi, east champaran, madhubani, araria, kishanganj, supaul, darbhanga and muzaffarpur) out of the 12 affected districts",lives,31,3,15,0,49,punjab
9/14/19,https://reliefweb.int/node/3303423,"within the next few days (31 july), the situation in both states worsened as more than 1.2 million people were affected in assam and bihar and at least 651,000 people displaced in 1,552 relief camps",lives,31,3,15,0,49,punjab
9/14/19,https://reliefweb.int/node/3303423,"approximately, 33,800 houses were reportedly destroyed in assam, kerala and rajasthan",lives,31,3,15,0,49,punjab
9/14/19,https://reliefweb.int/node/3303423,"as of 21 august, monsoon rains and widespread flooding have affected 11 indian states (maharashtra, kerala, west bengal, bihar, gujarat, assam, karnataka, madhya pradesh, rajasthan, odisha and punjab, with at least 1,149 fatalities and over 1.8 million people displaced",lives,31,3,15,0,49,punjab
8/29/19,https://reliefweb.int/node/3279863,"situation report in india on flood/heavy rain fall (as on 29th august 2019)  situation in india more than 8869768 population affected by flood and landslide, nearly 1155 people are reported to be dead across india due to monsoon related incidents as per the latest report of the national emergency response centre, mha released on 26th august 2019",lives,10,11,25,1,47,"ferozepur, sas nagar"
8/29/19,https://reliefweb.int/node/3279863,"major districts affected are; 13 (almora, bageshwar, chamoli, champawat, dehradun, nainital, pauri, pithoragarh, rudraprayag, tehri, udham singh nagar, haridwar and uttarkashi) ",lives,10,11,25,1,47,"ferozepur, sas nagar"
8/29/19,https://reliefweb.int/node/3279863,so far evacuated 53 persons & 01 livestock and retrieved 04 dead bodies.,lives,10,11,25,1,47,"ferozepur, sas nagar"
8/20/19,https://reliefweb.int/node/3267823,the chief minister said that at least 15 people have lost their lives while 6 are still missing,lives,17,7,21,0,45,"jalandhar, ludhiana, sas nagar"
8/20/19,https://reliefweb.int/node/3267823,"apart from 28 teams of ndrf, army and air force teams are also continuously involved in relief and rescue operations",lives,17,7,21,0,45,"jalandhar, ludhiana, sas nagar"
8/20/19,https://reliefweb.int/node/3267743,"in uttarakhand, death toll in mori subdivision of uttarkashi district has risen to 12 whereas 5 people are missing",lives,18,17,17,5,57,punjab
8/20/19,https://reliefweb.int/node/3267743,"after visiting the disaster affected areas, secretary, disaster management, amit negi told media in dehradun that rainfall has caused a loss of around 100 crore rupees in the state till now",lives,18,17,17,5,57,punjab
8/20/19,https://reliefweb.int/node/3267743, rehabilitation center have been setup at parajit where the administration is providing shelter to nearly 350 villagers with medical help and food facilities ,lives,18,17,17,5,57,punjab
8/20/19,https://reliefweb.int/node/3267743,more than 800 roads are closed and hundreds of vehicles are stranded in lahaul spiti due to unexpected snowfall which triggered landslides,lives,18,17,17,5,57,punjab
8/20/19,https://reliefweb.int/node/3267743,"more than 10,000 people living in low-lying areas along the yamuna were evacuated by government agencies",lives,18,17,17,5,57,punjab
8/20/19,https://reliefweb.int/node/3267743," in punjab, chief minister captain amarinder singh announced 100 crore rupees for emergency relief for flood-hit people",lives,18,17,17,5,57,punjab
8/19/19,https://reliefweb.int/node/3263983,"according to media reports, at least 23 people have been killed in himachal pradesh, while 3 died and 22 are missing following a cloudburst in uttarakhand, 3 more reportedly died in punjab",lives,6,1,3,0,10,punjab
7/27/19,https://reliefweb.int/node/3238109,successfully evacuation of 900 persons from mahalaxmi express stranded in flood in maharashtra,lives,10,1,10,0,21,punjab
7/27/19,https://reliefweb.int/node/3238109,"‚Ä¢ on getting the information about this incident around 8.50 am, ministry of home affairs (mha) immediately deputed 02 team each of national disaster response force (ndrf) from mumbai and pune along with 09 boats and other necessary rescue equipment and ndrf teams reached the spot at about 0940 hrs",lives,10,1,10,0,21,punjab
7/27/19,https://reliefweb.int/node/3238109,two mi-17 indian air force helicopters were also pressed into service to assist in rescue operation,lives,10,1,10,0,21,punjab
7/27/19,https://reliefweb.int/node/3238109,"two columns of army along with 130 trained staff, food packages, water and rescue material were also deployed",lives,10,1,10,0,21,punjab
9/20/18,https://reliefweb.int/node/2831344,"according to the national disaster management authority (ndma), as on august 24th, 417 people have died and over 54.11 lakh people were affected,12.47 lakh of whom had to seek shelter in 5,645 relief camps",lives,7,0,10,1,18,punjab
9/20/18,https://reliefweb.int/node/2831344,"thousands of volunteers have been engaged in the relief efforts across kerala, which include trained disaster response volunteers, junior and youth red cross members and others who are participating in rescue, packing and distribution of food items, tents and family packs containing tarpaulins, clothes, mosquito nets, hygiene kits, kitchen sets, buckets, solar lanterns etc",lives,7,0,10,1,18,punjab
9/24/18,https://reliefweb.int/node/2800734,people in any sort of difficult situation due the weather can also call on helpline number 1070,lives,13,8,6,0,27,punjab
9/24/18,https://reliefweb.int/node/2800734,himachal chief minister jai ram thakur has said that after the met department's forewarning all authorities concerned have been put on alert and advisories have been issued for rescue and relief work.2 people are reported to have been killed in heavy rains in himachal pradesh,lives,13,8,6,0,27,punjab
9/24/18,https://reliefweb.int/node/2800734,the downpour took a toll in doda district on tuesday when 5 members of a family lost their lives in a single incident,lives,13,8,6,0,27,punjab
7/26/18,https://reliefweb.int/node/2716534,"in vasundhara, more than 50 houses were evacuated after a road caved in",lives,8,3,8,0,19,sas nagar
6/21/18,https://reliefweb.int/node/2664929,"flood threat looms large over these 10 indian states  highlights at least five of these flood-affected states have been placed on high risk on two other hazards‚Äîcyclone and heat wave west bengal has the highest risk of cyclone, followed by odisha, andhra, gujarat and kerala at least 100 cyclone prone districts have been studied for the purpose new delhi: monsoon has just set in and more than 30 people have already died in floods in north east, 20 of them in assam alone with over half a million marooned",lives,8,5,12,0,25,punjab
6/21/18,https://reliefweb.int/node/2664929,at least five of these flood-affected states have been placed on high risk on two other hazards‚Äîcyclone and heat wave,lives,8,5,12,0,25,punjab
6/21/18,https://reliefweb.int/node/2664929,"in 2015 and 2016, more than 1,100 people reported killed in disasters and over 350 million affected across the country",lives,8,5,12,0,25,punjab
6/21/18,https://reliefweb.int/node/2664929,the damages to properties in these two years alone have been estimated at over $4.4 billion,lives,8,5,12,0,25,punjab
6/21/18,https://reliefweb.int/node/2664929,"a report from the un office for disaster risk reduction (unisdr) had earlier said that between 2005 and 2014, at least 167 disasters struck india causing damages of more than $47 billion in properties, ranking the nation among the top four countries in the world with highest number of reported disasters",lives,8,5,12,0,25,punjab
6/15/18,https://reliefweb.int/node/2656989,"in assam, thousands of people have been affected due to heavy rains in the past 48 hours, rains have also disrupted train services due to landslides",lives,9,12,11,0,32,punjab
6/15/18,https://reliefweb.int/node/2656989,"in tripura, the flood situation deteriorated with the rain-fed khowai river inundating fresh areas rendering thousands homeless and damaging roads and crops",lives,9,12,11,0,32,punjab
6/15/18,https://reliefweb.int/node/2656989,"with thousands of houses damaged, several thousand people have been moved out of the area and provided shelter at relief camps",lives,9,12,11,0,32,punjab
6/12/18,https://reliefweb.int/node/2650389,"over 1,000 people were evacuated to safer places in the two districts due to the flood",lives,8,3,2,0,13,"amritsar, patiala, sas nagar"
8/31/17,https://reliefweb.int/node/2223984,"highlights of situation report given by seocs as per situation report received from seocs, during last 24 hours due to heavy rainfall the following damages have been reported: i",lives,0,8,14,0,22,punjab
8/31/17,https://reliefweb.int/node/2223984," assam: district affected 05, human lives lost-nil ii",lives,0,8,14,0,22,punjab
8/31/17,https://reliefweb.int/node/2223984," west bengal: district affected 01, human lives lost 01",lives,0,8,14,0,22,punjab
8/31/17,https://reliefweb.int/node/2223984," uttar pradesh: district affected 13, human lives lost 04",lives,0,8,14,0,22,punjab
8/31/17,https://reliefweb.int/node/2223984," bihar:  district affected 19, human lives lost-nil",lives,0,8,14,0,22,punjab
8/30/17,https://reliefweb.int/node/2223979,"highlights of situation report given by seocs as per situation report received from seocs, during last 24 hours due to heavy rainfall the following damages have been reported: i",lives,0,8,14,0,22,punjab
8/30/17,https://reliefweb.int/node/2223979," assam: district affected 05, human lives lost-nil ii",lives,0,8,14,0,22,punjab
8/30/17,https://reliefweb.int/node/2223979," west bengal: district affected 04, human lives lost 05",lives,0,8,14,0,22,punjab
8/30/17,https://reliefweb.int/node/2223979," uttar pradesh: district affected 10, human lives lost 01",lives,0,8,14,0,22,punjab
8/30/17,https://reliefweb.int/node/2223979," bihar:  district affected 19, human lives lost-nil",lives,0,8,14,0,22,punjab
8/30/17,https://reliefweb.int/node/2223979," maharashtra: district affected 04, human lives lost-07",lives,0,8,14,0,22,punjab
8/7/17,https://reliefweb.int/node/2159444,"achievement during flood -2017 season are as under: assam :      so far ndrf teams rescued 82 persons ,evacuated 532 persons, retrieved 5 dead bodies and provide medical  assistance to 30 persons",lives,51,6,13,0,70,mansa
8/7/17,https://reliefweb.int/node/2159444,rajasthan: during last 24 hour ndrf on 06.08.2017 team conducted rescue ops at distt- jalore rajasthan and evacuated 28 personand distributed 900 food packet,lives,51,6,13,0,70,mansa
8/7/17,https://reliefweb.int/node/2159444,"so far teams have rescued 122 persons, evacuated 847 persons, 13 live stocks and retrieved 03 dead bodies and also distributed food-  7810pkts and medicines",lives,51,6,13,0,70,mansa
8/7/17,https://reliefweb.int/node/2159444,"gujarat:  so far teams have rescued 1355 persons, evacuated 7286 persons, 27 livestock and retrieved 11 dead bodies and distributed food- 71193 pkts, water pouches/ bottles-  81150 nos, dry ration ( rice, dal, suger, churaetc -1750 bags,biscuits / namkin- 2225 pkts,  cloth- 1750 nos and blanket- 75 nos",lives,51,6,13,0,70,mansa
8/7/17,https://reliefweb.int/node/2159444,"wb:  during last 24 hour ndrf on 06.08.2017 team conducted rescue and relief operation at ghatal, west medenipur, wb and evacuated 03 persons and distributed relief material water pouches- 2200nos, dry ration- 16  bags, milk powder 6 kgs, and gur60kgs",lives,51,6,13,0,70,mansa
8/7/17,https://reliefweb.int/node/2159444,"so far teams have rescued 253 persons, evacuated 1029 persons and retrieved 05 dead bodies and distributed food 1500 pkts, water pouches/ bottles-  25564 nos, dry ration ( rice, dal, suger, churaetc ‚Äì 236 bags, baby food - 244 ctns, milk- 1056 pkts, gur -2205  kgs, tarpoline-  58 nos,  vegetable- 540 kgs and medicines",lives,51,6,13,0,70,mansa
8/7/17,https://reliefweb.int/node/2159444,uttar pradesh: on 06.08.2017 teams evacuated 395 flood affected persons and distributed 800 food pkt,lives,51,6,13,0,70,mansa
8/7/17,https://reliefweb.int/node/2159444, so far teams have  evacuated 603 persons and distributed 800 food  packets .,lives,51,6,13,0,70,mansa
7/27/17,https://reliefweb.int/node/2143594,"as per the information of damage received from these states 508 persons have lost their lives, 24,811 cattle heads have perished, 63,215 houses/ huts have been damaged and about 2.8 lakh hectares of crop area have been reported affected due to heavy rains/ flood/ landslides etc",lives,11,22,44,1,78,punjab
7/27/17,https://reliefweb.int/node/2143594,"assam has faced two waves of floods till 19th july 2017 affecting 29 districts out of 33 districts, resulting in loss of human lives, livestock and large scale damage to the dwelling houses",lives,11,22,44,1,78,punjab
7/27/17,https://reliefweb.int/node/2143594,"the state government has mentioned that 1160 relief camps (357 relief camps + 803 relief distribution center) have been opened and 1,31,416 inmates are housed in these camps, so far",lives,11,22,44,1,78,punjab
7/27/17,https://reliefweb.int/node/2143594,"the inter-ministerial central team, in consultation with the state government, are visiting the affected areas of the state, from 25-28th july 2017 for on the spot assessment of damages of immediate and temporary nature",lives,11,22,44,1,78,punjab
7/27/17,https://reliefweb.int/node/2143594,"to ensure effective preparedness, mha conducted annual meeting of relief commissioners/ secretaries, department of disaster management of state / uts on 17 may 2017 to review the status of preparedness and to discuss other disaster management related issues",lives,11,22,44,1,78,punjab
7/27/17,https://reliefweb.int/node/2143594,"1555.84 crore has been provided during 2017-18, so far, to different states which were affected by calamities of severe nature",lives,11,22,44,1,78,punjab
7/27/17,https://reliefweb.int/node/2143594,mha have deployed about 88 specialized teams of ndrf in 26 states and uts with 304 boats another necessary search and rescue equipment,lives,11,22,44,1,78,punjab
3/22/17,https://reliefweb.int/node/1960219,the two hydrology projects have helped several communities in vulnerable areas to plan in advance and build resilience against the uncertainties of climate change,lives,10,12,11,2,35,punjab
3/22/17,https://reliefweb.int/node/1960219,"surging flood waters afflict some 32 million people each year, robbing the economy of anything between rs 6000 crore and rs 12,000 crores",lives,10,12,11,2,35,punjab
3/22/17,https://reliefweb.int/node/1960219,drought affects a further 150 million people,lives,10,12,11,2,35,punjab
3/22/17,https://reliefweb.int/node/1960219,"‚Äútake the floods in bihar in 2016, in odisha in 2011, or the floods in the krishna river in andhra pradesh in 1998 that affected more than 2 million people,‚Äù says gaur",lives,10,12,11,2,35,punjab
3/22/17,https://reliefweb.int/node/1960219,they now have a modelling tool that helps them predict water flows into their reservoirs three days in advance,lives,10,12,11,2,35,punjab
3/22/17,https://reliefweb.int/node/1960219," these reservoir management systems, which cost a total of rs 30 crores, have helped avert flood damages of over rs",lives,10,12,11,2,35,punjab
3/22/17,https://reliefweb.int/node/1960219,"but, in 2013, when the rivers were in similar spate, no floods took place and there was no damage",lives,10,12,11,2,35,punjab
3/22/17,https://reliefweb.int/node/1960219,"‚Äúoverall, the real and tangible benefits of the systems established under the two hydrology projects include people whose lives, homes, and crops are saved due to improved flood forecasting, farmers who benefit from improved irrigation supplies, and children who do not fall ill or worse from drinking contaminated water,‚Äù said halla maher qaddumi, senior water economist at the world bank in new delhi",lives,10,12,11,2,35,punjab
7/13/16,https://reliefweb.int/node/1608486,"the flood situation in assam remained unchanged in the deluge hit lakhimpur, golaghat, morigaon, barpeta, biswanath and jorhat districts where 1.11 lakh people are affected",lives,1,0,2,0,3,sas nagar
12/15/15,https://reliefweb.int/node/1307226,so far nearly 400 people have died and over 1.8 million people have been displaced,lives,31,5,22,0,58,punjab
12/15/15,https://reliefweb.int/node/1307226,non-stop torrential rains since monday night (30.11.2015) pounded several parts of chennai and north tamil nadu triggering a deluge completely disrupting normal life as army was deployed today in two suburban areas to undertake rescue on a war footing,lives,31,5,22,0,58,punjab
12/15/15,https://reliefweb.int/node/1307226,"the government has deployed 1200 ndrf personnel, 100 boats and 200 divers to rescue stranded people in flood-hit areas",lives,31,5,22,0,58,punjab
12/15/15,https://reliefweb.int/node/1307226,"40 army teams, 6 navy teams with 12 boats and several relief teams have been deployed in chennai to intensify rescue and relief operations",lives,31,5,22,0,58,punjab
12/15/15,https://reliefweb.int/node/1307226,"jayalalithaa and announced rs.1,000crore (us$ 151,515,151.52) for tamil nadu flood relief",lives,31,5,22,0,58,punjab
7/18/15,https://reliefweb.int/node/1087711,two spanish and two civil engineers were rescued by the army from the affected area after the natural calamity,lives,4,14,17,0,35,sas nagar
7/18/15,https://reliefweb.int/node/1087711,in assam around 174 villages in 4 districts are affected due to flood,lives,4,14,17,0,35,sas nagar
6/25/15,https://reliefweb.int/node/1053026,"according to district authorities, rescue operation is on in 12 villages marooned by the flood waters",lives,2,2,3,0,7,punjab
4/27/15,https://reliefweb.int/node/955971,the flood affected over 2.3 million people in the northern part of bihar,lives,21,1,5,1,28,punjab
4/27/15,https://reliefweb.int/node/955971,the government announced rs 6 lakh compensation to the relatives of those killed as prime minister narendra modi took stock of rescue and relief operations at a review meeting,lives,21,1,5,1,28,punjab
4/27/15,https://reliefweb.int/node/955971,an indian army expedition team rescued over 61 climbers from mount everest and retrieved 19 bodies,lives,21,1,5,1,28,punjab
4/27/15,https://reliefweb.int/node/955971,"""19 dead bodies were retrieved and 61 injured persons were rescued by the indian army expedition team",lives,21,1,5,1,28,punjab
11/18/14,https://reliefweb.int/node/728766,"help for recovery after south asia floods  by david tereshchuk* november 18, 2014‚Äîin september of this year, south asia‚Äôs worst monsoon season in 50 years caused torrential flooding and landslides that killed hundreds of people in india and pakistan, and displaced many thousands from their homes",lives,14,4,15,0,33,sas nagar
11/18/14,https://reliefweb.int/node/728766,"srinagar, indian kashmir‚Äôs largest city, was extensively damaged, with floodwaters running at a depth of 12 feet in many neighborhoods, often submerging entire homes",lives,14,4,15,0,33,sas nagar
11/18/14,https://reliefweb.int/node/728766,"your gift to international disaster response, advance # 982450, will help south asia flood survivors and other populations affected by catastrophe to start rebuilding their lives.",lives,14,4,15,0,33,sas nagar
10/28/14,https://reliefweb.int/node/703828,"in addition, residents of around 20 flood-affected villages are to receive psychosocial support",lives,13,3,31,0,47,punjab
10/28/14,https://reliefweb.int/node/703828,"communities in india hit by new flooding some 1.2 million people in assam and meghalaya have been hit by new flooding, which has destroyed nearly 34,000 homes and damaged infrastructure such as schools, health facilities and transport structures",lives,13,3,31,0,47,punjab
10/28/14,https://reliefweb.int/node/703828,"over 163,000 people are currently living in relief camps and other temporary shelters",lives,13,3,31,0,47,punjab
10/28/14,https://reliefweb.int/node/703828,"essential relief for flood-affected families in pakistan in pakistan, hundreds died and around 2.5 million people were affected as floodwaters destroyed homes, vital infrastructure, and livelihoods last month",lives,13,3,31,0,47,punjab
10/28/14,https://reliefweb.int/node/703828,"in punjab, we offered relief from the worry of finding food, by providing over 10,000 flood-affected families across four union councils with qurbani meat",lives,13,3,31,0,47,punjab
10/19/14,https://reliefweb.int/node/702341,"2 patna doctors serve flood-hit in kashmir  banjot kaur bhatia,tnn | oct 19, 2014, 10.45 pm ist patna: while help poured in from different corners of the world for the people of jammu and kashmir reeling under floods late last month, two patna-based doctors also did their bit by offering medical help to people there",lives,12,2,5,1,20,sas nagar
10/19/14,https://reliefweb.int/node/702341,they served the flood victims of srinagar and pulwama from september 28 to october 3,lives,12,2,5,1,20,sas nagar
9/15/14,https://reliefweb.int/node/691734,"round up at 1800 hrs - number of people rescued crosses 2,34,000 in j&k (15 september 2014)  more heavy duty suction pumps and ro plants being airlifted to the valley over 2,34,000 persons have been rescued so far by the armed forces and ndrf from different parts of jammu & kashmir in the ongoing rescue and relief operations in the flood ravaged state",lives,16,7,11,0,34,"amritsar, sas nagar"
9/15/14,https://reliefweb.int/node/691734,thirty generator sets of 3 to 5 kva capacity have also been sent to srinagar to augment continuous power supply in relief camps and field hospitals,lives,16,7,11,0,34,"amritsar, sas nagar"
9/15/14,https://reliefweb.int/node/691734,"over 33,000 blankets are being airlifted to flood-affected area today, which were donated by ministry of textile, red cross society and government of jharkhand and punjab",lives,16,7,11,0,34,"amritsar, sas nagar"
9/15/14,https://reliefweb.int/node/691734,"earlier 8,200 blankets and 1572 tents were provided to the flood victims",lives,16,7,11,0,34,"amritsar, sas nagar"
9/15/14,https://reliefweb.int/node/691734,"more relief materials including tents, water bottles and food packets are being airlifted from delhi, arakonam and amritsar",lives,16,7,11,0,34,"amritsar, sas nagar"
9/15/14,https://reliefweb.int/node/691734,eighty transport aircraft and helicopters of indian air force and army aviation corps are continuing their efforts in rescue and relief operations,lives,16,7,11,0,34,"amritsar, sas nagar"
9/15/14,https://reliefweb.int/node/691734,"army has deployed around 30,000 troops for rescue and relief operations in the flood affected area",lives,16,7,11,0,34,"amritsar, sas nagar"
9/15/14,https://reliefweb.int/node/691734,nearly 6 lakh litres of water and over 1313 tonnes of food packets/cooked food and ration have already been distributed in the flood-affected areas,lives,16,7,11,0,34,"amritsar, sas nagar"
9/15/14,https://reliefweb.int/node/691734,so far 2527 sorties were undertaken by the helicopters and aircraft of armed forces and 3673 tonnes of relief materials have been dropped by the indian air force,lives,16,7,11,0,34,"amritsar, sas nagar"
9/15/14,https://reliefweb.int/node/691734,a total of 224 boats of army and 148 ndrf‚Äôs inflatable boats are actively involved in the rescue operation,lives,16,7,11,0,34,"amritsar, sas nagar"
9/15/14,https://reliefweb.int/node/691734,armed forces have also established 19 relief camps in srinagar and jammu region,lives,16,7,11,0,34,"amritsar, sas nagar"
9/15/14,https://reliefweb.int/node/691734,"in srinagar region, camps were established at bb cantt, avantipur, old airfield, sumbal, chattargam and jijamata mandir, where thousands of rescued people are being sheltered",lives,16,7,11,0,34,"amritsar, sas nagar"
9/15/14,https://reliefweb.int/node/691554,"15 sept : round up at 1300 hrs - number of people rescued crosses 2,26,000 in j&k  more heavy duty suction pumps and ro plants being airlifted to the valley over 2,26,000 persons have been rescued so far by the armed forces and ndrf from different parts of jammu & kashmir in the ongoing rescue and relief operations in the flood ravaged state",lives,15,7,11,0,33,"amritsar, sas nagar"
9/15/14,https://reliefweb.int/node/691554,thirty generator sets of 3 to 5 kva capacity have also been sent to srinagar to augment continuous power supply in relief camps and field hospitals,lives,15,7,11,0,33,"amritsar, sas nagar"
9/15/14,https://reliefweb.int/node/691554,"over 33,000 blankets are being airlifted to flood-affected area today, which were donated by ministry of textile, red cross society and government of jharkhand and punjab",lives,15,7,11,0,33,"amritsar, sas nagar"
9/15/14,https://reliefweb.int/node/691554,"earlier 8,200 blankets and 1572 tents were provided to the flood victims",lives,15,7,11,0,33,"amritsar, sas nagar"
9/15/14,https://reliefweb.int/node/691554,"more relief materials including tents, water bottles and food packets are being airlifted from delhi, arakonam and amritsar",lives,15,7,11,0,33,"amritsar, sas nagar"
9/15/14,https://reliefweb.int/node/691554,eighty transport aircraft and helicopters of indian air force and army aviation corps are continuing their efforts in rescue and relief operations,lives,15,7,11,0,33,"amritsar, sas nagar"
9/15/14,https://reliefweb.int/node/691554,"army has deployed around 30,000 troops for rescue and relief operations in the flood affected area",lives,15,7,11,0,33,"amritsar, sas nagar"
9/15/14,https://reliefweb.int/node/691554,"more than 5,08,000 litres of water and over 1054 tonnes of food packets and cooked food have already been distributed in the flood-affected areas",lives,15,7,11,0,33,"amritsar, sas nagar"
9/15/14,https://reliefweb.int/node/691554,so far 2451 sorties were undertaken by the helicopters and aircraft of armed forces and 3435 tonnes of relief materials have been dropped by the indian air force,lives,15,7,11,0,33,"amritsar, sas nagar"
9/15/14,https://reliefweb.int/node/691554,a total of 224 boats of army and 148 ndrf‚Äôs inflatable boats are actively involved in the rescue operation,lives,15,7,11,0,33,"amritsar, sas nagar"
9/15/14,https://reliefweb.int/node/691554,armed forces have also established 19 relief camps in srinagar and jammu region,lives,15,7,11,0,33,"amritsar, sas nagar"
9/15/14,https://reliefweb.int/node/691554,"in srinagar region, camps were established at bb cantt, avantipur, old airfield, sumbal, chattargam and jijamata mandir, where thousands of rescued people are being sheltered",lives,15,7,11,0,33,"amritsar, sas nagar"
9/13/14,https://reliefweb.int/node/691309,"with no help in sight, the workers left the locality on foot when the water levels receded and trekked all the way to ramban along the closed srinagar-jammu national highway 150km away",lives,12,1,7,1,21,"amritsar, sas nagar"
9/13/14,https://reliefweb.int/node/691309,"kumar is among an estimated 12,000 people, who have trekked to ramban in sheer desperation as they received no help from administration, which was practically washed away in the flood waters that have killed over 200 people and marooned tens of thousands besides leaving as many homeless",lives,12,1,7,1,21,"amritsar, sas nagar"
9/13/14,https://reliefweb.int/node/691309, a defence spokesman said they had to specially help them cross a 300m stretch of the highway washed away near ramsu with the help of ropes,lives,12,1,7,1,21,"amritsar, sas nagar"
9/13/14,https://reliefweb.int/node/691309,"roshan singh from amritsar, who arrived in ramban on saturday, said the army rescued him after five days from a trapped house in srinagar",lives,12,1,7,1,21,"amritsar, sas nagar"
9/12/14,https://reliefweb.int/node/691053,india floods: aid on the way to survivors of worst floods for 50 years  thousands of people in the flood-stricken indian state of jammu and kashmir are to receive emergency aid from tearfund after the area suffered its worst monsoon rains in 50 years,lives,11,8,12,0,31,punjab
9/12/14,https://reliefweb.int/node/691053,"tearfund‚Äôs local partner, the evangelical fellowship of india commission on relief (eficor), will this week distribute food, including rice, wheat and pulses, to 500 of the most vulnerable families who‚Äôve suffered as a result of flooding and landslides",lives,11,8,12,0,31,punjab
9/12/14,https://reliefweb.int/node/691053,"eficor, which has a track record of responding to natural disasters, such as the 2001 gujarat earthquake and the 2004 boxing day tsunami, is working closely with the indian government and other humanitarian agencies at state and national level to get help to those who need it as quickly as possible",lives,11,8,12,0,31,punjab
9/12/14,https://reliefweb.int/node/691053, the disaster has so far claimed 220 lives in india and left a million people needing help,lives,11,8,12,0,31,punjab
9/12/14,https://reliefweb.int/node/691053,"the floods have also brought devastation to parts of pakistan where 230 people have died, with the state of punjab badly affected, as well as bangladesh and nepal",lives,11,8,12,0,31,punjab
9/10/14,https://reliefweb.int/node/690316,"as many as 60 major and minor roads have been cut off and over 30 bridges washed away, hampering the relief and rescue operations",lives,10,9,18,0,37,sas nagar
9/10/14,https://reliefweb.int/node/690316," caritas pakistan reaches survivors in punjab and azad jammu and kashmir in pakistan, hundreds of villages have been washed away, embankments broken, roads damaged and power lines downed",lives,10,9,18,0,37,sas nagar
9/10/14,https://reliefweb.int/node/690209,"j&k floods: over 200 dead, 47,000 people rescued  sameer arshad,tnn | sep 10, 2014, 06.40 am ist jammu: the death toll from the floods in jammu & kashmir crossed 200 on tuesday even as water receded in some parts with officials fearing the number of those killed could rise once the actual extent of damage becomes clearer",lives,16,5,22,0,43,sas nagar
9/10/14,https://reliefweb.int/node/690209,"armed forces and ndrf have so far saved 47,227 people flying 451 sorties and transporting 42,000 litres of water, 563 tonnes of relief material including seven tonnes of baby food",lives,16,5,22,0,43,sas nagar
9/10/14,https://reliefweb.int/node/690209,"the forces have deployed over 1 lakh soldiers for rescue operations, equipped with 170 boats",lives,16,5,22,0,43,sas nagar
9/9/14,https://reliefweb.int/node/690121,the radio station had done a commendable job by running a live helpline before it went off air on sunday,lives,23,3,23,0,49,sas nagar
9/9/14,https://reliefweb.int/node/690121,the army said it has pressed over one lakh soldiers for the rescue operations,lives,23,3,23,0,49,sas nagar
9/9/14,https://reliefweb.int/node/690121,they are equipped with 170 boats to evacuate marooned residents,lives,23,3,23,0,49,sas nagar
9/9/14,https://reliefweb.int/node/690121,"he said over 30,000 people have been evacuated to safer places",lives,23,3,23,0,49,sas nagar
9/1/14,https://reliefweb.int/node/688081,a drought is declared when overall deficiency is more than 10 per cent and over 20 per cent of country‚Äôs area is affected by drought-like conditions,lives,0,28,4,0,32,punjab
9/1/14,https://reliefweb.int/node/688081,"if a state government declares drought, it has to pay 50 per cent of the relief amount to the farmers before the centre releases its share",lives,0,28,4,0,32,punjab
8/12/13,https://reliefweb.int/node/594982,"rail, road traffic disrupted as rain continues in himachal pradesh  s gopal puri, tnn | aug 12, 2013, 05.36 am ist dharamshala: constant rainfall in himachal pradesh has caused massive destruction in the lower parts of the state, with rural areas and villages being the worst affected",lives,5,16,22,0,43,"pathankot, sas nagar"
8/12/13,https://reliefweb.int/node/594982,"about 100 families in kandrori area were evacuated and provided temporary shelter and food as gushing flood waters ravaged the villages after release of 60,000 cusecs of water from maharana pratap sagar reservoir (pong dam)",lives,5,16,22,0,43,"pathankot, sas nagar"
7/7/13,https://reliefweb.int/node/587489,"villagers still stuck with little to eat  swati mathur, tnn | jul 7, 2013, 03.00 am ist dehradun: even as relief material poured into dehradun for the 15th straight day, people in the flood-affected districts of uttarakhand continued to remain deprived of vital rations",lives,9,1,19,0,29,punjab
7/7/13,https://reliefweb.int/node/587489,"""we're despatching about 35 to 40 small relief trucks daily",lives,9,1,19,0,29,punjab
7/7/13,https://reliefweb.int/node/587489,government officials confirmed they had received over 400 large relief trucks since june 22 when supplies started pouring in from various parts of the country,lives,9,1,19,0,29,punjab
7/7/13,https://reliefweb.int/node/587489,"in mana, the last indian village along the indo-tibetan border, only 40 of the 200 families said they have received their share of relief",lives,9,1,19,0,29,punjab
7/7/13,https://reliefweb.int/node/587489,no one seems to have thought what will happen once relief supplies dry up and people are forced to return to the old sources of drinking water,lives,9,1,19,0,29,punjab
9/14/12,https://reliefweb.int/node/525080,"southwest monsoon-2012: daily flood situation report summary of important events as on 14.09.2012  rainfall/flood situation in the country rainfall occurred  at many places over east uttar pradesh, jharkhand, chhattisgarh, west bengal & sikkim, gujarat, west cost and andaman & nicobar islands; at a few places over himachal pradesh, uttrakhand, west uttar pradesh, bihar, odisha and northeastern states; at one or two places over punjab, haryana, east rajasthan, madhya pradesh, madhya maharashtra, interior karnataka, coastal andhra pradesh, tamilnadu and lakshadweep and weather remained mainly dry over rest part of the country",lives,1,5,1,1,8,sas nagar
8/2/12,https://reliefweb.int/node/515464,"southwest monsoon-2012: daily flood situation report summary of important events as on 02.08.2012  rainfall/flood situation in the country rainfall occurred at many places over himachal pradesh, delhi, konkan, assam, arunachal pradesh and nagaland; at a few places over uttrakhand, madhya pradesh, madhya maharashtra, costal karnataka, and tripura; at one or two places over jammu & kashmir, haryana, uttar pradesh, gujarat region, saurashtra, jharkhand, orissa, chhattisgarh, marathwada, vidarbha, telangana, rayalseema, sikkim and interior karnataka",lives,1,3,1,1,6,punjab
7/23/12,https://reliefweb.int/node/512568,sufficient funds to the tune of rs.4524 crore are currently available under national disaster relief fund,lives,2,18,6,1,27,punjab
9/10/11,https://reliefweb.int/node/445958,"the ircs, a member of the international federation of red cross and red crescent societies, the world‚Äôs largest humanitarian organization, with millions of active volunteers across 186 countries has responded to the floods in india that have affected 8.6 million people",lives,6,3,13,0,22,punjab
9/10/11,https://reliefweb.int/node/445958,"the floods have so far claimed 310 lives, 6371 life stock is lost and 63190 houses are completely damaged",lives,6,3,13,0,22,punjab
9/10/11,https://reliefweb.int/node/445958,"as an immediate response to the floods, the ircs provided relief items amounting to in excess of inr 38,000,000, however more needs to be done to assist the states most severely affected by flooding this monsoon season",lives,6,3,13,0,22,punjab
8/24/11,https://reliefweb.int/node/442809,"in view of the rains, several rivers, including yamuna, som, tangri, ghaggar, beas, sutlej and ravi are in spate with villages close to their banks facing a flood-like situation and affecting around 15,000 acres of farm land in punjab and haryana, official sources said here",lives,1,4,10,0,15,"amritsar, fazilka, ferozepur, ludhiana, patiala, sas nagar, tarn taran"
8/18/11,https://reliefweb.int/node/441578,"two more persons were killed on wednesday and another was said to be missing in heavy rains since sunday, the sources said adding that the landslide toll climbed to six after one person died last night at west garo hills",lives,19,8,5,0,32,punjab
8/18/11,https://reliefweb.int/node/441578,"over 5,000 people from selsella and garobadha areas were displaced as ganol and jinjiram rivers overflowed, inundating large tracts in west garo hills district",lives,19,8,5,0,32,punjab
5/13/11,https://reliefweb.int/node/401633,"hansi-butana wall worries punjab villagers   sangrur: as if a swelling ghaggar during monsoons was not enough for causing damage, the construction of a 10-foot high concrete wall along the hansi-butana canal in haryana is also expected to severely affect people living near the seasonal river",lives,11,2,17,0,30,"patiala, sangrur"
7/29/10,https://reliefweb.int/node/362397,"- 600 villages (kurukshetra-247, kaithal-147, ambala-22, fatehabad-127 and sirsa-57) have been affected",lives,10,6,16,0,32,"mansa, patiala, sangrur, sas nagar"
7/29/10,https://reliefweb.int/node/362397,- 30 human lives have been lost so far across the state,lives,10,6,16,0,32,"mansa, patiala, sangrur, sas nagar"
7/29/10,https://reliefweb.int/node/362397,"- 01 team of ndrf has been deployed in sirsa district consisting of 42 personnel alongwith boats and other life saving aids, for emergency response and rescue operations in flood affected areas",lives,10,6,16,0,32,"mansa, patiala, sangrur, sas nagar"
7/29/10,https://reliefweb.int/node/362397,- 157 houses fully and 1074 houses have been partially damaged,lives,10,6,16,0,32,"mansa, patiala, sangrur, sas nagar"
7/29/10,https://reliefweb.int/node/362397,- about 375 persons have been accommodated in 08 relief camps in mansa district,lives,10,6,16,0,32,"mansa, patiala, sangrur, sas nagar"
7/29/10,https://reliefweb.int/node/362397,- about 1500 persons have been evacuated in sangrur district so far,lives,10,6,16,0,32,"mansa, patiala, sangrur, sas nagar"
7/28/10,https://reliefweb.int/node/362384,"- 600 villages (kurukshetra-247, kaithal-147, ambala-22, fatehabad-127 and sirsa-57) have been affected",lives,10,6,16,0,32,"mansa, patiala, sangrur, sas nagar"
7/28/10,https://reliefweb.int/node/362384,- 30 human lives have been lost so far across the state,lives,10,6,16,0,32,"mansa, patiala, sangrur, sas nagar"
7/28/10,https://reliefweb.int/node/362384,"- 01 team of ndrf has been deployed in sirsa district consisting of 42 personnel alongwith boats and other life saving aids, for emergency response and rescue operations in flood affected areas",lives,10,6,16,0,32,"mansa, patiala, sangrur, sas nagar"
7/28/10,https://reliefweb.int/node/362384,- 157 houses fully and 1072 houses have been partially damaged,lives,10,6,16,0,32,"mansa, patiala, sangrur, sas nagar"
7/28/10,https://reliefweb.int/node/362384,- about 375 persons have been accommodated in 08 relief camps in mansa district,lives,10,6,16,0,32,"mansa, patiala, sangrur, sas nagar"
7/28/10,https://reliefweb.int/node/362384,- about 1500 persons have been evacuated in sangrur district so far,lives,10,6,16,0,32,"mansa, patiala, sangrur, sas nagar"
7/25/10,https://reliefweb.int/node/362192,"- 600 villages (kurukshetra-247, kaithal-147, ambala-22, fatehabad-127 and sirsa-57) have been affected",lives,10,8,16,0,34,"mansa, patiala, sangrur, sas nagar"
7/25/10,https://reliefweb.int/node/362192,- 30 human live lost have been reported so far across the state,lives,10,8,16,0,34,"mansa, patiala, sangrur, sas nagar"
7/25/10,https://reliefweb.int/node/362192,"- 02 teams of ndrf have been deployed in sirsa district consisting of 59 personnel alongwith boats and other life saving aids, for emergency response and rescue operations in flood affected area",lives,10,8,16,0,34,"mansa, patiala, sangrur, sas nagar"
7/25/10,https://reliefweb.int/node/362192,- 137 houses fully and 745 houses have been partially damaged,lives,10,8,16,0,34,"mansa, patiala, sangrur, sas nagar"
7/25/10,https://reliefweb.int/node/362192,- about 375 persons have been accommodated in 08 relief camps in mansa district,lives,10,8,16,0,34,"mansa, patiala, sangrur, sas nagar"
7/25/10,https://reliefweb.int/node/362192,- about 1500 persons have been evacuated in sangrur district so far,lives,10,8,16,0,34,"mansa, patiala, sangrur, sas nagar"
7/24/10,https://reliefweb.int/node/362106,- 77 villages of district fatehabad and 20 villages of district sirsa have been affected,lives,10,5,17,0,32,"mansa, patiala, sangrur, sas nagar"
7/24/10,https://reliefweb.int/node/362106,"- 02 teams of ndrf have been deployed in sirsa district consisting of 59 personnel alongwith boats and other life saving aids, for emergency response and rescue operations in flood affected area",lives,10,5,17,0,32,"mansa, patiala, sangrur, sas nagar"
7/24/10,https://reliefweb.int/node/362106,- 137 houses fully and 745 houses have been partially damaged,lives,10,5,17,0,32,"mansa, patiala, sangrur, sas nagar"
7/24/10,https://reliefweb.int/node/362106,- about 375 persons have been accommodated in 08 relief camps in mansa district,lives,10,5,17,0,32,"mansa, patiala, sangrur, sas nagar"
7/24/10,https://reliefweb.int/node/362106,- about 1500 persons have been evacuated in sangrur district so far,lives,10,5,17,0,32,"mansa, patiala, sangrur, sas nagar"
7/23/10,https://reliefweb.int/node/362190,- 77 villages of district fatehabad and 20 villages of district sirsa have been affected,lives,10,5,16,0,31,"mansa, patiala, sangrur, sas nagar"
7/23/10,https://reliefweb.int/node/362190,"- 02 teams of ndrf have been deployed in sirsa district consisting of 59 personnel alongwith boats and other life saving aids, for emergency response and rescue operations in flood affected area",lives,10,5,16,0,31,"mansa, patiala, sangrur, sas nagar"
7/23/10,https://reliefweb.int/node/362190,- 137 houses fully and 745 houses have been partially damaged,lives,10,5,16,0,31,"mansa, patiala, sangrur, sas nagar"
7/23/10,https://reliefweb.int/node/362190,- about 375 persons have been accommodated in 08 relief camps in mansa district,lives,10,5,16,0,31,"mansa, patiala, sangrur, sas nagar"
7/23/10,https://reliefweb.int/node/362190,- about 1500 persons have been evacuated in sangrur district so far,lives,10,5,16,0,31,"mansa, patiala, sangrur, sas nagar"
7/22/10,https://reliefweb.int/node/361876,- 77 villages of district fatehbad and 20 villages of district sirsa have been affected,lives,8,5,15,0,28,"mansa, patiala, sangrur, sas nagar"
7/22/10,https://reliefweb.int/node/361876,"- 02 teams of ndrf have been deployed in sirsa district consisting of 59 personnel alongwith boats and other life saving aids, for emergency response and rescue operations in flood affected area",lives,8,5,15,0,28,"mansa, patiala, sangrur, sas nagar"
7/22/10,https://reliefweb.int/node/361876,- 137 houses fully and 745 houses have been partially damaged,lives,8,5,15,0,28,"mansa, patiala, sangrur, sas nagar"
7/22/10,https://reliefweb.int/node/361876,- about 375 persons have been accommodated in 08 relief camps in mansa district,lives,8,5,15,0,28,"mansa, patiala, sangrur, sas nagar"
7/22/10,https://reliefweb.int/node/361876,- about 1500 persons have been evacuated in sangrur district so far,lives,8,5,15,0,28,"mansa, patiala, sangrur, sas nagar"
7/21/10,https://reliefweb.int/node/361685,- 77 villages of district fatehbad and 20 villages of district sirsa have been affected,lives,8,5,15,0,28,"mansa, patiala, sangrur, sas nagar"
7/21/10,https://reliefweb.int/node/361685,"- 02 teams of ndrf have been deployed in sirsa district consisting of 59 personnel alongwith boats and other life saving aids, for emergency response and rescue operations in flood affected area",lives,8,5,15,0,28,"mansa, patiala, sangrur, sas nagar"
7/21/10,https://reliefweb.int/node/361685,- 137 houses fully and 742 houses have been partially damaged,lives,8,5,15,0,28,"mansa, patiala, sangrur, sas nagar"
7/21/10,https://reliefweb.int/node/361685,- about 375 persons have been accommodated in 08 relief camps in mansa district,lives,8,5,15,0,28,"mansa, patiala, sangrur, sas nagar"
7/21/10,https://reliefweb.int/node/361685,- about 1500 persons have been evacuated in sangrur district so far,lives,8,5,15,0,28,"mansa, patiala, sangrur, sas nagar"
7/20/10,https://reliefweb.int/node/361647,"with disaster management conspicuous by its absence, a punjab irrigation official, requesting anonymity, said, ""ghaggar, known as the river of misery in the two states, can be tamed with the help of three damns",lives,4,13,11,2,30,"mansa, patiala, sangrur"
7/20/10,https://reliefweb.int/node/361647,heightened floods will cause extensive damage in punjab and the canal may prove to be an environmental hazard,lives,4,13,11,2,30,"mansa, patiala, sangrur"
7/20/10,https://reliefweb.int/node/361647,"and though the government wants the abandoned satluj-yamuna link canal to be operational at any cost, it has done nothing to carry out repairs in the neglected canal, which has given into fissures",lives,4,13,11,2,30,"mansa, patiala, sangrur"
7/20/10,https://reliefweb.int/node/361647,"punjab has also demanded damages of rs 10,000 against the existing rs 1,600 per acre of crop loss.",lives,4,13,11,2,30,"mansa, patiala, sangrur"
7/20/10,https://reliefweb.int/node/361587,- 77 villages of district fatehbad and 20 villages of district sirsa have been affected,lives,8,3,15,0,26,"mansa, patiala, sangrur, sas nagar"
7/20/10,https://reliefweb.int/node/361587,"- 01 team of ndrf has been deployed in sirsa district consisting of 60 personnel alongwith boats and other life saving aids, for emergency response and rescue operations in flood affected area",lives,8,3,15,0,26,"mansa, patiala, sangrur, sas nagar"
7/20/10,https://reliefweb.int/node/361587,- 137 houses fully and 742 houses have been partially damaged,lives,8,3,15,0,26,"mansa, patiala, sangrur, sas nagar"
7/20/10,https://reliefweb.int/node/361587,- about 375 persons have been accommodated in 08 relief camps in mansa district,lives,8,3,15,0,26,"mansa, patiala, sangrur, sas nagar"
7/20/10,https://reliefweb.int/node/361587,- about 1500 persons have been evacuated in sangrur district so far,lives,8,3,15,0,26,"mansa, patiala, sangrur, sas nagar"
7/19/10,https://reliefweb.int/node/361653,- 77 villages of district fatehbad and 20 villages of district sirsa have been affected,lives,8,3,15,0,26,"mansa, patiala, sangrur, sas nagar"
7/19/10,https://reliefweb.int/node/361653,"- 02 teams of ndrf have been deployed in sirsa district consisting of 60 personnel alongwith boats and other life saving aids, for emergency response and rescue operations in flood affected area",lives,8,3,15,0,26,"mansa, patiala, sangrur, sas nagar"
7/19/10,https://reliefweb.int/node/361653,- 137 houses fully and 742 houses have been partially damaged,lives,8,3,15,0,26,"mansa, patiala, sangrur, sas nagar"
7/19/10,https://reliefweb.int/node/361653,- about 375 persons have been accommodated in 08 relief camps in mansa district,lives,8,3,15,0,26,"mansa, patiala, sangrur, sas nagar"
7/19/10,https://reliefweb.int/node/361653,- about 1500 persons have been evacuated in sangrur district so far,lives,8,3,15,0,26,"mansa, patiala, sangrur, sas nagar"
7/18/10,https://reliefweb.int/node/361463,-77 villages of district fatehbad and 20 villages of district sirsa have been affected,lives,10,5,16,0,31,"mansa, patiala, sangrur, sas nagar"
7/18/10,https://reliefweb.int/node/361463, -01 team in sirsa district consisting of 42 personnel alongwith boats and other life saving aids have been deployed for emergency response and rescue operations in flood affected area,lives,10,5,16,0,31,"mansa, patiala, sangrur, sas nagar"
7/18/10,https://reliefweb.int/node/361463,-131 houses fully and 620 houses have been partially damaged,lives,10,5,16,0,31,"mansa, patiala, sangrur, sas nagar"
7/18/10,https://reliefweb.int/node/361463,-about 375 persons have been accommodated in 08 relief camps in mansa district,lives,10,5,16,0,31,"mansa, patiala, sangrur, sas nagar"
7/18/10,https://reliefweb.int/node/361463,-about 1500 persons have been evacuated in sangrur district so far,lives,10,5,16,0,31,"mansa, patiala, sangrur, sas nagar"
7/18/10,https://reliefweb.int/node/361463, -01 team in sardulgarh (district mansa) consisting of 44 personnel alongwith boats and other life saving aids have been deployed for emergency response and rescue operations in flood affected area,lives,10,5,16,0,31,"mansa, patiala, sangrur, sas nagar"
7/17/10,https://reliefweb.int/node/361549,-77 villages of district fatehbad and 20 villages of district sirsa have been affected,lives,7,5,15,0,27,"mansa, patiala, sangrur, sas nagar"
7/17/10,https://reliefweb.int/node/361549,-131 houses fully and 620 houses have been partially damaged,lives,7,5,15,0,27,"mansa, patiala, sangrur, sas nagar"
7/17/10,https://reliefweb.int/node/361549,-about 375 persons have been accommodated in 08 relief camps in mansa district,lives,7,5,15,0,27,"mansa, patiala, sangrur, sas nagar"
7/17/10,https://reliefweb.int/node/361549,-about 1500 persons have been evacuated in sangrur district so far,lives,7,5,15,0,27,"mansa, patiala, sangrur, sas nagar"
7/17/10,https://reliefweb.int/node/361549," -04 teams (patiala-02, sangrur-01 & sardulgarh-01) of 7th bn ndrf consisting of 151 personnel alongwith boats and other equipment deployed in the flood affected areas",lives,7,5,15,0,27,"mansa, patiala, sangrur, sas nagar"
7/16/10,https://reliefweb.int/node/361436,-77 villages of district fatehbad and 20 villages of district sirsa have been affected,lives,9,3,16,0,28,"mansa, patiala, sangrur, sas nagar"
7/16/10,https://reliefweb.int/node/361436," -01 team of 8th bn ndrf consisting of 44 personnel alongwith boats-09, and other life saving equipment deployed in fatehabad for emergency flood rescue and relief operations",lives,9,3,16,0,28,"mansa, patiala, sangrur, sas nagar"
7/16/10,https://reliefweb.int/node/361436,-131 houses fully and 620 houses have been partially damaged,lives,9,3,16,0,28,"mansa, patiala, sangrur, sas nagar"
7/16/10,https://reliefweb.int/node/361436,-about 375 persons have been accommodated in 08 relief camps in mansa district,lives,9,3,16,0,28,"mansa, patiala, sangrur, sas nagar"
7/16/10,https://reliefweb.int/node/361436,-about 1500 persons have been evacuated in sangrur district so far,lives,9,3,16,0,28,"mansa, patiala, sangrur, sas nagar"
7/16/10,https://reliefweb.int/node/361436," -04 teams (patiala-02, sangrur-01 & sardulgarh-01) of 7th bn ndrf consisting of 151 personnel alongwith boats and other equipment deployed in the flood affected areas",lives,9,3,16,0,28,"mansa, patiala, sangrur, sas nagar"
7/15/10,https://reliefweb.int/node/361268,- 77 villages of district fatehbad and 20 villages of district sirsa have been affected,lives,7,3,15,0,25,"mansa, patiala, sangrur, sas nagar"
7/15/10,https://reliefweb.int/node/361268,- 111 houses fully and 205 houses have been partially damaged,lives,7,3,15,0,25,"mansa, patiala, sangrur, sas nagar"
7/15/10,https://reliefweb.int/node/361268,- about 343 persons have been accommodated in 08 relief camps in mansa district,lives,7,3,15,0,25,"mansa, patiala, sangrur, sas nagar"
7/15/10,https://reliefweb.int/node/361268,- about 1500 persons have been evacuated in sangrur district so far,lives,7,3,15,0,25,"mansa, patiala, sangrur, sas nagar"
7/15/10,https://reliefweb.int/node/361268,"- 04 teams (patiala-02, sangrur-01 & sardulgarh-01) of 7th bn ndrf consisting of 151 personnel alongwith boats and other equipment deployed in the affected areas.",lives,7,3,15,0,25,"mansa, patiala, sangrur, sas nagar"
7/14/10,https://reliefweb.int/node/361147,- 77 villages of district fatehbad and 20 villages of district sirsa have been affected,lives,3,5,14,0,22,"mansa, patiala, sangrur"
7/14/10,https://reliefweb.int/node/361147,- 111 houses fully and 205 houses have been partially damaged,lives,3,5,14,0,22,"mansa, patiala, sangrur"
7/14/10,https://reliefweb.int/node/361147,- 16 relief camps (patiala-03 and mansa-13) have been opened,lives,3,5,14,0,22,"mansa, patiala, sangrur"
7/14/10,https://reliefweb.int/node/361147,- 05 teams of 7th bn ndrf consisting of 191 personnel alongwith boats and other equipment deployed in the affected areas,lives,3,5,14,0,22,"mansa, patiala, sangrur"
7/14/10,https://reliefweb.int/node/360970,"india: 'use existing funds for flood relief'  new delhi: even as the centre constituted a team to make a preliminary assessment of the damage due to floods in punjab and haryana, it asked both the states on tuesday to utilize the rs 3,467 crore already given to them from the calamity relief fund (crf) for immediate flood relief work",lives,2,2,10,0,14,punjab
7/13/10,https://reliefweb.int/node/360982,"over 1,967 km of road network has been fully damaged or washed away in the floods in punjab alone.",lives,9,9,15,0,33,"amritsar, fatehgarh sahib, ferozepur, gurdaspur, hoshiarpur, ludhiana, patiala, sangrur, sas nagar"
7/13/10,https://reliefweb.int/node/360959,- 77 villages of district fatehbad and 20 villages of district sirsa have been affected by floods yesterday,lives,7,7,18,0,32,"mansa, patiala, sangrur"
7/13/10,https://reliefweb.int/node/360959," - 05 teams of 8th bn ndrf consisting of 206 personnel alongwith boats-32, life jacket-110, life buoy- 187, inflatable lights-08, dragon light-10, torch (large)-72, chain saw-08, nylon ropes-11 bundles, reflective jackets-325, generator-08, tent-11, tarpouline-18 and deep diving apparatus-12 have been deployed at ambala-03 and kaithal-02 for emergency response and rescue operations in flood affected areas",lives,7,7,18,0,32,"mansa, patiala, sangrur"
7/13/10,https://reliefweb.int/node/360959,"- 05 teams of 7th bn ndrf consisting of 194 personnel alongwith boats-28, life jacket-47 and life buoy- 25 have been deployed at patiala and sangrur for emergency response and rescue operations in flood affected areas",lives,7,7,18,0,32,"mansa, patiala, sangrur"
7/13/10,https://reliefweb.int/node/360959,- about 4.00 lakhs people are reported to have been affected,lives,7,7,18,0,32,"mansa, patiala, sangrur"
7/13/10,https://reliefweb.int/node/360959,"- 2,71,784 acre cropped area are reported to have been affected",lives,7,7,18,0,32,"mansa, patiala, sangrur"
7/13/10,https://reliefweb.int/node/360959,- 111 houses fully and 205 houses have been partially damaged,lives,7,7,18,0,32,"mansa, patiala, sangrur"
7/13/10,https://reliefweb.int/node/360959,- 16 relief camps (patiala-03 and mansa-13) have been opened,lives,7,7,18,0,32,"mansa, patiala, sangrur"
7/13/10,https://reliefweb.int/node/360959,- 12 petrol boats of ndrf in patiala district have been deployed for relief and rescue operations,lives,7,7,18,0,32,"mansa, patiala, sangrur"
7/12/10,https://reliefweb.int/node/361003," - 05 teams of 8th bn ndrf consisting of 206 personnel alongwith boats-32, life jacket-110, life buoy- 187, inflatable lights-08, dragon light-10, torch (large)-72, chain saw-08, nylon ropes-11 bundles, reflective jackets-325, generator-08, tent-11, tarpouline-18 and deep diving apparatus-12 have been deployed at ambala-03 and kaithal-02 for emergency response and rescue operations in flood affected areas",lives,7,7,13,0,27,"patiala, sangrur"
7/12/10,https://reliefweb.int/node/361003,"- 05 teams of 7th bn ndrf consisting of 194 personnel alongwith boats-28, life jacket-47 and life buoy- 25 have been deployed at patiala and sangrur for emergency response and rescue operations in flood affected areas",lives,7,7,13,0,27,"patiala, sangrur"
7/12/10,https://reliefweb.int/node/361003,- about 4.00 lakhs people are reported to have been affected,lives,7,7,13,0,27,"patiala, sangrur"
7/12/10,https://reliefweb.int/node/361003,"- 2,53,322 acre cropped area are reported to have been affected",lives,7,7,13,0,27,"patiala, sangrur"
7/12/10,https://reliefweb.int/node/361003,- 91 houses fully and 146 houses have been partially damaged,lives,7,7,13,0,27,"patiala, sangrur"
7/12/10,https://reliefweb.int/node/361003,- 03 relief camps have been opened,lives,7,7,13,0,27,"patiala, sangrur"
7/12/10,https://reliefweb.int/node/361003,- 21 boats in patiala district have been deployed for evacuation,lives,7,7,13,0,27,"patiala, sangrur"
7/11/10,https://reliefweb.int/node/360767,"- 08 teams of 8th bn ndrf consisting of 343 personnel alongwith boats-52, life jacket-110, life buoy- 187, inflatable lights-08, dragon light-10, torch (large)-72, chain saw-08, nylon ropes-11 bundles, reflective jackets-325, generator-08, tent-11, tarpouline-18 and deep diving apparatus-12 have been deployed at kurukshetra and kaithal for emergency response and rescue operations in flood affected areas",lives,6,4,15,0,25,"patiala, sangrur"
7/11/10,https://reliefweb.int/node/360767,"- 05 teams of 7th bn ndrf consisting of 194 personnel alongwith boats-28, life jacket-47 and life buoy- 25 have been deployed at patiala and sangrur for emergency response and rescue operations in flood affected areas",lives,6,4,15,0,25,"patiala, sangrur"
7/11/10,https://reliefweb.int/node/360767,- about 900 people are reported to have been affected,lives,6,4,15,0,25,"patiala, sangrur"
7/11/10,https://reliefweb.int/node/360767,"- 1,41,500 ha cropped area are reported to have been affected",lives,6,4,15,0,25,"patiala, sangrur"
7/11/10,https://reliefweb.int/node/360767,- 80 houses fully and 129 houses have been partially damaged,lives,6,4,15,0,25,"patiala, sangrur"
7/11/10,https://reliefweb.int/node/360767,- 26 medical teams and vet teams have been deployed in the flood affected areas,lives,6,4,15,0,25,"patiala, sangrur"
7/11/10,https://reliefweb.int/node/360767,- 03 relief camps have been opened,lives,6,4,15,0,25,"patiala, sangrur"
7/11/10,https://reliefweb.int/node/360767,- 21 boats in patiala district have been deployed for evacuation.,lives,6,4,15,0,25,"patiala, sangrur"
7/11/10,https://reliefweb.int/node/360755,initial estimates suggest damage to paddy crop in over 2 lakh acre each in the two states,lives,8,12,25,0,45,"amritsar, patiala, sangrur"
7/11/10,https://reliefweb.int/node/360755,"according to a preliminary assessment by punjab government, the flood-affected districts have suffered losses worth around rs 300 crore in crops and infrastructure",lives,8,12,25,0,45,"amritsar, patiala, sangrur"
7/11/10,https://reliefweb.int/node/360755,"patiala in punjab seems to be the worst affected district, where only 5 out of 25 breaches have been plugged so far",lives,8,12,25,0,45,"amritsar, patiala, sangrur"
7/11/10,https://reliefweb.int/node/360755,floods have damaged 190 link roads in patiala,lives,8,12,25,0,45,"amritsar, patiala, sangrur"
7/11/10,https://reliefweb.int/node/360755,national disaster response force (ndrf) teams began rescue operations in the two states with the help of 18 boats,lives,8,12,25,0,45,"amritsar, patiala, sangrur"
7/10/10,https://reliefweb.int/node/360648,"- 03 districts (ambala, kurushetra and kaithal) have been badly affected",lives,8,5,21,0,34,"ludhiana, patiala, roopnagar, sangrur, sas nagar"
7/10/10,https://reliefweb.int/node/360648,"- 08 teams of 8th bn ndrf consisting of 343 personnel alongwith boats-52, life jacket-110, life buoy- 187, inflatable lights-08, dragon light-10, torch (large)-72, chain saw-08, nylon ropes-11 bundles, reflective jackets-325, generator-08, tent-11, tarpouline-18 and deep diving apparatus-12 have been deployed at kurushetra and kaithal for emergency response and rescue operations in flood affected areas",lives,8,5,21,0,34,"ludhiana, patiala, roopnagar, sangrur, sas nagar"
7/10/10,https://reliefweb.int/node/360648,"- due to incessant rains over the past four days, 04 districts (roopnagar, ludhiana, sas nagar and patiala) have been badly affected",lives,8,5,21,0,34,"ludhiana, patiala, roopnagar, sangrur, sas nagar"
7/10/10,https://reliefweb.int/node/360648,"- 05 teams of 7th bn ndrf consisting of 207 personnel alongwith boats-28, life jacket-47 and life buoy- 25 have been deployed at patiala and sangrur for emergency response and rescue operations in flood affected areas",lives,8,5,21,0,34,"ludhiana, patiala, roopnagar, sangrur, sas nagar"
7/10/10,https://reliefweb.int/node/360648,- about 178 villages in district patiala have been affected,lives,8,5,21,0,34,"ludhiana, patiala, roopnagar, sangrur, sas nagar"
7/10/10,https://reliefweb.int/node/360648,- about 900 people are reported to have been affected,lives,8,5,21,0,34,"ludhiana, patiala, roopnagar, sangrur, sas nagar"
7/10/10,https://reliefweb.int/node/360648,"- 1,41,500 ha cropped area are reported to have been affected",lives,8,5,21,0,34,"ludhiana, patiala, roopnagar, sangrur, sas nagar"
7/10/10,https://reliefweb.int/node/360648,- 80 fully and 129 partially houses have been damaged,lives,8,5,21,0,34,"ludhiana, patiala, roopnagar, sangrur, sas nagar"
7/10/10,https://reliefweb.int/node/360648,- 26 medical teams and vet teams have been deployed in the flood affected areas,lives,8,5,21,0,34,"ludhiana, patiala, roopnagar, sangrur, sas nagar"
7/10/10,https://reliefweb.int/node/360648,- 03 relief camps have been opened,lives,8,5,21,0,34,"ludhiana, patiala, roopnagar, sangrur, sas nagar"
7/10/10,https://reliefweb.int/node/360648,- 21 boats in patiala district have been deployed for evacuation,lives,8,5,21,0,34,"ludhiana, patiala, roopnagar, sangrur, sas nagar"
7/10/10,https://reliefweb.int/node/360648,- 763.26 km road have been damaged due to heavy and incessant rainfall.,lives,8,5,21,0,34,"ludhiana, patiala, roopnagar, sangrur, sas nagar"
7/9/10,https://reliefweb.int/node/360584,- eight teams of the national disaster response force (ndrf) comprising 339 personnel have been deployed to assist in rescue operations in the state,lives,5,3,14,0,22,"fatehgarh sahib, ludhiana, patiala, sangrur, sas nagar, sbs nagar"
7/9/10,https://reliefweb.int/node/360584,"- two army columns have been deployed in jyotisar (kurukshetra) and two army columns in devinagar (ambala) from 7th july 2010, to assist in flood relief and in repairing the breach in the sutlej yamuna link canal",lives,5,3,14,0,22,"fatehgarh sahib, ludhiana, patiala, sangrur, sas nagar, sbs nagar"
7/9/10,https://reliefweb.int/node/360584,of haryana has launched a helpline for the affected district of ambala (0171-2530401),lives,5,3,14,0,22,"fatehgarh sahib, ludhiana, patiala, sangrur, sas nagar, sbs nagar"
7/9/10,https://reliefweb.int/node/360584,"- according to air, 108 villages in the district of patiala, 115 villages in the district of ludhiana (including between 20-25,000 acres of standing crop) and 115 villages in the district of fatehgarh sahib have been affected by flooding",lives,5,3,14,0,22,"fatehgarh sahib, ludhiana, patiala, sangrur, sas nagar, sbs nagar"
7/9/10,https://reliefweb.int/node/360584,- four teams of the ndrf comprising 167 personnel have been deployed at patiala and sangrur for rescue operations,lives,5,3,14,0,22,"fatehgarh sahib, ludhiana, patiala, sangrur, sas nagar, sbs nagar"
7/9/10,https://reliefweb.int/node/360499,"- 03 districts (ambala, kurushetra and kaithal) have been badly affected",lives,9,5,21,0,35,"ludhiana, patiala, roopnagar, sangrur, sas nagar"
7/9/10,https://reliefweb.int/node/360499,"- 08 teams of 8th bn ndrf consisting of 339 personnel alongwith boats-52, life jacket-110, life buoy- 187, inflatable lights-08, dragon light-10, torch (large)-72, chain saw-08, nylon ropes-11 bundles, reflective jackets-325, generator-08, tent-11, tarpouline-18 and deep diving apparatus-12 have been deployed at kurushetra and kaithal for emergency response and rescue operations in flood affected areas",lives,9,5,21,0,35,"ludhiana, patiala, roopnagar, sangrur, sas nagar"
7/9/10,https://reliefweb.int/node/360499,"- due to incessant rains over the past four days, 04 districts (roopnagar, ludhiana, sas nagar and patiala) have been badly affected",lives,9,5,21,0,35,"ludhiana, patiala, roopnagar, sangrur, sas nagar"
7/9/10,https://reliefweb.int/node/360499,"- 04 teams of 7th bn ndrf consisting of 167 personnel alongwith boats-28, life jacket-47 and life buoy- 25 have been deployed at patiala and sangrur for emergency response and rescue operations in flood affected areas",lives,9,5,21,0,35,"ludhiana, patiala, roopnagar, sangrur, sas nagar"
7/9/10,https://reliefweb.int/node/360499,- about 178 villages in district patiala have been affected,lives,9,5,21,0,35,"ludhiana, patiala, roopnagar, sangrur, sas nagar"
7/9/10,https://reliefweb.int/node/360499,- about 900 people are reported to have been affected,lives,9,5,21,0,35,"ludhiana, patiala, roopnagar, sangrur, sas nagar"
7/9/10,https://reliefweb.int/node/360499,"- 1,41,500 ha cropped area are reported to have been affected",lives,9,5,21,0,35,"ludhiana, patiala, roopnagar, sangrur, sas nagar"
7/9/10,https://reliefweb.int/node/360499,- 80 fully and 129 partially houses have been damaged,lives,9,5,21,0,35,"ludhiana, patiala, roopnagar, sangrur, sas nagar"
7/9/10,https://reliefweb.int/node/360499,- 26 medical teams and vet teams have been deployed in the flood affected areas,lives,9,5,21,0,35,"ludhiana, patiala, roopnagar, sangrur, sas nagar"
7/9/10,https://reliefweb.int/node/360499,- 03 relief camps have been opened,lives,9,5,21,0,35,"ludhiana, patiala, roopnagar, sangrur, sas nagar"
7/9/10,https://reliefweb.int/node/360499,- 21 boats in patiala district have been deployed for evacuation,lives,9,5,21,0,35,"ludhiana, patiala, roopnagar, sangrur, sas nagar"
7/9/10,https://reliefweb.int/node/360499,- 763.26 km road have been damaged due to heavy and incessant rainfall,lives,9,5,21,0,35,"ludhiana, patiala, roopnagar, sangrur, sas nagar"
7/8/10,https://reliefweb.int/node/360551,"- 03 districts (ambala, kurushetra and kaithal) have been badly affected",lives,7,4,11,0,22,"fatehgarh sahib, ludhiana, patiala, sangrur, sas nagar, sbs nagar"
7/8/10,https://reliefweb.int/node/360551," - 08 teams of 8th bn ndrf consisting of 339 personnel alongwith boats-52, life jacket-110, life buoy- 187, inflatable lights-08, dragon light-10, torch (large)-72, chain saw-08, nylon ropes-11 bundles, reflective jackets-325, generator-08, tent-11, tarpouline-18 and deep diving apparatus-12 have been deployed at kurushetra and kaithal for emergency response and rescue operations in flood affected areas",lives,7,4,11,0,22,"fatehgarh sahib, ludhiana, patiala, sangrur, sas nagar, sbs nagar"
7/8/10,https://reliefweb.int/node/360551,#NAME?,lives,7,4,11,0,22,"fatehgarh sahib, ludhiana, patiala, sangrur, sas nagar, sbs nagar"
7/8/10,https://reliefweb.int/node/360551,"- 04 teams of 7th bn ndrf consisting of 167 personnel alongwith boats-28, life jacket-47 and life buoy- 25 have been deployed at patiala and sangrur for emergency response and rescue operations in flood affected areas",lives,7,4,11,0,22,"fatehgarh sahib, ludhiana, patiala, sangrur, sas nagar, sbs nagar"
7/8/10,https://reliefweb.int/node/360551,- about 40 villages in district patiala have been affected,lives,7,4,11,0,22,"fatehgarh sahib, ludhiana, patiala, sangrur, sas nagar, sbs nagar"
7/7/10,https://reliefweb.int/node/360299," buses, trains and other vehicles were stranded and the situation is fast turning grim for those along riverine areas in the three states",lives,3,0,2,0,5,punjab
7/7/10,https://reliefweb.int/node/360202,- 03 districts have been badly affected,lives,4,4,10,0,18,"fatehgarh sahib, ludhiana, patiala, sas nagar, sbs nagar"
7/7/10,https://reliefweb.int/node/360202,"- 03 teams of 8th bn ndrf consisting of 138 personnel alongwith 20 boats and other life saving aids have been deployed at sutlej yamuna link, canal for emergency response and rescue operations in flood affected area",lives,4,4,10,0,18,"fatehgarh sahib, ludhiana, patiala, sas nagar, sbs nagar"
7/7/10,https://reliefweb.int/node/360202,#NAME?,lives,4,4,10,0,18,"fatehgarh sahib, ludhiana, patiala, sas nagar, sbs nagar"
7/7/10,https://reliefweb.int/node/360202,- about 40 villages in district patiala have been affected,lives,4,4,10,0,18,"fatehgarh sahib, ludhiana, patiala, sas nagar, sbs nagar"
7/6/10,https://reliefweb.int/node/360264,"- ¬† ¬† ¬† ¬†about 9,43,357 people, 1363 villages and 13 districts have been affected",lives,7,4,14,0,25,punjab
7/6/10,https://reliefweb.int/node/360264,"- ¬† ¬† ¬† ¬†4,36,800 people have been accommodated in 706 relief camps",lives,7,4,14,0,25,punjab
7/6/10,https://reliefweb.int/node/360264,"- ¬† ¬† ¬† ¬†about 23,262 people, 08 districts & 32 villages have been affected",lives,7,4,14,0,25,punjab
7/6/10,https://reliefweb.int/node/360264,- ¬† ¬† ¬† ¬†163 fully and 3379 partially houses have been damaged so far,lives,7,4,14,0,25,punjab
7/6/10,https://reliefweb.int/node/360264,- ¬† ¬† ¬† ¬†216 people have been accommodated in 04 relief camps,lives,7,4,14,0,25,punjab
7/5/10,https://reliefweb.int/node/360195,"- ¬† ¬† ¬† ¬†about 9,43,357 people, 1363 villages and 13 districts have been affected",lives,7,4,14,0,25,punjab
7/5/10,https://reliefweb.int/node/360195,"- ¬† ¬† ¬† ¬†4,36,800 people have been accommodated in 706 relief camps",lives,7,4,14,0,25,punjab
7/5/10,https://reliefweb.int/node/360195,"- ¬† ¬† ¬† ¬†about 23,059 people, 05 districts & 07 villages have been affected",lives,7,4,14,0,25,punjab
7/5/10,https://reliefweb.int/node/360195,- ¬† ¬† ¬† ¬†157 fully and 3340 partially houses have been damaged so far,lives,7,4,14,0,25,punjab
7/5/10,https://reliefweb.int/node/360195,- ¬† ¬† ¬† ¬†216 people have been accommodated in 04 relief camps,lives,7,4,14,0,25,punjab
7/4/10,https://reliefweb.int/node/360232,"- ¬† ¬† ¬† ¬†about 9,43,357 people, 1363 villages and 13 districts have been affected",lives,7,4,14,0,25,punjab
7/4/10,https://reliefweb.int/node/360232,"- ¬† ¬† ¬† ¬†4,36,800 people have been accommodated in 706 relief camps",lives,7,4,14,0,25,punjab
7/4/10,https://reliefweb.int/node/360232,"- ¬† ¬† ¬† ¬†about 24,363 people, 10 districts & 42 villages have been affected",lives,7,4,14,0,25,punjab
7/4/10,https://reliefweb.int/node/360232,- ¬† ¬† ¬† ¬†142 fully and 3125 partially houses have been damaged so far,lives,7,4,14,0,25,punjab
7/4/10,https://reliefweb.int/node/360232,- ¬† ¬† ¬† ¬†215 people have been accommodated in 04 relief camps,lives,7,4,14,0,25,punjab
7/3/10,https://reliefweb.int/node/360255,"- ¬† ¬† ¬† ¬†about 9,43,357 people, 1363 villages and 13 districts have been affected",lives,7,6,15,0,28,punjab
7/3/10,https://reliefweb.int/node/360255,"- ¬† ¬† ¬† ¬†56,384.59 ha cropped area are reported to have been affected",lives,7,6,15,0,28,punjab
7/3/10,https://reliefweb.int/node/360255,"- ¬† ¬† ¬† ¬†4,36,800 people have been accommodated in 706 relief camps",lives,7,6,15,0,28,punjab
7/3/10,https://reliefweb.int/node/360255,"- ¬† ¬† ¬† ¬†about 24,363 people, 10 districts & 42 villages have been affected",lives,7,6,15,0,28,punjab
7/3/10,https://reliefweb.int/node/360255,- ¬† ¬† ¬† ¬†142 fully and 3125 partially houses have been damaged so far,lives,7,6,15,0,28,punjab
7/3/10,https://reliefweb.int/node/360255,- ¬† ¬† ¬† ¬†215 people have been accommodated in 04 relief camps,lives,7,6,15,0,28,punjab
7/2/10,https://reliefweb.int/node/360081,"- about 9,43,357 people, 1363 villages and 13 districts have been affected",lives,7,6,15,0,28,punjab
7/2/10,https://reliefweb.int/node/360081,"- 56,384.59 ha cropped area are reported to have been affected",lives,7,6,15,0,28,punjab
7/2/10,https://reliefweb.int/node/360081,"- 4,36,800 people have been accommodated in 706 relief camps",lives,7,6,15,0,28,punjab
7/2/10,https://reliefweb.int/node/360081,"- about 24,363 people, 10 districts & 42 villages have been affected",lives,7,6,15,0,28,punjab
7/2/10,https://reliefweb.int/node/360081,- 142 fully and 3125 partially houses have been damaged so far,lives,7,6,15,0,28,punjab
7/2/10,https://reliefweb.int/node/360081,- 215 people have been accommodated in 04 relief camps,lives,7,6,15,0,28,punjab
7/1/10,https://reliefweb.int/node/359848,"- ¬† ¬† ¬† ¬†about 934,127 people, 1206 villages and 11 districts have been affected",lives,7,5,14,0,26,punjab
7/1/10,https://reliefweb.int/node/359848,- ¬† ¬† ¬† ¬†144 boats have been deployed in the affected areas,lives,7,5,14,0,26,punjab
7/1/10,https://reliefweb.int/node/359848,"- ¬† ¬† ¬† ¬†436,800 people have been accommodated in 521 relief camps",lives,7,5,14,0,26,punjab
7/1/10,https://reliefweb.int/node/359848,"- ¬† ¬† ¬† ¬†about 24,363 people, 10 districts & 42 villages have been affected",lives,7,5,14,0,26,punjab
7/1/10,https://reliefweb.int/node/359848,- ¬† ¬† ¬† ¬†142 fully and 3125 partially houses have been damaged so far,lives,7,5,14,0,26,punjab
7/1/10,https://reliefweb.int/node/359848,- ¬† ¬† ¬† ¬†215 people have been accommodated in 04 relief camps,lives,7,5,14,0,26,punjab
6/30/10,https://reliefweb.int/node/359918,"- ¬† ¬† ¬† ¬†about 9,34,127 people, 1206 villages and 11 districts have been affected",lives,7,7,14,0,28,punjab
6/30/10,https://reliefweb.int/node/359918,- ¬† ¬† ¬† ¬†144 boats have been deployed in the affected areas,lives,7,7,14,0,28,punjab
6/30/10,https://reliefweb.int/node/359918,"- ¬† ¬† ¬† ¬†4,36,800 people have been accommodated in 521 relief camps",lives,7,7,14,0,28,punjab
6/30/10,https://reliefweb.int/node/359918,"- ¬† ¬† ¬† ¬†about 24,363 people, 10 districts & 42 villages have been affected",lives,7,7,14,0,28,punjab
6/30/10,https://reliefweb.int/node/359918,- ¬† ¬† ¬† ¬†142 fully and 3125 partially houses have been damaged so far,lives,7,7,14,0,28,punjab
6/30/10,https://reliefweb.int/node/359918,- ¬† ¬† ¬† ¬†215 people have been accommodated in 04 relief camps,lives,7,7,14,0,28,punjab
6/29/10,https://reliefweb.int/node/359891,"- ¬† ¬† ¬† ¬†about 8,63,947 people are reported to have been affected",lives,5,7,14,0,26,punjab
6/29/10,https://reliefweb.int/node/359891,"- ¬† ¬† ¬† ¬†56,224.59 ha cropped area is reported to have been affected",lives,5,7,14,0,26,punjab
6/29/10,https://reliefweb.int/node/359891,- ¬† ¬† ¬† ¬†144 boats have been deployed in the affected areas,lives,5,7,14,0,26,punjab
6/29/10,https://reliefweb.int/node/359891,"- ¬† ¬† ¬† ¬†4,36,800 people have been accommodated in 521 relief camps",lives,5,7,14,0,26,punjab
6/29/10,https://reliefweb.int/node/359891,"- ¬† ¬† ¬† ¬†about 23,706 population and 71 villages in 11 districts are reported to have been affected in the state due to flood so far",lives,5,7,14,0,26,punjab
6/29/10,https://reliefweb.int/node/359891,- ¬† ¬† ¬† ¬†133 fully and 2986 partially houses have been damaged so far,lives,5,7,14,0,26,punjab
6/29/10,https://reliefweb.int/node/359891,- ¬† ¬† ¬† ¬†2820.67 ha cropped area is reported to have been affected,lives,5,7,14,0,26,punjab
6/29/10,https://reliefweb.int/node/359891,- ¬† ¬† ¬† ¬†215 people have been accommodated in 04 relief camps,lives,5,7,14,0,26,punjab
6/28/10,https://reliefweb.int/node/359938,"- ¬† ¬† ¬† ¬†about 8,63,947 people are reported to have been affected",lives,3,4,5,0,12,punjab
6/28/10,https://reliefweb.int/node/359938,"- ¬† ¬† ¬† ¬†56,224.59 ha cropped area are reported to have been affected",lives,3,4,5,0,12,punjab
6/28/10,https://reliefweb.int/node/359938,- ¬† ¬† ¬† ¬†144 boats have been deployed in the affected areas,lives,3,4,5,0,12,punjab
6/28/10,https://reliefweb.int/node/359938,"- ¬† ¬† ¬† ¬†4,36,800 people have been accommodated in 521 relief camps",lives,3,4,5,0,12,punjab
6/3/10,https://reliefweb.int/node/359948,- ¬† ¬† ¬† ¬†13 houses have been damaged,lives,1,2,14,0,17,punjab
6/3/10,https://reliefweb.int/node/359948,- ¬† ¬† ¬† ¬†about 1985 population and 7 villages in 04 districts are reported to have been affected in the state due to flood so far,lives,1,2,14,0,17,punjab
6/3/10,https://reliefweb.int/node/359948,- ¬† ¬† ¬† ¬†01 relief camps has been opened in the affected areas,lives,1,2,14,0,17,punjab
6/3/10,https://reliefweb.int/node/359948,- ¬† ¬† ¬† ¬†385 houses (13-fully & 372-partially) have been damaged,lives,1,2,14,0,17,punjab
12/21/09,https://reliefweb.int/node/337810,"late floods in india during october affected six different states across the country, out of which andhra pradesh and karnataka were the most affected",lives,37,4,13,1,55,punjab
12/21/09,https://reliefweb.int/node/337810,another flood /landslide in the first week of october 2009 affected more than 14 districts of the far western region of nepal,lives,37,4,13,1,55,punjab
12/21/09,https://reliefweb.int/node/337810,"the flood and landslides claimed 62 lives, affecting more than 27,000 families and more than 150,000 individuals",lives,37,4,13,1,55,punjab
12/21/09,https://reliefweb.int/node/337810,"following an assessment, a disaster relief emergency fund (dref) of approximately chf 307,000 (usd 294,763 or eur 205,656) has been allocated for the distribution of non-food items to some 4,000 affected families and replenishment of emergency stocks during the cyclone aila operation, bangladesh red crescent society (bdrcs) and the international federation successfully completed the distribution of shelter kits and household items to 7,000 the affected families in satkhira and khulna districts",lives,37,4,13,1,55,punjab
12/21/09,https://reliefweb.int/node/337810,"approximately 200,000 displaced people are expected to leave the conflict area",lives,37,4,13,1,55,punjab
12/21/09,https://reliefweb.int/node/337810,"according to government estimates, 2,500 to 3,000 displaced families are still staying back in hazara division and attock district",lives,37,4,13,1,55,punjab
12/21/09,https://reliefweb.int/node/337810,latest figures on the displaced people suggest that more than 1.65 million (out of 2.7 million) displaced families have returned to their homes in malakand division,lives,37,4,13,1,55,punjab
12/21/09,https://reliefweb.int/node/337810,"some 7,200 displaced families have so far received non-food items",lives,37,4,13,1,55,punjab
12/21/09,https://reliefweb.int/node/337810,of people we help: the south asia regional office supports the seven national societies and seven country offices of the international federation in south asia,lives,37,4,13,1,55,punjab
9/11/09,https://reliefweb.int/node/324281,"human deaths - as per provisional information received from the affected states/uts, 13 human deaths have been reported from states of bihar, uttar pradesh & west bengal, thus raising the total death toll to 1012 from 999",lives,5,0,3,0,8,punjab
9/10/09,https://reliefweb.int/node/324067,"human deaths - as per provisional information received from the affected states/uts, 04 human deaths have been reported from states of uttar pradesh & west bengal, thus raising the total death toll to 999 from 995",lives,4,0,2,0,6,punjab
9/3/09,https://reliefweb.int/node/323143,"human deaths - as per provisional information received from the affected states/uts, 27 human deaths {uttarakhand -21(18 persons missing in pithoragarh landslide have been included in the death list by the state of uttarakhand), uttar pradesh -03, punjab -02 and west bengal -01} have been reported, thus raising the total death toll to 967 from 939",lives,8,4,2,0,14,punjab
8/18/09,https://reliefweb.int/node/320992,"- about 6,56,742 people are reported to have been affected",lives,17,11,32,0,60,sas nagar
8/18/09,https://reliefweb.int/node/320992,- 45 relief camps have been opened in the affected areas,lives,17,11,32,0,60,sas nagar
8/18/09,https://reliefweb.int/node/320992,- 02 relief camps have been opened in the affected areas,lives,17,11,32,0,60,sas nagar
8/18/09,https://reliefweb.int/node/320992,"- about 3,84,000 people are reported to have been affected",lives,17,11,32,0,60,sas nagar
8/18/09,https://reliefweb.int/node/320992,"- 1,26,000 ha cropped area are reported to have been affected",lives,17,11,32,0,60,sas nagar
8/18/09,https://reliefweb.int/node/320992,- 12547 houses have been damaged,lives,17,11,32,0,60,sas nagar
8/18/09,https://reliefweb.int/node/320992,- 62200 people have been evacuated so far,lives,17,11,32,0,60,sas nagar
8/18/09,https://reliefweb.int/node/320992,- 64346 people are accommodated in 80 relief camps,lives,17,11,32,0,60,sas nagar
8/18/09,https://reliefweb.int/node/320992,- 25906.24 ha cropped area are reported to have been affected,lives,17,11,32,0,60,sas nagar
8/18/09,https://reliefweb.int/node/320992,- 22196 houses have been damaged,lives,17,11,32,0,60,sas nagar
8/18/09,https://reliefweb.int/node/320992,- 2926 ha cropped area have affected,lives,17,11,32,0,60,sas nagar
8/18/09,https://reliefweb.int/node/320992,- 6122 houses have been damaged,lives,17,11,32,0,60,sas nagar
8/18/09,https://reliefweb.int/node/320992,- 24131 people are accommodated in 95 relief camps,lives,17,11,32,0,60,sas nagar
8/18/09,https://reliefweb.int/node/320992,- 10877 houses have been damaged,lives,17,11,32,0,60,sas nagar
8/18/09,https://reliefweb.int/node/320992,"human deaths - as per provisional information received from the affected states/uts, 02 human deaths (assam-01 & punjab-01) have been reported, thus raising the total death toll to 703 from 701",lives,17,11,32,0,60,sas nagar
8/18/09,https://reliefweb.int/node/320992,"ndma - total 06 coys & 08 teams of ndrf battalions have been deployed in the flood affected districts of assam (04-teams), bihar (01-coy & 02 teams), kerala (01-team), maharashtra (04-coys & 01-team) and west bengal (01-coy) for rescue and relief operations",lives,17,11,32,0,60,sas nagar
8/5/09,https://reliefweb.int/node/319788, - about 1.68 lakh people in 107 villages are reported to have been affected,lives,19,14,43,0,76,punjab
8/5/09,https://reliefweb.int/node/319788,- 10156 people have been evacuated so far,lives,19,14,43,0,76,punjab
8/5/09,https://reliefweb.int/node/319788,"- in sitamari district, a breach in the embankment of river bagmati near runi saidpur has been reported due to which, about 1.00 lakh people, 40 villages in 7-8 panchayat          are reported to have been affected",lives,19,14,43,0,76,punjab
8/5/09,https://reliefweb.int/node/319788,"about 40,000 people in 20 villages are reported to have been badly affected",lives,19,14,43,0,76,punjab
8/5/09,https://reliefweb.int/node/319788,- 200 people have been accommodated in 02 relief camps,lives,19,14,43,0,76,punjab
8/5/09,https://reliefweb.int/node/319788,"- 131 private boats, 18 government boats and 22 ndrf boats have been pressed into service for rescue and relief operations",lives,19,14,43,0,76,punjab
8/5/09,https://reliefweb.int/node/319788,"- about 3,84,000 people are reported to have been affected",lives,19,14,43,0,76,punjab
8/5/09,https://reliefweb.int/node/319788,"- 1,26,000 ha cropped area have been affected",lives,19,14,43,0,76,punjab
8/5/09,https://reliefweb.int/node/319788,- 7127 houses have been damaged,lives,19,14,43,0,76,punjab
8/5/09,https://reliefweb.int/node/319788,- 62200 people have been evacuated so far,lives,19,14,43,0,76,punjab
8/5/09,https://reliefweb.int/node/319788,- about 1220297 people are reported to have been affected,lives,19,14,43,0,76,punjab
8/5/09,https://reliefweb.int/node/319788,- 25906.24 ha cropped area have been affected,lives,19,14,43,0,76,punjab
8/5/09,https://reliefweb.int/node/319788,- 22138 houses have been damaged,lives,19,14,43,0,76,punjab
8/5/09,https://reliefweb.int/node/319788,"- about 6,33,981 people are reported to have been affected",lives,19,14,43,0,76,punjab
8/5/09,https://reliefweb.int/node/319788,- 2926 ha cropped area have been affected,lives,19,14,43,0,76,punjab
8/5/09,https://reliefweb.int/node/319788,- 5492 houses (fully-83 & partially-5409) have been damaged,lives,19,14,43,0,76,punjab
8/5/09,https://reliefweb.int/node/319788," - about 2,17,000 people in 252 villages and 14 districts are reported to have been affected",lives,19,14,43,0,76,punjab
8/5/09,https://reliefweb.int/node/319788,- 137230 ha cropped area have been affected,lives,19,14,43,0,76,punjab
8/5/09,https://reliefweb.int/node/319788,- 10877 houses have been damaged,lives,19,14,43,0,76,punjab
8/5/09,https://reliefweb.int/node/319788,"human deaths - as per provisional information received from the affected states/uts, 09 human deaths (tamil nadu-04, madhya pradesh-02, kerala, punjab and west bengal-01 each) have been reported, thus raising the total death toll to 636 from 627",lives,19,14,43,0,76,punjab
8/5/09,https://reliefweb.int/node/319788," ndma - total 08 coys & 04 teams of ndrf battalions have been deployed in the flood affected districts of assam (03-teams), bihar (03-coys), kerala (01-team), maharashtra (04-coys) and west bengal (01-coy) for rescue and relief operations",lives,19,14,43,0,76,punjab
7/29/09,https://reliefweb.int/node/318915," - about 1,64,000 people are reported to have been affected",lives,15,17,38,0,70,punjab
7/29/09,https://reliefweb.int/node/318915," - 77,728 ha cropped area have been affected",lives,15,17,38,0,70,punjab
7/29/09,https://reliefweb.int/node/318915,- 5926 houses have been damaged,lives,15,17,38,0,70,punjab
7/29/09,https://reliefweb.int/node/318915, - 8840 people have been evacuated so far,lives,15,17,38,0,70,punjab
7/29/09,https://reliefweb.int/node/318915, - 10770 people have been accommodated in 79 relief camps,lives,15,17,38,0,70,punjab
7/29/09,https://reliefweb.int/node/318915,- about 1217998 people are reported to have been affected,lives,15,17,38,0,70,punjab
7/29/09,https://reliefweb.int/node/318915, - 25689.38 ha cropped area have been affected,lives,15,17,38,0,70,punjab
7/29/09,https://reliefweb.int/node/318915, - 21580 houses have been damaged,lives,15,17,38,0,70,punjab
7/29/09,https://reliefweb.int/node/318915, - 147 people have been accommodated in 04 relief camps,lives,15,17,38,0,70,punjab
7/29/09,https://reliefweb.int/node/318915," - about 4,11,018 people are reported to have been affected",lives,15,17,38,0,70,punjab
7/29/09,https://reliefweb.int/node/318915, - 2926 ha cropped area have been affected,lives,15,17,38,0,70,punjab
7/29/09,https://reliefweb.int/node/318915,- 5382 houses have been damaged,lives,15,17,38,0,70,punjab
7/29/09,https://reliefweb.int/node/318915, - 18680 people have been accommodated in 95 relief camps,lives,15,17,38,0,70,punjab
7/29/09,https://reliefweb.int/node/318915, - 42 medical teams have also been deployed in the affected areas,lives,15,17,38,0,70,punjab
7/29/09,https://reliefweb.int/node/318915,- 1265 ha cropped area have been affected,lives,15,17,38,0,70,punjab
7/29/09,https://reliefweb.int/node/318915,- 5914 houses have been damaged,lives,15,17,38,0,70,punjab
7/29/09,https://reliefweb.int/node/318915, - 1308 people have been accommodated in 26 relief camps,lives,15,17,38,0,70,punjab
7/29/09,https://reliefweb.int/node/318915,- about 2.95 lakh population and 453 villages in 12 districts are reported to have been affected in the state due to flood so far,lives,15,17,38,0,70,punjab
7/29/09,https://reliefweb.int/node/318915, - 138 relief camps have also been opened in the affected areas,lives,15,17,38,0,70,punjab
7/29/09,https://reliefweb.int/node/318915," human deaths  - as per provisional information received from the affected states/uts, 26 human deaths (uttarakhand-19, kerala-04, punjab-02 & gujarat-01) have been reported, thus raising the total death toll to 555 from 529",lives,15,17,38,0,70,punjab
7/29/09,https://reliefweb.int/node/318915," ndma  - total 06 coys & 12 teams of ndrf battalions have been deployed in the flood affected districts of assam (04-teams), bihar (01-team & 01-coy), gujarat (03-teams), kerala (03-teams), maharashtra (04-coys & 01-team) and west bengal (01-coy) for rescue and relief operations",lives,15,17,38,0,70,punjab
6/10/09,https://reliefweb.int/node/312923,"deployment of national disaster response force (ndrf) on 9th june, 2009 in west bengal - 08 teams consisting of 247 personnel (officer -01, so -20 and ors -225) deployed in affected areas alongwith 69 boats, 30 life bouys and 83 life jackets for carrying out relief and rescue operation",lives,4,0,5,0,9,sas nagar
6/10/09,https://reliefweb.int/node/312923,"- relief material, 5200 ration pkgs of 500 grams each distributed till data - 09 bauts are on standby",lives,4,0,5,0,9,sas nagar
6/10/09,https://reliefweb.int/node/312923,"navy - diving team distributed a total of 2000 water packets at aamtoli, radhnagar and chhota mullakhali areas on 5th june 2009 - the diving team shifted to kolkata on 8th june 2009, following receding of water levels from the flood affected areas",lives,4,0,5,0,9,sas nagar
6/6/09,https://reliefweb.int/node/312402,"status of logistic support provided by the ministry of defence as on 5th june, 2009 to west bengal in view of cyclone ""aila"" army - 10 x medical teams dispatched to affected area on 03rd june, 2009 (fn)",lives,0,2,6,0,8,punjab
6/6/09,https://reliefweb.int/node/312402,"06 x medical teams reached affected areas by 1800 hrs on 3rd june, 2009",lives,0,2,6,0,8,punjab
6/6/09,https://reliefweb.int/node/312402,"navy - 04 x gemini boats alongwith 08 divers dispatched to affected areas at 1330 hrs on 02 june, 2009 - additional gemini is on standby at vizag",lives,0,2,6,0,8,punjab
6/6/09,https://reliefweb.int/node/312402,"air force - 03 helicopters carried out relief operations wef 26th may, 2009 till 30th may, 2009",lives,0,2,6,0,8,punjab
6/6/09,https://reliefweb.int/node/312402,36 sorties carried out and 71.64 tons relief materials airlifted,lives,0,2,6,0,8,punjab
9/21/08,https://reliefweb.int/node/281535,"- due to deep depression from 16.09.2008 to 18.09.2008, heavy to very heavy rainfall with widespread extremely heavy falls has been reported in several parts of the state causing floods and damages in various districts",lives,47,29,84,0,160,sas nagar
9/21/08,https://reliefweb.int/node/281535,- about 30.44 lakh population in 17 districts and in 2962 villages have been affected due to flood so far,lives,47,29,84,0,160,sas nagar
9/21/08,https://reliefweb.int/node/281535,- 45190 houses have also been damaged so far,lives,47,29,84,0,160,sas nagar
9/21/08,https://reliefweb.int/node/281535,- 1194 lakh ha crop area has also been damaged so far,lives,47,29,84,0,160,sas nagar
9/21/08,https://reliefweb.int/node/281535,- 689 relief camps are established in which about 240754 persons have been accommodated,lives,47,29,84,0,160,sas nagar
9/21/08,https://reliefweb.int/node/281535,- 58 medical teams have also been deployed in the affected areas for providing medical car,lives,47,29,84,0,160,sas nagar
9/21/08,https://reliefweb.int/node/281535,"- 02 sar (search & rescue) teams of ndrf consisting of 82 personnel (36 personnel in each team, and 10 support staff) have been deployed in kendrapara and jagatsinghpur districts alongwith 20 obms for rescue and relief operations",lives,47,29,84,0,160,sas nagar
9/21/08,https://reliefweb.int/node/281535,"- 137 relief camps are running in the affected districts of the state in which about 29,799 people have been accommodated",lives,47,29,84,0,160,sas nagar
9/21/08,https://reliefweb.int/node/281535,- 09 boats have been pressed into service in the affected areas for rescue and relief operations,lives,47,29,84,0,160,sas nagar
9/21/08,https://reliefweb.int/node/281535,- 332 state and 512 panchayat roads are reportedly damaged due to heavy rainfall in the state,lives,47,29,84,0,160,sas nagar
9/21/08,https://reliefweb.int/node/281535,"- as per information received from on telephone from state control room, 34 persons have lost their lives during last 48 hours due to landslides, heavy rains etc",lives,47,29,84,0,160,sas nagar
9/21/08,https://reliefweb.int/node/281535,- 8210 people have been affected in state so far due to heavy rainfall and landslides,lives,47,29,84,0,160,sas nagar
9/21/08,https://reliefweb.int/node/281535,- 490 people have been evacuated from champawat district to safer places,lives,47,29,84,0,160,sas nagar
9/21/08,https://reliefweb.int/node/281535,"- in all, about 45,74,000 people from 2528 villages in 18 districts have been affected due to flood in the state",lives,47,29,84,0,160,sas nagar
9/21/08,https://reliefweb.int/node/281535,"- 3,19,669 houses are reported to have been damaged due to flood so far",lives,47,29,84,0,160,sas nagar
9/21/08,https://reliefweb.int/node/281535,- 3654 boats have been pressed into service for rescue and relief operations in the flood affected areas of the state,lives,47,29,84,0,160,sas nagar
9/21/08,https://reliefweb.int/node/281535,- 1028345 persons have been evacuated from the affected areas so far,lives,47,29,84,0,160,sas nagar
9/21/08,https://reliefweb.int/node/281535,"- 372 relief camps have been opened in the flood affected area in which 3,85932 people have been accommodated",lives,47,29,84,0,160,sas nagar
9/21/08,https://reliefweb.int/node/281535,- 189 cattle camps are opened in the affected areas in which about 54230 animals accommodated,lives,47,29,84,0,160,sas nagar
9/21/08,https://reliefweb.int/node/281535,- 177 medical teams have been deployed in the affected areas of the state,lives,47,29,84,0,160,sas nagar
9/21/08,https://reliefweb.int/node/281535,- 409 health centre have also been opened in the flood affected areas of the state for providing medical care,lives,47,29,84,0,160,sas nagar
9/21/08,https://reliefweb.int/node/281535,"- in all, 25,75,500 people from 4,741 villages in 23 districts have been affected severely and 732 villages marooned in the state so far due to flood",lives,47,29,84,0,160,sas nagar
9/21/08,https://reliefweb.int/node/281535,"- about 3,40,761 houses have been damaged so far",lives,47,29,84,0,160,sas nagar
9/21/08,https://reliefweb.int/node/281535,"- about 57,425 people from the affected areas have been evacuated so far",lives,47,29,84,0,160,sas nagar
9/21/08,https://reliefweb.int/node/281535,- 4.22 lakh ha areas have been damaged so far,lives,47,29,84,0,160,sas nagar
9/21/08,https://reliefweb.int/node/281535,- 441 relief camps have been opened in the flood affected areas in which 48182 people have been accommodated,lives,47,29,84,0,160,sas nagar
9/21/08,https://reliefweb.int/node/281535,"- 4,330 boats have been pressed into service for rescue and relief operations in the affected areas",lives,47,29,84,0,160,sas nagar
9/21/08,https://reliefweb.int/node/281535,- 183 mobile teams of doctors along with medicines have been deployed in the flood affected areas for providing medical care,lives,47,29,84,0,160,sas nagar
9/21/08,https://reliefweb.int/node/281535,"- about 38.76 lakh people, in all, are reported to have been affected in the state due to flood so far",lives,47,29,84,0,160,sas nagar
9/21/08,https://reliefweb.int/node/281535,- 119858 ha cropped areas has been damaged,lives,47,29,84,0,160,sas nagar
9/21/08,https://reliefweb.int/node/281535,- about 8913 people have been evacuated to the safer places,lives,47,29,84,0,160,sas nagar
9/21/08,https://reliefweb.int/node/281535,- 37 relief centres are opened in which about 10247 people have been accommodated,lives,47,29,84,0,160,sas nagar
9/21/08,https://reliefweb.int/node/281535,- about 20.00 lakh people have been affected in 21 districts and 1524 villages in the state due to flood so far,lives,47,29,84,0,160,sas nagar
9/21/08,https://reliefweb.int/node/281535,- 32067 people continued to be accommodated in 178 relief camps in the flood affected areas of the state,lives,47,29,84,0,160,sas nagar
9/21/08,https://reliefweb.int/node/281535,- 85 boats continued to be deployed in the state for relief and rescue operations,lives,47,29,84,0,160,sas nagar
9/21/08,https://reliefweb.int/node/281535,"- 33,704 people have been evacuated from the affected areas and shifted to safer places",lives,47,29,84,0,160,sas nagar
9/21/08,https://reliefweb.int/node/281535,"human deaths - as per provisional information received from the affected states/uts, 135 human deaths were reported, raising the total death toll to 2364 from 2210 during the last 48 hours",lives,47,29,84,0,160,sas nagar
9/20/08,https://reliefweb.int/node/281294,"- due to deep depression from 16.09.2008 to 18.09.2008, heavy to very heavy rainfall with widespread extremely heavy falls has been reported in several parts of the state causing floods and damages in various districts",lives,46,21,89,0,156,punjab
9/20/08,https://reliefweb.int/node/281294,- about 19.83 lakh population in 15 districts and in 2606 villages have been affected due to flood so far,lives,46,21,89,0,156,punjab
9/20/08,https://reliefweb.int/node/281294,- 45190 houses have also been damaged so far,lives,46,21,89,0,156,punjab
9/20/08,https://reliefweb.int/node/281294,- 1194 ha crop area has also been damaged so far,lives,46,21,89,0,156,punjab
9/20/08,https://reliefweb.int/node/281294,- in 441 relief camps about 150386 persons have been accommodated,lives,46,21,89,0,156,punjab
9/20/08,https://reliefweb.int/node/281294,"- relief has been provided to 19,83,131 people so far in the affected areas",lives,46,21,89,0,156,punjab
9/20/08,https://reliefweb.int/node/281294,"- 79,203 people have been evacuated so far",lives,46,21,89,0,156,punjab
9/20/08,https://reliefweb.int/node/281294,- 55 medical teams have also been deployed in the affected areas,lives,46,21,89,0,156,punjab
9/20/08,https://reliefweb.int/node/281294,"- 02 sar (search & rescue) teams of ndrf consisting of 82 personnel (36 personnel in each team, and 10 support staff) have been deployed in kendrapara and jagatsinghpur districts alongwith 20 obms for rescue and relief operations",lives,46,21,89,0,156,punjab
9/20/08,https://reliefweb.int/node/281294,- 02 sar (search & rescue) teams of ndrf alongwith 25 obms are likely to reach orissa from bihar by today night and they will be deployed in cuttack and puri districts for rescue and relief operations from 21.09.2008,lives,46,21,89,0,156,punjab
9/20/08,https://reliefweb.int/node/281294,- about 18.56 lakh people in 15 districts and in 121 villages have been affected due to flood so far,lives,46,21,89,0,156,punjab
9/20/08,https://reliefweb.int/node/281294,"- in 137 relief camps about 29,799 people have been accommodated",lives,46,21,89,0,156,punjab
9/20/08,https://reliefweb.int/node/281294,- 09 boats have been pressed into service in the affected areas,lives,46,21,89,0,156,punjab
9/20/08,https://reliefweb.int/node/281294,- 332 state and 512 panchayat roads are reportedly damaged due to heavy rainfall in the state,lives,46,21,89,0,156,punjab
9/20/08,https://reliefweb.int/node/281294,"- 6149 feeders, 590 transformers and 4322 electricity poles in 12908 villages have been damaged",lives,46,21,89,0,156,punjab
9/20/08,https://reliefweb.int/node/281294,- 330 medical teams consisting of 136 medical officers and 1035 paramedical staff have been deployed in the affected areas,lives,46,21,89,0,156,punjab
9/20/08,https://reliefweb.int/node/281294,"- about 45,72,000 people from 2502 villages in 18 have been affected due to flood in the state",lives,46,21,89,0,156,punjab
9/20/08,https://reliefweb.int/node/281294,"- 3,19,569 houses are reported to have been damaged due to flood so far",lives,46,21,89,0,156,punjab
9/20/08,https://reliefweb.int/node/281294,- 3521 boats have been pressed into service for rescue and relief operations,lives,46,21,89,0,156,punjab
9/20/08,https://reliefweb.int/node/281294,- 1028345 persons have been evacuated from the affected areas so far,lives,46,21,89,0,156,punjab
9/20/08,https://reliefweb.int/node/281294,"- in 372 relief camps about 3,71,100 people have been accommodated",lives,46,21,89,0,156,punjab
9/20/08,https://reliefweb.int/node/281294,- 177 medical teams have been deployed in the affected areas of the state,lives,46,21,89,0,156,punjab
9/20/08,https://reliefweb.int/node/281294,- 409 health centre have also been opened in the flood affected areas,lives,46,21,89,0,156,punjab
9/20/08,https://reliefweb.int/node/281294,"- about 25,75,498 people from 4,741 villages in 23 districts have been affected severely",lives,46,21,89,0,156,punjab
9/20/08,https://reliefweb.int/node/281294,"- about 3,31,265 houses have been damaged so far",lives,46,21,89,0,156,punjab
9/20/08,https://reliefweb.int/node/281294,"- about 57,425 people from the affected areas have been evacuated so far",lives,46,21,89,0,156,punjab
9/20/08,https://reliefweb.int/node/281294,- 4.22 lakh ha areas have been damaged so far,lives,46,21,89,0,156,punjab
9/20/08,https://reliefweb.int/node/281294,- in 441 relief camps about 48182 people have been accommodated,lives,46,21,89,0,156,punjab
9/20/08,https://reliefweb.int/node/281294,"- 4,330 boats and 183 mobile teams of doctors along with medicines continued to be deployed in the flood affected areas",lives,46,21,89,0,156,punjab
9/20/08,https://reliefweb.int/node/281294,- 17 companies of pac have been deployed with 184 motorized boats and 88 wooden boats in the affected areas for relief and rescue operations,lives,46,21,89,0,156,punjab
9/20/08,https://reliefweb.int/node/281294,"as a result, several villages in the districts of poorva medinipur, south 24 pargana and north 24 pargana are reported to have been affected severally",lives,46,21,89,0,156,punjab
9/20/08,https://reliefweb.int/node/281294,- about 38.76 lakh people have been affected in the state due to flood so far,lives,46,21,89,0,156,punjab
9/20/08,https://reliefweb.int/node/281294,- 119858 ha cropped areas has been damaged,lives,46,21,89,0,156,punjab
9/20/08,https://reliefweb.int/node/281294,- about 8913 people have been evacuated to the safer places,lives,46,21,89,0,156,punjab
9/20/08,https://reliefweb.int/node/281294,- in 37 relief centres about 10247 people have been accommodated,lives,46,21,89,0,156,punjab
9/20/08,https://reliefweb.int/node/281294,- 418099 houses have been damaged due to flood so far,lives,46,21,89,0,156,punjab
9/20/08,https://reliefweb.int/node/281294,- about 20.00 lakh people have been affected in 21 districts and 1524 villages in the state due to flood so far,lives,46,21,89,0,156,punjab
9/20/08,https://reliefweb.int/node/281294,- 32067 people continued to be accommodated in 178 relief camps,lives,46,21,89,0,156,punjab
9/20/08,https://reliefweb.int/node/281294,- 85 boats continued to be deployed in the state for relief and rescue operations,lives,46,21,89,0,156,punjab
9/20/08,https://reliefweb.int/node/281294,"- 33,704 people have been evacuated from the affected areas and shifted to safer places",lives,46,21,89,0,156,punjab
9/20/08,https://reliefweb.int/node/281294,"human deaths - as per provisional information received from the affected states/uts, 19 human deaths were reported, raising the total death toll to 2229 from 2210",lives,46,21,89,0,156,punjab
9/9/08,https://reliefweb.int/node/279984,"consolidated report on india floods  situation according to the updated report of the disaster management division of the ministry of home affairs, so far, incessant rains and flash floods have engulfed 1906 human lives, affected a population of 199,69326, estimated livestock loss is 19940 and demolished/damaged 583255 houses in 13634 villages of 117 districts across the country",lives,30,8,38,7,83,punjab
9/9/08,https://reliefweb.int/node/279984,so far 40.37 lakh people from 2319 villages in 16 districts have been affected,lives,30,8,38,7,83,punjab
9/9/08,https://reliefweb.int/node/279984,over ten lakh-marooned people were evacuated and shifted to safer places,lives,30,8,38,7,83,punjab
9/9/08,https://reliefweb.int/node/279984,about three lakh people have taken shelter in 350 relief camps,lives,30,8,38,7,83,punjab
9/9/08,https://reliefweb.int/node/279984,"earlier the prime minister, after an aerial survey, announced bihar floods a national calamity and announced a relief package of 1,000 crore of rupees and ordered release of over a lakh of tones of food grains",lives,30,8,38,7,83,punjab
9/9/08,https://reliefweb.int/node/279984,who has contributed half a million rupees to meet operational costs,lives,30,8,38,7,83,punjab
9/9/08,https://reliefweb.int/node/279984,nine watsan units are placed at the disposal of the state branch to meet the water & sanitation requirements in the affected areas,lives,30,8,38,7,83,punjab
9/9/08,https://reliefweb.int/node/279984,"in katihar district, the reliance club with the help of red cross volunteers prepared 10,000 food packets consisting of chura, sattu, gur, candle and blankets and distributed them among the flood victims",lives,30,8,38,7,83,punjab
9/9/08,https://reliefweb.int/node/279984,"a uk based organization, divine omkar mission, together with red cross district branch distributed one truck load of relief materials in village belli",lives,30,8,38,7,83,punjab
9/9/08,https://reliefweb.int/node/279984,in bhagalpur district there are four dharamshalas where community kitchens are being run with the help of red cross volunteers,lives,30,8,38,7,83,punjab
9/9/08,https://reliefweb.int/node/279984,assam the state branch has reported that 21 out of 28 districts in the state are affected by floods,lives,30,8,38,7,83,punjab
9/9/08,https://reliefweb.int/node/279984,a total of 5.5 lakh people are marooned and two lakh displaced are living in 400 relief camps,lives,30,8,38,7,83,punjab
9/9/08,https://reliefweb.int/node/279984,"it also mobilized its members and volunteers, numbering 1500 to help in rescue, medical and relief distribution activities",lives,30,8,38,7,83,punjab
9/9/08,https://reliefweb.int/node/279984,"the state branch has requested for 60,000 family packs and rs.16.6 lakhs to cover the operational costs",lives,30,8,38,7,83,punjab
9/7/08,https://reliefweb.int/node/279521,- about 38.28 lakh people from 2155 villages in 16 districts have been affected so far,lives,25,11,42,0,78,punjab
9/7/08,https://reliefweb.int/node/279521,"- 3,14,756 houses have been damaged due to flood so far",lives,25,11,42,0,78,punjab
9/7/08,https://reliefweb.int/node/279521,- 3358 boats have been pressed into service in the flood affected areas,lives,25,11,42,0,78,punjab
9/7/08,https://reliefweb.int/node/279521,"- 9,20,787 persons have been evacuated from the affected areas so far",lives,25,11,42,0,78,punjab
9/7/08,https://reliefweb.int/node/279521,"- in 343 relief camps about 2,82,014 people accommodated",lives,25,11,42,0,78,punjab
9/7/08,https://reliefweb.int/node/279521,- 177 medical teams continued to be deployed in the affected areas,lives,25,11,42,0,78,punjab
9/7/08,https://reliefweb.int/node/279521,- 341 health centre have also been opened in the flood affected areas,lives,25,11,42,0,78,punjab
9/7/08,https://reliefweb.int/node/279521,"- 23,75,775 people from 4,587 villages in 21 districts have been affected severely",lives,25,11,42,0,78,punjab
9/7/08,https://reliefweb.int/node/279521,"- about 1,53,484 houses have been damaged so far",lives,25,11,42,0,78,punjab
9/7/08,https://reliefweb.int/node/279521,"- about 46,209 people have been evacuated so far",lives,25,11,42,0,78,punjab
9/7/08,https://reliefweb.int/node/279521,- 2.27 lakh ha areas have been damaged so far,lives,25,11,42,0,78,punjab
9/7/08,https://reliefweb.int/node/279521,- 479 relief camps have been opened in the flood affected areas in which 39960 people have been accommodated,lives,25,11,42,0,78,punjab
9/7/08,https://reliefweb.int/node/279521,"- 4,354 boats and 183 mobile teams of doctors along with medicines continued to be deployed in the flood affected areas",lives,25,11,42,0,78,punjab
9/7/08,https://reliefweb.int/node/279521,- about 13.24 lakh people have been affected in 15 districts and 1822 villages in the state due to flood so far,lives,25,11,42,0,78,punjab
9/7/08,https://reliefweb.int/node/279521,- in 20350 people continued to be accommodated in 134 relief camps,lives,25,11,42,0,78,punjab
9/7/08,https://reliefweb.int/node/279521,- 85 boats continued to be deployed in the affected areas,lives,25,11,42,0,78,punjab
9/7/08,https://reliefweb.int/node/279521,"- 33,700 people have been evacuated so far",lives,25,11,42,0,78,punjab
9/7/08,https://reliefweb.int/node/279521,- about 37.92 lakh people have been affected in the state so far,lives,25,11,42,0,78,punjab
9/7/08,https://reliefweb.int/node/279521,- in 07 relief camps about 1252 people have been accommodated - 154 medical teams and 31 boats continued to be deployed,lives,25,11,42,0,78,punjab
9/7/08,https://reliefweb.int/node/279521,- 119858 ha cropped areas has been damaged,lives,25,11,42,0,78,punjab
9/7/08,https://reliefweb.int/node/279521,- 406511 houses have been damaged due to flood so far,lives,25,11,42,0,78,punjab
9/7/08,https://reliefweb.int/node/279521,"human deaths  - as per provisional information received from the affected states/uts, 08 human deaths (bihar -06 and kerala-02) were reported, raising the total death toll to 1884 to 1876",lives,25,11,42,0,78,punjab
9/6/08,https://reliefweb.int/node/280844,"- in all, about 37.54 lakh people from 1955 villages in 16 districts (muzaffarpur, supaul, patna, katihar, nalanda, araria, west champaran, shekhpura, saharsa, purnea, saran, begusarai, bhagalpur, madhepura, vaishall and khagaria) have been affected due to flood in the state",lives,26,13,53,0,92,punjab
9/6/08,https://reliefweb.int/node/280844,"- 3,04,745 houses are reported to have been damaged due to flood so far",lives,26,13,53,0,92,punjab
9/6/08,https://reliefweb.int/node/280844,- 3190 boats have been pressed into service for rescue and relief operations in the flood affected areas of the state,lives,26,13,53,0,92,punjab
9/6/08,https://reliefweb.int/node/280844,"- 8,74,527 persons have been evacuated from the affected areas so far",lives,26,13,53,0,92,punjab
9/6/08,https://reliefweb.int/node/280844,"- 330 relief camps have been opened in the flood affected area in which 2,77,731 people have been accommodated",lives,26,13,53,0,92,punjab
9/6/08,https://reliefweb.int/node/280844,- 100 cattle camps are opened in the affected areas in which about 15160 animals accommodated,lives,26,13,53,0,92,punjab
9/6/08,https://reliefweb.int/node/280844,- 177 medical teams have been deployed in the affected areas of the state,lives,26,13,53,0,92,punjab
9/6/08,https://reliefweb.int/node/280844,"- in all, 23,75,775 people from 4,587 villages in 21 districts have been affected severely and 732 villages marooned in the state so far due to flood",lives,26,13,53,0,92,punjab
9/6/08,https://reliefweb.int/node/280844,"- about 1,53,484 houses have been damaged so far",lives,26,13,53,0,92,punjab
9/6/08,https://reliefweb.int/node/280844,"- about 46,209 people from the affected areas have been evacuated so far",lives,26,13,53,0,92,punjab
9/6/08,https://reliefweb.int/node/280844,- 479 relief camps have been opened in the flood affected areas in which 39960 people have been accommodated,lives,26,13,53,0,92,punjab
9/6/08,https://reliefweb.int/node/280844,"- 4,354 boats have been pressed into service for rescue and relief operations in the affected areas",lives,26,13,53,0,92,punjab
9/6/08,https://reliefweb.int/node/280844,- 183 mobile teams of doctors along with medicines have been deployed in the flood affected areas for providing medical care,lives,26,13,53,0,92,punjab
9/6/08,https://reliefweb.int/node/280844,- about 12.00 lakh people have been affected in 14 districts and 1822 villages in the state due to flood so far,lives,26,13,53,0,92,punjab
9/6/08,https://reliefweb.int/node/280844,- 20350 people continued to be accommodated in 134 relief camps in the flood affected areas of the state,lives,26,13,53,0,92,punjab
9/6/08,https://reliefweb.int/node/280844,- 85 boats continued to be deployed in the state for relief and rescue operations,lives,26,13,53,0,92,punjab
9/6/08,https://reliefweb.int/node/280844,"- 33,700 people have been evacuated from the affected areas and shifted to safer places",lives,26,13,53,0,92,punjab
9/6/08,https://reliefweb.int/node/280844,"- about 37.92 lakh people, in all, are reported to have been affected in the state due to flood so far",lives,26,13,53,0,92,punjab
9/6/08,https://reliefweb.int/node/280844,- 07 relief camps opened in the state in which about 1252 people have been accommodated - 154 medical teams and 31 boats continued to be deployed in the affected areas of the state,lives,26,13,53,0,92,punjab
9/6/08,https://reliefweb.int/node/280844,- 119858 ha cropped areas has been damaged,lives,26,13,53,0,92,punjab
9/6/08,https://reliefweb.int/node/280844,- 406511 houses (240398 fully and 166113 partially) are reported to have been damaged due to flood so far,lives,26,13,53,0,92,punjab
9/6/08,https://reliefweb.int/node/280844,"human deaths - as per provisional information received from the affected states/uts, 10 human deaths (uttar pradesh -07 and bihar -03) were reported, raising the total death toll to 1876 to 1866",lives,26,13,53,0,92,punjab
9/3/08,https://reliefweb.int/node/278859,"according to government figures, vast areas of agricultural land have been inundated and a large number of houses have collapsed or been destroyed (597,000 houses have been fully damaged while 418,497 houses have been partially damaged)",lives,49,30,91,1,171,"amritsar, gurdaspur, hoshiarpur, jalandhar, kapurthala, moga, sas nagar"
9/3/08,https://reliefweb.int/node/278859,"with over 18.6 million people affected across india and 1,778 people killed, it has been a major blow to the country's economy and people",lives,49,30,91,1,171,"amritsar, gurdaspur, hoshiarpur, jalandhar, kapurthala, moga, sas nagar"
9/3/08,https://reliefweb.int/node/278859,"latest reports from the ministry of home affairs indicate that over 3.3 million people from 1,849 villages in 16 districts of the state have been affected",lives,49,30,91,1,171,"amritsar, gurdaspur, hoshiarpur, jalandhar, kapurthala, moga, sas nagar"
9/3/08,https://reliefweb.int/node/278859,"the state government has said that all marooned people will be evacuated within three days (approximately 497,300 people have been evacuated so far)",lives,49,30,91,1,171,"amritsar, gurdaspur, hoshiarpur, jalandhar, kapurthala, moga, sas nagar"
9/3/08,https://reliefweb.int/node/278859," in severely hit supaul district, approximately 893,790 people in 243 villages have been affected, and 22,000 people are living in 36 relief camps",lives,49,30,91,1,171,"amritsar, gurdaspur, hoshiarpur, jalandhar, kapurthala, moga, sas nagar"
9/3/08,https://reliefweb.int/node/278859,"around 65,000 people have been evacuated with the help of 229 local boats and 12 motor boats",lives,49,30,91,1,171,"amritsar, gurdaspur, hoshiarpur, jalandhar, kapurthala, moga, sas nagar"
9/3/08,https://reliefweb.int/node/278859,"a total of 223,446 houses (temporary and permanent) have been destroyed and 13,550 cattle have 2 been lost",lives,49,30,91,1,171,"amritsar, gurdaspur, hoshiarpur, jalandhar, kapurthala, moga, sas nagar"
9/3/08,https://reliefweb.int/node/278859,the total land under crops that has been damaged is 0.14 million hectares,lives,49,30,91,1,171,"amritsar, gurdaspur, hoshiarpur, jalandhar, kapurthala, moga, sas nagar"
9/3/08,https://reliefweb.int/node/278859," in madhepura district, over 1 million people have been severely affected in 378 villages across 11 administrative blocks, and water logging continues to be at a level of 3-8 feet",lives,49,30,91,1,171,"amritsar, gurdaspur, hoshiarpur, jalandhar, kapurthala, moga, sas nagar"
9/3/08,https://reliefweb.int/node/278859,"presently 40 relief camps are being run in which more than 27,884 people are taking shelter",lives,49,30,91,1,171,"amritsar, gurdaspur, hoshiarpur, jalandhar, kapurthala, moga, sas nagar"
9/3/08,https://reliefweb.int/node/278859,"more than 95,000 people have been evacuated in the district with the help of 177 local boats and 25 motor boats",lives,49,30,91,1,171,"amritsar, gurdaspur, hoshiarpur, jalandhar, kapurthala, moga, sas nagar"
9/3/08,https://reliefweb.int/node/278859,the government and other civil agencies have set up almost 20 animal camps for protecting cattle and 40 medical centres for providing immediate medical aid to the affected people,lives,49,30,91,1,171,"amritsar, gurdaspur, hoshiarpur, jalandhar, kapurthala, moga, sas nagar"
9/3/08,https://reliefweb.int/node/278859," in araria district, over 0.25 million people have been affected in 30 villages",lives,49,30,91,1,171,"amritsar, gurdaspur, hoshiarpur, jalandhar, kapurthala, moga, sas nagar"
9/3/08,https://reliefweb.int/node/278859,"presently 33 relief camps are functioning and providing shelter to approximately 30,000 people",lives,49,30,91,1,171,"amritsar, gurdaspur, hoshiarpur, jalandhar, kapurthala, moga, sas nagar"
9/3/08,https://reliefweb.int/node/278859,"about 15,000 people have been evacuated with the help of 35 boats",lives,49,30,91,1,171,"amritsar, gurdaspur, hoshiarpur, jalandhar, kapurthala, moga, sas nagar"
9/3/08,https://reliefweb.int/node/278859,"in addition, 33 medical centres for the affected population and 33 cattle camps have been set up",lives,49,30,91,1,171,"amritsar, gurdaspur, hoshiarpur, jalandhar, kapurthala, moga, sas nagar"
9/3/08,https://reliefweb.int/node/278859," in saharsa district as well, over 0.25 million people have been affected in 35 villages",lives,49,30,91,1,171,"amritsar, gurdaspur, hoshiarpur, jalandhar, kapurthala, moga, sas nagar"
9/3/08,https://reliefweb.int/node/278859,"presently, 7,000 people have been evacuated and provided shelter in 30 relief camps",lives,49,30,91,1,171,"amritsar, gurdaspur, hoshiarpur, jalandhar, kapurthala, moga, sas nagar"
9/3/08,https://reliefweb.int/node/278859,"about 7,000 people have been evacuated with 35 local boats",lives,49,30,91,1,171,"amritsar, gurdaspur, hoshiarpur, jalandhar, kapurthala, moga, sas nagar"
9/3/08,https://reliefweb.int/node/278859,"in katihaar district, 62,015 people have been affected in 63 villages out of which 20 villages are marooned",lives,49,30,91,1,171,"amritsar, gurdaspur, hoshiarpur, jalandhar, kapurthala, moga, sas nagar"
9/3/08,https://reliefweb.int/node/278859,a total of 439 boats have been pressed into service for relief and rescue efforts in the district,lives,49,30,91,1,171,"amritsar, gurdaspur, hoshiarpur, jalandhar, kapurthala, moga, sas nagar"
9/3/08,https://reliefweb.int/node/278859," in purnia district, about 150,000 people have been affected in 20 administrative blocks and six relief camps are being set up, accommodating several people",lives,49,30,91,1,171,"amritsar, gurdaspur, hoshiarpur, jalandhar, kapurthala, moga, sas nagar"
9/3/08,https://reliefweb.int/node/278859,"in the state of uttar pradesh 2.2 million people have been affected in 4,461 villages in 21 districts and 732 villages are still marooned",lives,49,30,91,1,171,"amritsar, gurdaspur, hoshiarpur, jalandhar, kapurthala, moga, sas nagar"
9/3/08,https://reliefweb.int/node/278859,"over 0.15 million houses have been destroyed and more than 37,000 people are still taking shelter in 438 relief camps",lives,49,30,91,1,171,"amritsar, gurdaspur, hoshiarpur, jalandhar, kapurthala, moga, sas nagar"
9/3/08,https://reliefweb.int/node/278859,"since the floods began, 34,980 people have been evacuated with the help of about 4,000 boats",lives,49,30,91,1,171,"amritsar, gurdaspur, hoshiarpur, jalandhar, kapurthala, moga, sas nagar"
9/3/08,https://reliefweb.int/node/278859,178 mobile medical teams have been pressed into service in order to assist the affected people,lives,49,30,91,1,171,"amritsar, gurdaspur, hoshiarpur, jalandhar, kapurthala, moga, sas nagar"
9/3/08,https://reliefweb.int/node/278859," in assam, the situation is slowly returning to normal as no significant rainfall has been reported in the past 24 hours though about 0.79 million people have been affected",lives,49,30,91,1,171,"amritsar, gurdaspur, hoshiarpur, jalandhar, kapurthala, moga, sas nagar"
9/3/08,https://reliefweb.int/node/278859,"approximately 20,350 people are still to be accommodated in 132 relief camps in the state",lives,49,30,91,1,171,"amritsar, gurdaspur, hoshiarpur, jalandhar, kapurthala, moga, sas nagar"
9/3/08,https://reliefweb.int/node/278859," in punjab, so far 11 districts have been affected, including ropar, jalandhar, moga, kapurthala, tarantaran, ferozpur, amritsar, mukatsar, hoshiarpur, mohali and gurdaspur",lives,49,30,91,1,171,"amritsar, gurdaspur, hoshiarpur, jalandhar, kapurthala, moga, sas nagar"
9/3/08,https://reliefweb.int/node/278859,the total number of people affected in the state is 0.19 million in 872 villages,lives,49,30,91,1,171,"amritsar, gurdaspur, hoshiarpur, jalandhar, kapurthala, moga, sas nagar"
9/3/08,https://reliefweb.int/node/278859,"about 8,615 people have been evacuated in four districts",lives,49,30,91,1,171,"amritsar, gurdaspur, hoshiarpur, jalandhar, kapurthala, moga, sas nagar"
9/3/08,https://reliefweb.int/node/278859,"a total of 184,132 hectares of cropped land has been affected",lives,49,30,91,1,171,"amritsar, gurdaspur, hoshiarpur, jalandhar, kapurthala, moga, sas nagar"
9/3/08,https://reliefweb.int/node/278859,"approximately 3.7 million people have been affected and 119,852 hectares of cropped land has been destroyed",lives,49,30,91,1,171,"amritsar, gurdaspur, hoshiarpur, jalandhar, kapurthala, moga, sas nagar"
9/3/08,https://reliefweb.int/node/278859,a total of 152 medical teams have been deployed and 26 boats have been pressed into service for rescue and relief,lives,49,30,91,1,171,"amritsar, gurdaspur, hoshiarpur, jalandhar, kapurthala, moga, sas nagar"
9/1/08,https://reliefweb.int/node/278555,"- in supaul district, about 8,93,790 people in 243 villages have been badly affected",lives,38,19,78,0,135,punjab
9/1/08,https://reliefweb.int/node/278555,"- in madhepura district, about 10.22 lakh people in 378 villages have been badly affected",lives,38,19,78,0,135,punjab
9/1/08,https://reliefweb.int/node/278555,126 panchayats have been affected severely,lives,38,19,78,0,135,punjab
9/1/08,https://reliefweb.int/node/278555,"- in araria district, about 2.50 lakh people in 30 villages have been badly affected",lives,38,19,78,0,135,punjab
9/1/08,https://reliefweb.int/node/278555,"- in saharsa district, about 2.50 lakh people in 07 panchayats and in 35 villages have been badly affected",lives,38,19,78,0,135,punjab
9/1/08,https://reliefweb.int/node/278555,"- in katihar district, about 62,015 people in 13 blocks, 26 villages and in 63 villages have been badly affected",lives,38,19,78,0,135,punjab
9/1/08,https://reliefweb.int/node/278555,"- in purnia district, about 1,50,000 people in 20 panchayats have been badly affected",lives,38,19,78,0,135,punjab
9/1/08,https://reliefweb.int/node/278555,"- about 31,29,000 people from 1778 villages in 16 districts have been affected so far",lives,38,19,78,0,135,punjab
9/1/08,https://reliefweb.int/node/278555,"- 2,97,958 houses are reported to have been damaged so far",lives,38,19,78,0,135,punjab
9/1/08,https://reliefweb.int/node/278555,"- 4,97,289 persons have been evacuated so far",lives,38,19,78,0,135,punjab
9/1/08,https://reliefweb.int/node/278555,"- in 193 relief camps about 1,22,002 people accommodated",lives,38,19,78,0,135,punjab
9/1/08,https://reliefweb.int/node/278555,- 184 health centre have also been opened in the flood affected areas,lives,38,19,78,0,135,punjab
9/1/08,https://reliefweb.int/node/278555,"relief assistance provided by government of india ndrf -16 teams of ndrf (about 701 personnel) alongwith 102 motorized boats (from ndrf-87, bsf-06 & ssb-09) deployed in supaul, madhepura, araria, mudali and purnia districts for flood and relief duties",lives,38,19,78,0,135,punjab
9/1/08,https://reliefweb.int/node/278555,navy - two relief teams ex vishakhapatnam and mumbai have been deployed for rescue & relief operations in kumarkhand and balmanki areas,lives,38,19,78,0,135,punjab
9/1/08,https://reliefweb.int/node/278555,each relief team comprises of 45 personnel and 15 geminies with obms,lives,38,19,78,0,135,punjab
9/1/08,https://reliefweb.int/node/278555,"air force - four mi-17 helicopters lifted 22 passengers and dropped 51.15 tons of relief material in 18 sorties in purnea, mathapura, chhattarpur, muraliganj and gopalpur areas",lives,38,19,78,0,135,punjab
9/1/08,https://reliefweb.int/node/278555,"- two mi-8 helicopters lifted 26 passengers and dropped 12.10 tons of relief material in 08 sorties in triveniganj, kishanganj, madhepura and kumarkhand areas",lives,38,19,78,0,135,punjab
9/1/08,https://reliefweb.int/node/278555,"- four il-76 in 13 sorties moved 150 passengers and 71.2 ton load of army columns and relief equipment from bhopal, sarsawa, chandigarh and agra to purnea on 31st august, 2008",lives,38,19,78,0,135,punjab
9/1/08,https://reliefweb.int/node/278555,"- thirteen an-32 aircraft were utilized for movement of rescue teams, boats, geminies and other relief equipment",lives,38,19,78,0,135,punjab
9/1/08,https://reliefweb.int/node/278555,-two avro aircraft in 07 sorties moved 37 passengers and 4.03 ton load of rescue teams and relief equipment from bhuj and allahabad to purnea,lives,38,19,78,0,135,punjab
9/1/08,https://reliefweb.int/node/278555,"- a total of 166.98 tons of relief equipment/material and 823 passengers were airlifted in 92 sorties on 31st august, 2008",lives,38,19,78,0,135,punjab
9/1/08,https://reliefweb.int/node/278555,"- about 22,01,317 people in 4,461 villages affected severely",lives,38,19,78,0,135,punjab
9/1/08,https://reliefweb.int/node/278555,"- 1,15,159 houses have been damaged so far",lives,38,19,78,0,135,punjab
9/1/08,https://reliefweb.int/node/278555,"- about 34,980 people have been evacuated so far",lives,38,19,78,0,135,punjab
9/1/08,https://reliefweb.int/node/278555,"- 4,023 lakh ha areas have been damaged so far",lives,38,19,78,0,135,punjab
9/1/08,https://reliefweb.int/node/278555,"- in 438 relief camps about 37,141 people have been accommodated",lives,38,19,78,0,135,punjab
9/1/08,https://reliefweb.int/node/278555,"- 4,046 boats and 78 mobile teams of doctors along with medicines continued to be deployed in the flood affected areas",lives,38,19,78,0,135,punjab
9/1/08,https://reliefweb.int/node/278555,- 17 companies of pac have been deployed with 184 motorized boats and 88 wooden boats in the affected areas for relief and rescue operations,lives,38,19,78,0,135,punjab
9/1/08,https://reliefweb.int/node/278555,- about 10.27 lakh people have been affected in the state so far,lives,38,19,78,0,135,punjab
9/1/08,https://reliefweb.int/node/278555,- 20350 people continued to be accommodated in 132 relief camps,lives,38,19,78,0,135,punjab
9/1/08,https://reliefweb.int/node/278555,- about 194675 people in 910 villages have been affected,lives,38,19,78,0,135,punjab
9/1/08,https://reliefweb.int/node/278555,"- 1,84,132 acres cropped area has been damaged",lives,38,19,78,0,135,punjab
9/1/08,https://reliefweb.int/node/278555,- in 30 relief camps about 450 people have been accommodated,lives,38,19,78,0,135,punjab
9/1/08,https://reliefweb.int/node/278555,"- 6,875 houses and 90 huts have been damaged so far",lives,38,19,78,0,135,punjab
9/1/08,https://reliefweb.int/node/278555,- about 37.89 lakh people have been affected in the state so far,lives,38,19,78,0,135,punjab
9/1/08,https://reliefweb.int/node/278555,- in 26 relief camps about 6580 people have been accommodated - 152 medical teams and 26 boats continued to be deployed,lives,38,19,78,0,135,punjab
9/1/08,https://reliefweb.int/node/278555,- 406058 houses have been damaged so far,lives,38,19,78,0,135,punjab
9/1/08,https://reliefweb.int/node/278555,"human deaths - as per provisional information received from the affected states/uts, 08 human deaths (west bengal-07, bihar-02 & assam-01) were reported, raising the total death toll to 1746 from 1736",lives,38,19,78,0,135,punjab
8/29/08,https://reliefweb.int/node/278448,"a two kilometre long breach in the mud embankment has led to a change in the course of the river kosi, which has caused this flooding, including inundation of those districts in bihar which have not been affected by floods in past 50 years",lives,23,11,34,0,68,punjab
8/29/08,https://reliefweb.int/node/278448,"so far, 2.6 million people have been affected in the state and 47 people killed(1) since the breach occurred earlier this week",lives,23,11,34,0,68,punjab
8/29/08,https://reliefweb.int/node/278448,"he undertook an aerial survey of the affected areas and declared a relief package of inr 100 million (chf 2.5 million or usd 2.3 million), along with the release of 0.1 million tonnes of food grain for the state",lives,23,11,34,0,68,punjab
8/29/08,https://reliefweb.int/node/278448,of district affected 16 no,lives,23,11,34,0,68,punjab
8/29/08,https://reliefweb.int/node/278448,"of villages affected 1,598 no",lives,23,11,34,0,68,punjab
8/29/08,https://reliefweb.int/node/278448,of people affected 2.6 million no,lives,23,11,34,0,68,punjab
8/29/08,https://reliefweb.int/node/278448,"of houses destroyed 227,969 the 16 affected districts include muzaffarpur, supaul, patna, katihar, nalanda, araria, west champaran, shekhpura, saharsa, purnea, saran, begusarai, bhagalpur, madhepura, vaishall and khagaria",lives,23,11,34,0,68,punjab
8/29/08,https://reliefweb.int/node/278448,"another major area of concern is that due to continued flow of water from the breached embankment, displaced people will not be able to go back to their original locations for at least another two or three months",lives,23,11,34,0,68,punjab
8/29/08,https://reliefweb.int/node/278448,"morigaon district was inundated with fresh floods, with 80 villages and 6,800 hectares of paddy fields being severely affected",lives,23,11,34,0,68,punjab
8/29/08,https://reliefweb.int/node/278448,"so far, 1.6 million people have been affected from 3,686 villages in 21 districts in uttar pradesh and 194,675 people have been affected from 849 villages in 11 districts in punjab",lives,23,11,34,0,68,punjab
8/29/08,https://reliefweb.int/node/278448,"a total of 12 million people have been affected throughout the country this year and approximately 1,600 people have been killed in 19 states2 (himachal pradesh, andhra pradesh, uttar pradesh, uttarakhand, bihar, assam, jharkhand, west bengal, orissa, tamil nadu, kerala, karnataka, goa, maharashtra, madhya pradesh, gujarat, rajasthan, haryana and punjab).",lives,23,11,34,0,68,punjab
8/27/08,https://reliefweb.int/node/278134,"- on 18.08.2008, a long embankment was swept away at kushaha in nepal, about 7 km away from the kosi barrage at birpur in supaul, due to which supaul, madhepura and araria districts have been affected severely",lives,25,9,55,0,89,ferozepur
8/27/08,https://reliefweb.int/node/278134,"- in all, about 26,25,000 people from 1598 villages in 15 districts have been affected due to flood in the state",lives,25,9,55,0,89,ferozepur
8/27/08,https://reliefweb.int/node/278134,"- 103 relief camps have been opened in the flood affected area in which 23,587 people have been accommodated",lives,25,9,55,0,89,ferozepur
8/27/08,https://reliefweb.int/node/278134,- 59 cattle camps have been opened in the affected areas in which 715 animals have been treated,lives,25,9,55,0,89,ferozepur
8/27/08,https://reliefweb.int/node/278134,"champaramn-18, saran-01, bhagalpur-07 and madhepura-31) have also been opened in the flood affected areas of the state for providing medical care",lives,25,9,55,0,89,ferozepur
8/27/08,https://reliefweb.int/node/278134,"- 07 teams (about 274 personnel) alongwith 50 boats (10 men inflatable with motor-35, fiber glass speed boat-05 and 20 men boat- 10) are deployed in districts of supaul, madhepura and araria for 2 flood and relief duties",lives,25,9,55,0,89,ferozepur
8/27/08,https://reliefweb.int/node/278134,- also two flood trained teams (77 personnel) are moving by road from ndrf bn kolkata with 02 medical vehicles to augment the flood rescue efforts,lives,25,9,55,0,89,ferozepur
8/27/08,https://reliefweb.int/node/278134, - two mi-8 helicopters dropped 8.20 tons relief material and airlifted 18 passengers in six sorties,lives,25,9,55,0,89,ferozepur
8/27/08,https://reliefweb.int/node/278134,two mi-17 helicopters dropped 14.10 tons relief material and airlifted 14 passengers in six sorties,lives,25,9,55,0,89,ferozepur
8/27/08,https://reliefweb.int/node/278134,"a total of 22.30 tons of relief material was dropped and 32 passengers airlifted in 12 sorties in purnea, araria and madhepura districts",lives,25,9,55,0,89,ferozepur
8/27/08,https://reliefweb.int/node/278134,- one army column has been deployed in madhepura for rescue and relief operation on 26 aug 2008(a/n),lives,25,9,55,0,89,ferozepur
8/27/08,https://reliefweb.int/node/278134,02 army columns from allahabad and ranchi with 34 obm have reached today evening for relief and rescue operation in affected areas,lives,25,9,55,0,89,ferozepur
8/27/08,https://reliefweb.int/node/278134,"- 11 districts, have been flooded and about 194675 people from 849 villages in above districts are reported to have been affected",lives,25,9,55,0,89,ferozepur
8/27/08,https://reliefweb.int/node/278134,- 30 relief camps opened in the affected areas in which various affected persons have been accommodated,lives,25,9,55,0,89,ferozepur
8/27/08,https://reliefweb.int/node/278134,- 45 medical teams have been deployed in the flood affected areas,lives,25,9,55,0,89,ferozepur
8/27/08,https://reliefweb.int/node/278134,- 6226 houses (3926-fully and 2300 -partially) and 90 huts have been damaged so far,lives,25,9,55,0,89,ferozepur
8/27/08,https://reliefweb.int/node/278134,"- in all, 15,95,636 people from 3691 villages in 21 districts have been affected in the state so far due to flood",lives,25,9,55,0,89,ferozepur
8/27/08,https://reliefweb.int/node/278134,"- 84,693 houses have been damaged so far",lives,25,9,55,0,89,ferozepur
8/27/08,https://reliefweb.int/node/278134, - about 5697 people from the affected areas have been evacuated so far,lives,25,9,55,0,89,ferozepur
8/27/08,https://reliefweb.int/node/278134," - 319 relief camps have been opened in the flood affected areas in which 11,269 people have been accommodated",lives,25,9,55,0,89,ferozepur
8/27/08,https://reliefweb.int/node/278134,- 178 mobile teams of doctors along with medicines have been deployed in the flood affected areas for providing medical care,lives,25,9,55,0,89,ferozepur
8/27/08,https://reliefweb.int/node/278134,"- about 7.92 lakh people, in all, are reported to have been affected in the state due to flood so far",lives,25,9,55,0,89,ferozepur
8/27/08,https://reliefweb.int/node/278134,- 20350 people continued to be accommodated in 132 relief camps in the flood affected areas of the state,lives,25,9,55,0,89,ferozepur
8/27/08,https://reliefweb.int/node/278134,"- about 37.70 lakh people, in all, are reported to have been affected in the state due to flood so far",lives,25,9,55,0,89,ferozepur
8/27/08,https://reliefweb.int/node/278134,- 199 medical teams and 26 boats continued to be deployed in the affected areas of the state,lives,25,9,55,0,89,ferozepur
8/27/08,https://reliefweb.int/node/278134,- 398899 houses (238880 fully and 160019 partially) are reported to have been damaged due to flood so far,lives,25,9,55,0,89,ferozepur
8/27/08,https://reliefweb.int/node/278134,"human deaths - as per provisional information received from the affected states/uts, 50 human deaths (bihar -45, uttar pradesh -04 and maharashtra - 01) were reported, raising the total death toll to 1644 from 1594",lives,25,9,55,0,89,ferozepur
8/26/08,https://reliefweb.int/node/278299,"- on 18.08.2008, a long embankment was swept away at kushaha in nepal, about 7 km away from the kosi barrage at birpur in supaul, due to which supaul, madhepura and araria districts have been affected severely",lives,33,9,56,0,98,"ferozepur, jalandhar, kapurthala, moga"
8/26/08,https://reliefweb.int/node/278299,"- about 24,84,000 people from 1499 villages in 15 districts have been affected so far",lives,33,9,56,0,98,"ferozepur, jalandhar, kapurthala, moga"
8/26/08,https://reliefweb.int/node/278299,"- 2,27,081 houses are reported to have been damaged",lives,33,9,56,0,98,"ferozepur, jalandhar, kapurthala, moga"
8/26/08,https://reliefweb.int/node/278299,- 1216 boats have been pressed into service for rescue and relief operations in the flood affected areas of the state,lives,33,9,56,0,98,"ferozepur, jalandhar, kapurthala, moga"
8/26/08,https://reliefweb.int/node/278299,"- in 98 relief camps about 10,622 people have been accommodated",lives,33,9,56,0,98,"ferozepur, jalandhar, kapurthala, moga"
8/26/08,https://reliefweb.int/node/278299,- 101 health centre have also been opened in the flood affected areas,lives,33,9,56,0,98,"ferozepur, jalandhar, kapurthala, moga"
8/26/08,https://reliefweb.int/node/278299,- two mi-8 helicopters and one mi-17 helicopters dropped 15.40 tons of food material and airlifted 17 passengers in 07 sorties in the affected areas,lives,33,9,56,0,98,"ferozepur, jalandhar, kapurthala, moga"
8/26/08,https://reliefweb.int/node/278299,- 11 districts have been flooded and about 194675 people from 849 villages in above districts have been affected,lives,33,9,56,0,98,"ferozepur, jalandhar, kapurthala, moga"
8/26/08,https://reliefweb.int/node/278299,"- about 8615 people have been evacuated in moga, kapurthala, ferozepur and jalandhar districts",lives,33,9,56,0,98,"ferozepur, jalandhar, kapurthala, moga"
8/26/08,https://reliefweb.int/node/278299,- 61 boats and 45 medical teams have been deployed in the flood affected areas,lives,33,9,56,0,98,"ferozepur, jalandhar, kapurthala, moga"
8/26/08,https://reliefweb.int/node/278299,- 30 relief camps opened in the affected areas in which various affected persons have been accommodated,lives,33,9,56,0,98,"ferozepur, jalandhar, kapurthala, moga"
8/26/08,https://reliefweb.int/node/278299,- 6226 houses and 90 huts have been damaged so far,lives,33,9,56,0,98,"ferozepur, jalandhar, kapurthala, moga"
8/26/08,https://reliefweb.int/node/278299,"- 4 cattle camps opened in which about 1775 cattle have been accommodated - all army columns and engineer task forces deployed for rescue and relief operations in the state have been derequisitioned on 25th august, 2008",lives,33,9,56,0,98,"ferozepur, jalandhar, kapurthala, moga"
8/26/08,https://reliefweb.int/node/278299,"- about 16,28,621 people from 3686 villages in 21 districts have been affected severely and 674 villages marooned in the state",lives,33,9,56,0,98,"ferozepur, jalandhar, kapurthala, moga"
8/26/08,https://reliefweb.int/node/278299,"- 82,529 houses (3076 fully and 79453 partially) have been damaged so far",lives,33,9,56,0,98,"ferozepur, jalandhar, kapurthala, moga"
8/26/08,https://reliefweb.int/node/278299,- about 5697 people from the affected areas have been evacuated so far,lives,33,9,56,0,98,"ferozepur, jalandhar, kapurthala, moga"
8/26/08,https://reliefweb.int/node/278299,"- in 275 relief camps about 10,833 people have been accommodated",lives,33,9,56,0,98,"ferozepur, jalandhar, kapurthala, moga"
8/26/08,https://reliefweb.int/node/278299,- about 7.92 lakh people have been affected in the state,lives,33,9,56,0,98,"ferozepur, jalandhar, kapurthala, moga"
8/26/08,https://reliefweb.int/node/278299,- 20350 people continued to be accommodated in 132 relief camps,lives,33,9,56,0,98,"ferozepur, jalandhar, kapurthala, moga"
8/26/08,https://reliefweb.int/node/278299,- about 37.70 lakh people have been affected in the state,lives,33,9,56,0,98,"ferozepur, jalandhar, kapurthala, moga"
8/26/08,https://reliefweb.int/node/278299,- 199 medical teams and 26 boats continued to be deployed in the affected areas of the state,lives,33,9,56,0,98,"ferozepur, jalandhar, kapurthala, moga"
8/26/08,https://reliefweb.int/node/278299,- 398899 houses (238880 fully and 160019 partially) are reported to have been damaged due to flood so far,lives,33,9,56,0,98,"ferozepur, jalandhar, kapurthala, moga"
8/26/08,https://reliefweb.int/node/278299,"human deaths - as per provisional information received from the affected states/uts, 19 human deaths (gujarat & bihar-07 each, uttar pradesh-04, and west bengal-01) were reported, raising the total death toll to 1594 from 1575",lives,33,9,56,0,98,"ferozepur, jalandhar, kapurthala, moga"
8/25/08,https://reliefweb.int/node/278295,- about 194675 people from 849 villages in 11 districts have been affected due to flood,lives,21,4,42,0,67,"amritsar, kapurthala"
8/25/08,https://reliefweb.int/node/278295,- 28 relief camps opened in the affected areas in which various affected persons have been accommodated,lives,21,4,42,0,67,"amritsar, kapurthala"
8/25/08,https://reliefweb.int/node/278295,- 45 medical teams have been deployed in the flood affected areas,lives,21,4,42,0,67,"amritsar, kapurthala"
8/25/08,https://reliefweb.int/node/278295,- 6226 houses (3926-fully and 2300 -partially) and 90 huts have been damaged so far,lives,21,4,42,0,67,"amritsar, kapurthala"
8/25/08,https://reliefweb.int/node/278295,- 04 army columns with 04 engineer task forces (ferozpur and kapurthala) continued to be deployed for rescue and relief operations,lives,21,4,42,0,67,"amritsar, kapurthala"
8/25/08,https://reliefweb.int/node/278295," - an inter-ministerial central team is visiting the state for assessment of the damage, from 23rd to 25th august, 2008",lives,21,4,42,0,67,"amritsar, kapurthala"
8/25/08,https://reliefweb.int/node/278295,"- in all, 1609781 people from 3638 villages in 21 districts have been affected due to flood",lives,21,4,42,0,67,"amritsar, kapurthala"
8/25/08,https://reliefweb.int/node/278295,- 275 relief camps have been opened in the flood affected areas in which 10833 people have been accommodated,lives,21,4,42,0,67,"amritsar, kapurthala"
8/25/08,https://reliefweb.int/node/278295,- 3480 boats have been pressed into service for rescue and relief operations in the affected areas,lives,21,4,42,0,67,"amritsar, kapurthala"
8/25/08,https://reliefweb.int/node/278295,- 178 mobile teams of doctors along with medicines have been deployed in the flood affected areas for providing medical care,lives,21,4,42,0,67,"amritsar, kapurthala"
8/25/08,https://reliefweb.int/node/278295,"- in all, about 14.69 lakh people from 1081 villages in 13 districts have been affected due to flood in the state",lives,21,4,42,0,67,"amritsar, kapurthala"
8/25/08,https://reliefweb.int/node/278295,"- 27 relief camps have been opened in the flood affected area in which 10,122 people have been accommodated",lives,21,4,42,0,67,"amritsar, kapurthala"
8/25/08,https://reliefweb.int/node/278295,- 15 cattle camps have been opened in the affected areas,lives,21,4,42,0,67,"amritsar, kapurthala"
8/25/08,https://reliefweb.int/node/278295,- 61 health centre have also been opened in the flood affected areas,lives,21,4,42,0,67,"amritsar, kapurthala"
8/25/08,https://reliefweb.int/node/278295,"- 06 teams of ndrf (about 230 personnel) alongwith 23 boats deployed in supaul, madhepura and araria for flood and relief duties - 10 inflatable boats with obm and 20 flood rescue trained personnel of ndrf reached at purnia for the deployment at madhepura and araria",lives,21,4,42,0,67,"amritsar, kapurthala"
8/25/08,https://reliefweb.int/node/278295,"- about 7.92 lakh people, in all, are reported to have been affected in the state due to flood so far",lives,21,4,42,0,67,"amritsar, kapurthala"
8/25/08,https://reliefweb.int/node/278295,- 20350 people continued to be accommodated in 132 relief camps in the flood affected areas of the state,lives,21,4,42,0,67,"amritsar, kapurthala"
8/25/08,https://reliefweb.int/node/278295,"- about 37.70 lakh people, in all, are reported to have been affected in the state due to flood so far",lives,21,4,42,0,67,"amritsar, kapurthala"
8/25/08,https://reliefweb.int/node/278295,- 199 medical teams and 26 boats continued to be deployed in the affected areas of the state,lives,21,4,42,0,67,"amritsar, kapurthala"
8/25/08,https://reliefweb.int/node/278295,- 398881 houses (238880 fully and 160001 partially) are reported to have been damaged due to flood so far,lives,21,4,42,0,67,"amritsar, kapurthala"
8/25/08,https://reliefweb.int/node/278295,"human deaths - as per provisional information received from the affected states/uts, 07 human deaths (uttar pradesh -04, bihar-02 and haryana -01) were reported during last 24 hours, raising the total death toll to 1575 from 1568",lives,21,4,42,0,67,"amritsar, kapurthala"
8/24/08,https://reliefweb.int/node/278337,- about 107718 population from 822 villages in 10 districts have been affected due to flood,lives,23,11,51,0,85,punjab
8/24/08,https://reliefweb.int/node/278337,- 28 relief camps opened in the affected areas in which various affected persons have been accommodated,lives,23,11,51,0,85,punjab
8/24/08,https://reliefweb.int/node/278337,- 56 boats and 40 medical teams continued to be deployed in the affected areas,lives,23,11,51,0,85,punjab
8/24/08,https://reliefweb.int/node/278337,- 5414 houses and 90 huts have been damaged so far,lives,23,11,51,0,85,punjab
8/24/08,https://reliefweb.int/node/278337,- 4 cattle camps opened in which about 1775 cattle have been accommodated - 04 army columns with 04 engineer task forces continued to be deployed for rescue and relief operations,lives,23,11,51,0,85,punjab
8/24/08,https://reliefweb.int/node/278337,"- an inter-ministerial central team is visiting the state for assessment of the damage, from 23rd to 25th august, 2008",lives,23,11,51,0,85,punjab
8/24/08,https://reliefweb.int/node/278337,- about 15.93 lakh people from 3586 villages in 21 districts have been affected severely and 713 villages marooned due to flood,lives,23,11,51,0,85,punjab
8/24/08,https://reliefweb.int/node/278337,- 80540 houses have been damaged,lives,23,11,51,0,85,punjab
8/24/08,https://reliefweb.int/node/278337,- in 276 relief camps about 10833 people have been accommodated,lives,23,11,51,0,85,punjab
8/24/08,https://reliefweb.int/node/278337,- 3406 boats and 178 mobile teams of doctors along with medicines continued to be deployed in the flood affected areas,lives,23,11,51,0,85,punjab
8/24/08,https://reliefweb.int/node/278337,- 17 companies of pac have been deployed with 184 motorized boats and 88 wooden boats in the affected areas for relief and rescue operations,lives,23,11,51,0,85,punjab
8/24/08,https://reliefweb.int/node/278337,- about 14.69 people from 1081 villages in 13 districts have been affected due to flood,lives,23,11,51,0,85,punjab
8/24/08,https://reliefweb.int/node/278337,"- about 2,25,192 houses have been damaged",lives,23,11,51,0,85,punjab
8/24/08,https://reliefweb.int/node/278337,- 970 boats have been pressed into service in the flood affected areas,lives,23,11,51,0,85,punjab
8/24/08,https://reliefweb.int/node/278337,"- in 27 relief camps about 10,122 people have been accommodated",lives,23,11,51,0,85,punjab
8/24/08,https://reliefweb.int/node/278337,- 15 cattle camps have been opened in the affected areas,lives,23,11,51,0,85,punjab
8/24/08,https://reliefweb.int/node/278337,- 61 health centre have also been opened in the flood affected areas,lives,23,11,51,0,85,punjab
8/24/08,https://reliefweb.int/node/278337,"- 06 teams of ndrf alongwith 23 boats deployed in supaul, madhepura and araria for flood and relief duties",lives,23,11,51,0,85,punjab
8/24/08,https://reliefweb.int/node/278337,- 10 inflatable boats with obm and 20 flood rescue trained personnel of ndrf reached at purnia for deployment at madhepura and araria,lives,23,11,51,0,85,punjab
8/24/08,https://reliefweb.int/node/278337,- about 4.93 lakh people have been affected in the state due to flood,lives,23,11,51,0,85,punjab
8/24/08,https://reliefweb.int/node/278337,"- 15,165 people continued to be accommodated in 22 relief camps",lives,23,11,51,0,85,punjab
8/24/08,https://reliefweb.int/node/278337,- about 37.70 lakh people have been affected in the state due to flood,lives,23,11,51,0,85,punjab
8/24/08,https://reliefweb.int/node/278337,- 200 people continued to be accommodated in 06 relief camps,lives,23,11,51,0,85,punjab
8/24/08,https://reliefweb.int/node/278337,- 199 medical teams and 12 boats continued to be deployed in the affected areas,lives,23,11,51,0,85,punjab
8/24/08,https://reliefweb.int/node/278337,- 398866 houses have been damaged due to flood,lives,23,11,51,0,85,punjab
8/24/08,https://reliefweb.int/node/278337,"human deaths - as per provisional information received from the affected states/uts, 05 human deaths were reported during last 24 hours, raising the total death toll to 1568 from 1563",lives,23,11,51,0,85,punjab
8/23/08,https://reliefweb.int/node/278317,- in 10 districts about 826 villages and 107718 people have been affected,lives,23,6,48,0,77,kapurthala
8/23/08,https://reliefweb.int/node/278317,- 28 relief camps continued to be running in the affected areas,lives,23,6,48,0,77,kapurthala
8/23/08,https://reliefweb.int/node/278317,- 40 medical teams have been deployed in the flood affected areas,lives,23,6,48,0,77,kapurthala
8/23/08,https://reliefweb.int/node/278317,- 4620 houses and 90 huts have been damaged so far,lives,23,6,48,0,77,kapurthala
8/23/08,https://reliefweb.int/node/278317,"however, 04 army columns with 07 engineer task forces (ferozpur and kapurthala) continued to be deployed for rescue and relief operations",lives,23,6,48,0,77,kapurthala
8/23/08,https://reliefweb.int/node/278317,"- in all, 15,93,440 people from 3586 villages in 21 districts have been affected severely and 713 villages in the state so far due to flood",lives,23,6,48,0,77,kapurthala
8/23/08,https://reliefweb.int/node/278317,- 80540 houses (2982 fully and 77558 partially) have been damaged so far,lives,23,6,48,0,77,kapurthala
8/23/08,https://reliefweb.int/node/278317,- about 5751 people from the affected areas have been evacuated so far,lives,23,6,48,0,77,kapurthala
8/23/08,https://reliefweb.int/node/278317,- 276 relief camps have been opened in the flood affected areas in which 10833 people have been accommodated,lives,23,6,48,0,77,kapurthala
8/23/08,https://reliefweb.int/node/278317,- 3406 boats have been pressed into service for rescue and relief operations in the affected areas,lives,23,6,48,0,77,kapurthala
8/23/08,https://reliefweb.int/node/278317,- 178 mobile teams of doctors along with medicines have been deployed in the flood affected areas for providing medical care,lives,23,6,48,0,77,kapurthala
8/23/08,https://reliefweb.int/node/278317,"- 10 inflatable boats with obm and 20 personnel of ndrf are being airlifted from delhi today the 23rd august, 2008 for relief and rescue operations in the state as requisitioned by the bihar government",lives,23,6,48,0,77,kapurthala
8/23/08,https://reliefweb.int/node/278317,"- in all, about 6,27,000 people from 814 villages in 11 districts (muzaffarpur, supaul, patna, katihar, nalanda, araria, west champaran, shekhpura, saharsa, purnea and khagaria) have been affected due to flood in the state",lives,23,6,48,0,77,kapurthala
8/23/08,https://reliefweb.int/node/278317,- 20 relief camps have been opened in the flood affected area in which 3296 people have been accommodated,lives,23,6,48,0,77,kapurthala
8/23/08,https://reliefweb.int/node/278317,"- 01 mi-8 helicopter and 01 mi-17 helicopters dropped 22.50 tons of relief material and airlifted 30 passengers in ten sorties in chattarpur, purnea, tryveniganj, mirgawa, mirganj, kumar khand, madhepura and jadya area",lives,23,6,48,0,77,kapurthala
8/23/08,https://reliefweb.int/node/278317,"- about 4.93 lakh people, in all, are reported to have been affected in the state due to flood so far",lives,23,6,48,0,77,kapurthala
8/23/08,https://reliefweb.int/node/278317,"- 15,165 people continued to be accommodated in 22 relief camps",lives,23,6,48,0,77,kapurthala
8/23/08,https://reliefweb.int/node/278317,- 200 people continued to be accommodated in 06 relief camps,lives,23,6,48,0,77,kapurthala
8/23/08,https://reliefweb.int/node/278317,- 199 medical teams and 12 boats continued to be deployed in the affected areas of the state,lives,23,6,48,0,77,kapurthala
8/23/08,https://reliefweb.int/node/278317,- 398866 houses (238867 fully and 159999 partially) are reported to have been damaged due to flood so far,lives,23,6,48,0,77,kapurthala
8/23/08,https://reliefweb.int/node/278317,"human deaths - as per provisional information received from the affected states/uts, 03 human deaths (uttar pradesh) were reported during last 24 hours, raising the total death toll to 1563 from 1560",lives,23,6,48,0,77,kapurthala
8/22/08,https://reliefweb.int/node/278298,- in 10 districts about 826 villages and 107718 people have been affected,lives,28,10,52,0,90,kapurthala
8/22/08,https://reliefweb.int/node/278298,- 56 boats have been pressed into service for rescue and relief operations,lives,28,10,52,0,90,kapurthala
8/22/08,https://reliefweb.int/node/278298,- 28 relief camps continued to be running in the affected areas,lives,28,10,52,0,90,kapurthala
8/22/08,https://reliefweb.int/node/278298,- 40 medical teams have been deployed in the flood affected areas,lives,28,10,52,0,90,kapurthala
8/22/08,https://reliefweb.int/node/278298,- 4620 houses and 90 huts have been damaged so far,lives,28,10,52,0,90,kapurthala
8/22/08,https://reliefweb.int/node/278298,"however, 07 army columns with 07 engineer task forces (ferozpur and kapurthala) continued to be deployed for rescue and relief operations uttar pradesh - moderate to heavy rainfall with isolated very heavy falls has been reported in some parts of the state",lives,28,10,52,0,90,kapurthala
8/22/08,https://reliefweb.int/node/278298,"- in all, 15,67,353 people from 3308 villages in 21 districts have been affected severely and 674 villages in the state",lives,28,10,52,0,90,kapurthala
8/22/08,https://reliefweb.int/node/278298,- 77837 houses have been damaged so far,lives,28,10,52,0,90,kapurthala
8/22/08,https://reliefweb.int/node/278298,- in 274 relief camps about 10742 people have been accommodated,lives,28,10,52,0,90,kapurthala
8/22/08,https://reliefweb.int/node/278298,- 3037 boats and 178 mobile teams of doctors along with medicines continued to be deployed in the flood affected areas,lives,28,10,52,0,90,kapurthala
8/22/08,https://reliefweb.int/node/278298,- 17 companies of pac with 184 motorized boats and 88 wooden boats continued to be deployed in the affected areas,lives,28,10,52,0,90,kapurthala
8/22/08,https://reliefweb.int/node/278298,"- in all, about 6,27,000 people from 814 villages in 11 districts have been affected",lives,28,10,52,0,90,kapurthala
8/22/08,https://reliefweb.int/node/278298,- 2156 houses are reported to have been damaged so far,lives,28,10,52,0,90,kapurthala
8/22/08,https://reliefweb.int/node/278298,- 745 boats have been pressed into service for rescue and relief operations in the flood affected areas of the state,lives,28,10,52,0,90,kapurthala
8/22/08,https://reliefweb.int/node/278298,"- 55,711 persons have been evacuated from the affected areas so far",lives,28,10,52,0,90,kapurthala
8/22/08,https://reliefweb.int/node/278298,- in 20 relief camps about 3296 people have been accommodated,lives,28,10,52,0,90,kapurthala
8/22/08,https://reliefweb.int/node/278298,- 05 cattle camps have also been opened in the affected areas,lives,28,10,52,0,90,kapurthala
8/22/08,https://reliefweb.int/node/278298,- mi-8 helicopter dropped 3.2 tons of relief material and airlifted six passengers in four sorties,lives,28,10,52,0,90,kapurthala
8/22/08,https://reliefweb.int/node/278298,"01 mi-17 helicopter has been positioned at purnea on 21st august, 2008 for rescue and relief operation",lives,28,10,52,0,90,kapurthala
8/22/08,https://reliefweb.int/node/278298,"- about 4.93 lakh people, in all, are reported to have been affected in the state due to flood so far",lives,28,10,52,0,90,kapurthala
8/22/08,https://reliefweb.int/node/278298,"- 15,165 people continued to be accommodated in 22 relief camps",lives,28,10,52,0,90,kapurthala
8/22/08,https://reliefweb.int/node/278298,"- about 37.70 lakh people, in all, are reported to have been affected",lives,28,10,52,0,90,kapurthala
8/22/08,https://reliefweb.int/node/278298,- 200 people continued to be accommodated in 06 relief camps,lives,28,10,52,0,90,kapurthala
8/22/08,https://reliefweb.int/node/278298,- 199 medical teams and 12 boats continued to be deployed in the affected areas of the state,lives,28,10,52,0,90,kapurthala
8/22/08,https://reliefweb.int/node/278298,- 398866 houses (238867 fully and 159999 partially) are reported to have been damaged due to flood so far,lives,28,10,52,0,90,kapurthala
8/22/08,https://reliefweb.int/node/278298,"human deaths - as per provisional information received from the affected states/uts, 67 human deaths (uttar pradesh-50, gujarat-12, west bengal-03, mp & tamil nadu-01 each) were reported during last 24 hours, raising the total death toll to 1560 from 1493",lives,28,10,52,0,90,kapurthala
8/21/08,https://reliefweb.int/node/280650,"in all, about 6,14,000 people from 802 villages in 10 districts (muzaffarpur, supaul, patna, katihar, nalanda, araria, west champaran, shekhpura, saharsa and khagaria) have been severally affected",lives,3,2,23,0,28,"jalandhar, sas nagar"
8/21/08,https://reliefweb.int/node/280650,734 boats have been pressed into service for rescue and relief operations in the affected areas,lives,3,2,23,0,28,"jalandhar, sas nagar"
8/21/08,https://reliefweb.int/node/280650,five relief camps have been opened in which 2792 people have been accommodated,lives,3,2,23,0,28,"jalandhar, sas nagar"
8/21/08,https://reliefweb.int/node/280650,"so far incessant rains and flash floods have engulfed 1385 human lives and affected a population of 101,47,296 in 10942 villages of 96 districts in the country",lives,3,2,23,0,28,"jalandhar, sas nagar"
8/21/08,https://reliefweb.int/node/277451,"- in 10 districts, 708 villages have been affected due to flood",lives,24,5,35,0,64,"ferozepur, jalandhar, kapurthala, moga, sas nagar"
8/21/08,https://reliefweb.int/node/277451,- 28 relief camps have been opened in the affected areas,lives,24,5,35,0,64,"ferozepur, jalandhar, kapurthala, moga, sas nagar"
8/21/08,https://reliefweb.int/node/277451,- 40 medical teams have been deployed in the flood affected areas,lives,24,5,35,0,64,"ferozepur, jalandhar, kapurthala, moga, sas nagar"
8/21/08,https://reliefweb.int/node/277451,"- 09 army columns with 09 engineer task forces have been deployed in jalandhar, ferozepur and kapurthala for rescue and relief operations delhi - no significant rainfall has been reported in delhi and ncr",lives,24,5,35,0,64,"ferozepur, jalandhar, kapurthala, moga, sas nagar"
8/21/08,https://reliefweb.int/node/277451,- 154 villages in 05 districts have been affected,lives,24,5,35,0,64,"ferozepur, jalandhar, kapurthala, moga, sas nagar"
8/21/08,https://reliefweb.int/node/277451,- 44 relief camps opened in the affected areas in which about 5978 people have been accommodated,lives,24,5,35,0,64,"ferozepur, jalandhar, kapurthala, moga, sas nagar"
8/21/08,https://reliefweb.int/node/277451,- about 253586 people in 05 districts have been severally affected,lives,24,5,35,0,64,"ferozepur, jalandhar, kapurthala, moga, sas nagar"
8/21/08,https://reliefweb.int/node/277451,- 51 relief camps have been opened in the flood affected areas in which about 19631 people have been accommodated,lives,24,5,35,0,64,"ferozepur, jalandhar, kapurthala, moga, sas nagar"
8/21/08,https://reliefweb.int/node/277451,"- in all, 15,29179 people from 3173 villages in 11 districts have been affected in the state so far due to flood",lives,24,5,35,0,64,"ferozepur, jalandhar, kapurthala, moga, sas nagar"
8/21/08,https://reliefweb.int/node/277451,- 268 relief camps have been opened in the flood affected areas in which 10623 people have been accommodated,lives,24,5,35,0,64,"ferozepur, jalandhar, kapurthala, moga, sas nagar"
8/21/08,https://reliefweb.int/node/277451,- 178 mobile teams of doctors along with medicines have been deployed in the flood affected areas for providing medical care,lives,24,5,35,0,64,"ferozepur, jalandhar, kapurthala, moga, sas nagar"
8/21/08,https://reliefweb.int/node/277451,"- in all, about 6,14,000 people from 802 villages have been affected due to flood in the state",lives,24,5,35,0,64,"ferozepur, jalandhar, kapurthala, moga, sas nagar"
8/21/08,https://reliefweb.int/node/277451,- 20 relief camps have been opened in the flood affected area in which 2792 people have been accommodated,lives,24,5,35,0,64,"ferozepur, jalandhar, kapurthala, moga, sas nagar"
8/21/08,https://reliefweb.int/node/277451,- 03 teams of ndrf with obm plus boats assault universal type are reaching supaul and araria districts for carrying out flood rescue operations,lives,24,5,35,0,64,"ferozepur, jalandhar, kapurthala, moga, sas nagar"
8/21/08,https://reliefweb.int/node/277451,"- about 4.93 lakh people, in all, are reported to have been affected in the state due to flood so far",lives,24,5,35,0,64,"ferozepur, jalandhar, kapurthala, moga, sas nagar"
8/21/08,https://reliefweb.int/node/277451,"- 15,165 people continued to be accommodated in 22 relief camps in the flood affected areas of the state",lives,24,5,35,0,64,"ferozepur, jalandhar, kapurthala, moga, sas nagar"
8/21/08,https://reliefweb.int/node/277451,"- about 37.70 lakh people, in all, are reported to have been affected in the state due to flood so far",lives,24,5,35,0,64,"ferozepur, jalandhar, kapurthala, moga, sas nagar"
8/21/08,https://reliefweb.int/node/277451,- 200 people continued to be accommodated in 06 relief camps in the state,lives,24,5,35,0,64,"ferozepur, jalandhar, kapurthala, moga, sas nagar"
8/21/08,https://reliefweb.int/node/277451,"human deaths - as per provisional information received from the affected states/uts, 62 human deaths (uttar pradesh -41, maharashtra -08, punjab -09, west bengal -03 and bihar -01) were reported during last 24 hours, raising the total death toll to 1493 from 1431",lives,24,5,35,0,64,"ferozepur, jalandhar, kapurthala, moga, sas nagar"
8/21/08,https://reliefweb.int/node/277239,"the situation is worse in remote areas, where over 2,000 thatched houses and 320 roads have been damaged and over 5,000 hectares of crops destroyed in koraput and jeypore sub-division, orissa",lives,16,19,28,1,64,punjab
8/21/08,https://reliefweb.int/node/277239,"the flood was sudden and more than 50,000 people are affected",lives,16,19,28,1,64,punjab
8/21/08,https://reliefweb.int/node/277239,the number of people who have gone missing is yet to be ascertained,lives,16,19,28,1,64,punjab
8/21/08,https://reliefweb.int/node/277239,"some 530,000 acres of land, including 200,000 cultivated acres, have been affected",lives,16,19,28,1,64,punjab
8/21/08,https://reliefweb.int/node/277239,- nepal: the lwf nepal rapid assessment team from the eastern region rushed to the affected area on 19 august 2008 in order to assess the situation and the specific emergency roles the lwf nepal could play with the affected population,lives,16,19,28,1,64,punjab
8/21/08,https://reliefweb.int/node/277239,"the package of assistance and relief per family is planned as follows: food items (10 kg rice, 2 kg dal, 1 litre oil, ¬Ω kg salt, ¬Ω kg red chilli); and non-food items (men's wear, women's wear and blankets)",lives,16,19,28,1,64,punjab
8/20/08,https://reliefweb.int/node/277545,"- in 09 districts, 576 villages have been affected due to flood",lives,24,2,31,0,57,"ferozepur, jalandhar, kapurthala, moga"
8/20/08,https://reliefweb.int/node/277545,- 23 relief camps have been opened in the affected areas,lives,24,2,31,0,57,"ferozepur, jalandhar, kapurthala, moga"
8/20/08,https://reliefweb.int/node/277545,"- 09 army columns with 09 engineer task forces continued to be deployed in jalandhar, ferozepur and kapurthala for rescue and relief operations delhi - no significant rainfall has been reported in delhi and ncr",lives,24,2,31,0,57,"ferozepur, jalandhar, kapurthala, moga"
8/20/08,https://reliefweb.int/node/277545,- 154 villages in 05 districts have been affected severally due to flood,lives,24,2,31,0,57,"ferozepur, jalandhar, kapurthala, moga"
8/20/08,https://reliefweb.int/node/277545,- in 44 relief camps about 5978 people have been accommodated,lives,24,2,31,0,57,"ferozepur, jalandhar, kapurthala, moga"
8/20/08,https://reliefweb.int/node/277545,- about 253586 people in 05 districts have been severally affected,lives,24,2,31,0,57,"ferozepur, jalandhar, kapurthala, moga"
8/20/08,https://reliefweb.int/node/277545,- 19631 people have been accommodated in 51 relief camps,lives,24,2,31,0,57,"ferozepur, jalandhar, kapurthala, moga"
8/20/08,https://reliefweb.int/node/277545,- 06th ndrf bn at arakanam has been alerted to keep the sar teams ready for move on short notice for rescue and relief operations,lives,24,2,31,0,57,"ferozepur, jalandhar, kapurthala, moga"
8/20/08,https://reliefweb.int/node/277545,"- in all, 15,18,380 people from 3249 villages in 11 districts have been affected severely",lives,24,2,31,0,57,"ferozepur, jalandhar, kapurthala, moga"
8/20/08,https://reliefweb.int/node/277545,"- in 252 relief camps, about 10029 people have been accommodated",lives,24,2,31,0,57,"ferozepur, jalandhar, kapurthala, moga"
8/20/08,https://reliefweb.int/node/277545,"- in all, about 6,14,000 people from 802 villages in 10 districts have been severally affected",lives,24,2,31,0,57,"ferozepur, jalandhar, kapurthala, moga"
8/20/08,https://reliefweb.int/node/277545,- in 05 relief camps about 2792 people have been accommodated,lives,24,2,31,0,57,"ferozepur, jalandhar, kapurthala, moga"
8/20/08,https://reliefweb.int/node/277545,"- about 4.93 lakh people, in all, are reported to have been affected in the state due to flood so far",lives,24,2,31,0,57,"ferozepur, jalandhar, kapurthala, moga"
8/20/08,https://reliefweb.int/node/277545,"- 15,865 people continued to be accommodated in 22 relief camps",lives,24,2,31,0,57,"ferozepur, jalandhar, kapurthala, moga"
8/20/08,https://reliefweb.int/node/277545,"- about 37.51 lakh people, in all, have been affected in the state due to flood",lives,24,2,31,0,57,"ferozepur, jalandhar, kapurthala, moga"
8/20/08,https://reliefweb.int/node/277545,- 200 people continued to be accommodated in 06 relief camps,lives,24,2,31,0,57,"ferozepur, jalandhar, kapurthala, moga"
8/20/08,https://reliefweb.int/node/277545,"human deaths - as per provisional information received from the affected states/uts, 20 human deaths (uttar pradesh -19 and assam -01) which occurred earlier in these states but reported today thereby raising the total death toll to 1431 from 1411",lives,24,2,31,0,57,"ferozepur, jalandhar, kapurthala, moga"
8/19/08,https://reliefweb.int/node/277180,"- 09 districts, (have been flooded and about 73459 people from 391 villages in above districts are reported to have been affected",lives,29,6,63,0,98,"ferozepur, jalandhar, kapurthala, moga"
8/19/08,https://reliefweb.int/node/277180,- 3233 people have been evacuated in ferozpur and moga districts so far,lives,29,6,63,0,98,"ferozepur, jalandhar, kapurthala, moga"
8/19/08,https://reliefweb.int/node/277180,- 23 relief camps have been opened in the affected areas,lives,29,6,63,0,98,"ferozepur, jalandhar, kapurthala, moga"
8/19/08,https://reliefweb.int/node/277180,- 37 medical teams have been deployed in the flood affected areas,lives,29,6,63,0,98,"ferozepur, jalandhar, kapurthala, moga"
8/19/08,https://reliefweb.int/node/277180,- 1857 houses (1274-fully and 583-partially) have been damaged so far,lives,29,6,63,0,98,"ferozepur, jalandhar, kapurthala, moga"
8/19/08,https://reliefweb.int/node/277180,"- 11 army columns with 11 engineer task forces have been deployed in jalandhar, firozepur and kapurthala for rescue and relief operations delhi - no significant rainfall has been reported in delhi and ncr",lives,29,6,63,0,98,"ferozepur, jalandhar, kapurthala, moga"
8/19/08,https://reliefweb.int/node/277180,- about 20025 people from 127 villages are reported to have been affected severely,lives,29,6,63,0,98,"ferozepur, jalandhar, kapurthala, moga"
8/19/08,https://reliefweb.int/node/277180,- 176 medical teams have been deployed in the flood affected areas,lives,29,6,63,0,98,"ferozepur, jalandhar, kapurthala, moga"
8/19/08,https://reliefweb.int/node/277180,- 342 houses (38-fully and 304 partially) have been damaged so far,lives,29,6,63,0,98,"ferozepur, jalandhar, kapurthala, moga"
8/19/08,https://reliefweb.int/node/277180,- 154 villages in 05 districts have been affected severally due to flood so far,lives,29,6,63,0,98,"ferozepur, jalandhar, kapurthala, moga"
8/19/08,https://reliefweb.int/node/277180,- 2589 houses (259 fully and 2330 partially) have been damaged so far,lives,29,6,63,0,98,"ferozepur, jalandhar, kapurthala, moga"
8/19/08,https://reliefweb.int/node/277180,- 44 relief camps opened in the affected areas in which about 5978 people have been accommodated,lives,29,6,63,0,98,"ferozepur, jalandhar, kapurthala, moga"
8/19/08,https://reliefweb.int/node/277180,- about 253586 people in 05 districts have been severally affected,lives,29,6,63,0,98,"ferozepur, jalandhar, kapurthala, moga"
8/19/08,https://reliefweb.int/node/277180,- 51 relief camps have been opened in the flood affected areas in which about 19631 people have been accommodated,lives,29,6,63,0,98,"ferozepur, jalandhar, kapurthala, moga"
8/19/08,https://reliefweb.int/node/277180,- 405 medical camps have been established for providing medical care to the affected people,lives,29,6,63,0,98,"ferozepur, jalandhar, kapurthala, moga"
8/19/08,https://reliefweb.int/node/277180,- 06th ndrf bn at arakanam has been alerted to keep the sar teams ready for move on short notice for rescue and relief operations,lives,29,6,63,0,98,"ferozepur, jalandhar, kapurthala, moga"
8/19/08,https://reliefweb.int/node/277180,- total 1976 village in 06 districts have been affected severely due heavy rainfall,lives,29,6,63,0,98,"ferozepur, jalandhar, kapurthala, moga"
8/19/08,https://reliefweb.int/node/277180,- 02 teams consisting of 64 personnel continued to be deployed at chandrapur and kolhapur district for flood water rescue operation,lives,29,6,63,0,98,"ferozepur, jalandhar, kapurthala, moga"
8/19/08,https://reliefweb.int/node/277180,"- in all, 15,13,342 people have been affected in 11 districts in the state so far due to flood",lives,29,6,63,0,98,"ferozepur, jalandhar, kapurthala, moga"
8/19/08,https://reliefweb.int/node/277180,- 252 relief camps have been opened in the flood affected areas in which 10029 people have been accommodated,lives,29,6,63,0,98,"ferozepur, jalandhar, kapurthala, moga"
8/19/08,https://reliefweb.int/node/277180,- 116 mobile teams of doctors along with medicines have been deployed in the flood affected areas for providing medical care,lives,29,6,63,0,98,"ferozepur, jalandhar, kapurthala, moga"
8/19/08,https://reliefweb.int/node/277180,"- in all, about 6,14,000 people from 802 villages, have been affected due to flood in the state",lives,29,6,63,0,98,"ferozepur, jalandhar, kapurthala, moga"
8/19/08,https://reliefweb.int/node/277180,- 734 boats have been pressed into service for rescue and relief operations in the flood affected areas of the state,lives,29,6,63,0,98,"ferozepur, jalandhar, kapurthala, moga"
8/19/08,https://reliefweb.int/node/277180,- 05 relief camps have been opened in the flood affected area in which 2792 people have been accommodated,lives,29,6,63,0,98,"ferozepur, jalandhar, kapurthala, moga"
8/19/08,https://reliefweb.int/node/277180,"- about 4.93 lakh people, in all, are reported to have been affected in the state due to flood so far",lives,29,6,63,0,98,"ferozepur, jalandhar, kapurthala, moga"
8/19/08,https://reliefweb.int/node/277180,"- 15,865 people continued to be accommodated in 22 relief camps in the flood affected areas of the state",lives,29,6,63,0,98,"ferozepur, jalandhar, kapurthala, moga"
8/19/08,https://reliefweb.int/node/277180,"- about 37.06 lakh people, in all, are reported to have been affected in the state due to flood so far",lives,29,6,63,0,98,"ferozepur, jalandhar, kapurthala, moga"
8/19/08,https://reliefweb.int/node/277180,- 150 people continued to be accommodated in 05 relief camps in the state,lives,29,6,63,0,98,"ferozepur, jalandhar, kapurthala, moga"
8/19/08,https://reliefweb.int/node/277180,- 199 medical teams and 02 boats continued to be deployed in the affected areas of the state,lives,29,6,63,0,98,"ferozepur, jalandhar, kapurthala, moga"
8/19/08,https://reliefweb.int/node/277180,- 398454 houses (238570 fully and 159984 partially) are reported to have been damaged due to flood so far,lives,29,6,63,0,98,"ferozepur, jalandhar, kapurthala, moga"
8/19/08,https://reliefweb.int/node/277180,"human deaths - as per provisional information received from the affected states/uts, 26 human deaths (uttar pradesh -20, orissa- 03, kerala -02 and rajasthan -01) were reported during last 24 hours, raising the total death toll to 1411 from 1385",lives,29,6,63,0,98,"ferozepur, jalandhar, kapurthala, moga"
8/18/08,https://reliefweb.int/node/277200," army columns and ngos are engaged in evacuation work at a brisk rate, officials said adding that the 150 ft breach in the banks of sutlej in lohian in jalandhar district is being plugged",lives,6,2,9,0,17,"ferozepur, gurdaspur, jalandhar, moga"
8/18/08,https://reliefweb.int/node/277023,"- due to heavy rainfall, ropar, jalandhar, moga, kapurthala, tarantaran & ferozepur districts have been flooded and about 37903 people from 244 villages in above districts are reported to have been affected severely",lives,33,6,50,0,89,"ferozepur, jalandhar, kapurthala, moga"
8/18/08,https://reliefweb.int/node/277023,- 23 cattle and 11700 hens have been perished and 50655 ha cropped area has been damaged,lives,33,6,50,0,89,"ferozepur, jalandhar, kapurthala, moga"
8/18/08,https://reliefweb.int/node/277023,- 09 boats and 03 medical teams have been deployed in the flood affected areas,lives,33,6,50,0,89,"ferozepur, jalandhar, kapurthala, moga"
8/18/08,https://reliefweb.int/node/277023,"- 11 relief camps have been opened in the affected areas - train, road communications, power and water supply have also been affected in ropar, jalandhar, moga, kapurthala, tarantaran & ferozepur districts",lives,33,6,50,0,89,"ferozepur, jalandhar, kapurthala, moga"
8/18/08,https://reliefweb.int/node/277023,- 10 army columns with 10 engineer task forces have been deployed in the flood affected areas for rescue and relief operations delhi - light rainfall has been reported in delhi and ncr during last 24 hours - no human death has been reported by the state during last 24 hours,lives,33,6,50,0,89,"ferozepur, jalandhar, kapurthala, moga"
8/18/08,https://reliefweb.int/node/277023,- about 19700 people from 126 villages are reported to have been affected severely,lives,33,6,50,0,89,"ferozepur, jalandhar, kapurthala, moga"
8/18/08,https://reliefweb.int/node/277023,- 176 medical teams have been deployed in the flood affected areas,lives,33,6,50,0,89,"ferozepur, jalandhar, kapurthala, moga"
8/18/08,https://reliefweb.int/node/277023,- 154 villages in 05 districts have been affected severally due to flood,lives,33,6,50,0,89,"ferozepur, jalandhar, kapurthala, moga"
8/18/08,https://reliefweb.int/node/277023,- in 44 relief camps about 5978 people have been accommodated,lives,33,6,50,0,89,"ferozepur, jalandhar, kapurthala, moga"
8/18/08,https://reliefweb.int/node/277023,- about 253586 people in 05 districts have been severally affected,lives,33,6,50,0,89,"ferozepur, jalandhar, kapurthala, moga"
8/18/08,https://reliefweb.int/node/277023,- in 51 relief camps about 19631 people have been accommodated,lives,33,6,50,0,89,"ferozepur, jalandhar, kapurthala, moga"
8/18/08,https://reliefweb.int/node/277023,- 405 medical camps have been established in the affected people,lives,33,6,50,0,89,"ferozepur, jalandhar, kapurthala, moga"
8/18/08,https://reliefweb.int/node/277023,- 06th ndrf bn at arakanam has been alerted to keep the sar teams ready for move on short notice for rescue and relief operations,lives,33,6,50,0,89,"ferozepur, jalandhar, kapurthala, moga"
8/18/08,https://reliefweb.int/node/277023,- total 1976 village in 06 districts have been affected severely,lives,33,6,50,0,89,"ferozepur, jalandhar, kapurthala, moga"
8/18/08,https://reliefweb.int/node/277023,- 02 teams consisting of 64 personnel continued to be deployed at chandrapur and kolhapur district for flood water rescue operation,lives,33,6,50,0,89,"ferozepur, jalandhar, kapurthala, moga"
8/18/08,https://reliefweb.int/node/277023,"- in all, 15,13,342 people have been affected in 11 districts in the state so far due to flood",lives,33,6,50,0,89,"ferozepur, jalandhar, kapurthala, moga"
8/18/08,https://reliefweb.int/node/277023,- 3239 villages have been affected,lives,33,6,50,0,89,"ferozepur, jalandhar, kapurthala, moga"
8/18/08,https://reliefweb.int/node/277023,"- in 252 relief camps, about 10029 people continued to be accommodated",lives,33,6,50,0,89,"ferozepur, jalandhar, kapurthala, moga"
8/18/08,https://reliefweb.int/node/277023,- 2047 boats and 116 mobile teams of doctors along with medicines have been deployed in the flood affected areas,lives,33,6,50,0,89,"ferozepur, jalandhar, kapurthala, moga"
8/18/08,https://reliefweb.int/node/277023,"- in all, about 6,14,000 people from 802 villages in 10 districts have been severally affected due to flood in the state",lives,33,6,50,0,89,"ferozepur, jalandhar, kapurthala, moga"
8/18/08,https://reliefweb.int/node/277023,- 1893 houses are reported to have been damaged due to flood so far,lives,33,6,50,0,89,"ferozepur, jalandhar, kapurthala, moga"
8/18/08,https://reliefweb.int/node/277023,- 734 boats have been pressed into service for rescue and relief operations in the flood affected areas of the state,lives,33,6,50,0,89,"ferozepur, jalandhar, kapurthala, moga"
8/18/08,https://reliefweb.int/node/277023,- in 05 relief camps about 2792 people continued to be accommodated,lives,33,6,50,0,89,"ferozepur, jalandhar, kapurthala, moga"
8/18/08,https://reliefweb.int/node/277023,"- about 4.93 lakh people, in all, are reported to have been affected in the state due to flood so far",lives,33,6,50,0,89,"ferozepur, jalandhar, kapurthala, moga"
8/18/08,https://reliefweb.int/node/277023,"- 15,865 people continued to be accommodated in 22 relief camps",lives,33,6,50,0,89,"ferozepur, jalandhar, kapurthala, moga"
8/18/08,https://reliefweb.int/node/277023,"- about 37.06 lakh people, in all, are reported to have been affected",lives,33,6,50,0,89,"ferozepur, jalandhar, kapurthala, moga"
8/18/08,https://reliefweb.int/node/277023,- 150 people continued to be accommodated in 05 relief camps in the state,lives,33,6,50,0,89,"ferozepur, jalandhar, kapurthala, moga"
8/18/08,https://reliefweb.int/node/277023,- 199 medical teams and 02 boats continued to be deployed in the affected areas of the state,lives,33,6,50,0,89,"ferozepur, jalandhar, kapurthala, moga"
8/18/08,https://reliefweb.int/node/277023,"human deaths - as per provisional information received from the affected states/uts, 103 human deaths were reported during last 24 hours, raising the total death toll to 1385 from 1282",lives,33,6,50,0,89,"ferozepur, jalandhar, kapurthala, moga"
8/18/08,https://reliefweb.int/node/276855,"india: flood fury - army moves in 10 cos  chandigarh: the punjab government had to call in army on saturday, to help the civil administration deal with this year's abnormally aggressive monsoon",lives,10,5,14,0,29,"ferozepur, jalandhar, kapurthala, moga, sas nagar"
8/18/08,https://reliefweb.int/node/276855,"however, as the river waters continued to breach their banks and hundreds of shelterless families still needing help, reinforcements were sent in a day later",lives,10,5,14,0,29,"ferozepur, jalandhar, kapurthala, moga, sas nagar"
8/18/08,https://reliefweb.int/node/276855,"on sunday, army moved in 10 companies to evacuate people from flood-affected areas of punjab, particularly in the districts of kapurthala, jalandhar, moga and ferozepur",lives,10,5,14,0,29,"ferozepur, jalandhar, kapurthala, moga, sas nagar"
8/18/08,https://reliefweb.int/node/276855,the state government has already evacuated 100 villages,lives,10,5,14,0,29,"ferozepur, jalandhar, kapurthala, moga, sas nagar"
8/18/08,https://reliefweb.int/node/276855,"""by saturday evening, close to a 100 civilians, including women and children, were rescued and moved to safe areas",lives,10,5,14,0,29,"ferozepur, jalandhar, kapurthala, moga, sas nagar"
8/17/08,https://reliefweb.int/node/276987,- total 200 villages in 06 districts have been affected severely due to recent flash flood,lives,32,2,42,0,76,moga
8/17/08,https://reliefweb.int/node/276987,- 2000 people have been evacuated from the affected areas and shifted to safer places,lives,32,2,42,0,76,moga
8/17/08,https://reliefweb.int/node/276987,- 154 villages in 05 districts have been affected severally in the state,lives,32,2,42,0,76,moga
8/17/08,https://reliefweb.int/node/276987,"- in 44 relief camps, about 5978 people have been accommodated",lives,32,2,42,0,76,moga
8/17/08,https://reliefweb.int/node/276987,- about 253586 people in 05 districts have been severally affected,lives,32,2,42,0,76,moga
8/17/08,https://reliefweb.int/node/276987,"- in, 51 relief camps about 19631 people have been accommodated",lives,32,2,42,0,76,moga
8/17/08,https://reliefweb.int/node/276987,- 405 medical camps have been established for providing medical care to the affected people,lives,32,2,42,0,76,moga
8/17/08,https://reliefweb.int/node/276987,- total 1976 village in 06 districts have been affected severely due heavy rainfall,lives,32,2,42,0,76,moga
8/17/08,https://reliefweb.int/node/276987,- 13950 people have been evacuated from the affected areas,lives,32,2,42,0,76,moga
8/17/08,https://reliefweb.int/node/276987,"- in, 35 relief camps about 462 people have been accommodated",lives,32,2,42,0,76,moga
8/17/08,https://reliefweb.int/node/276987,- 02 teams consisting of 64 personnel have been deployed at chandrapur and kolhapur district for flood water rescue operation,lives,32,2,42,0,76,moga
8/17/08,https://reliefweb.int/node/276987,"- in all, 15,13,342 people have been affected in 11 districts in the state so far due to flood",lives,32,2,42,0,76,moga
8/17/08,https://reliefweb.int/node/276987,- 3239 villages have been affected,lives,32,2,42,0,76,moga
8/17/08,https://reliefweb.int/node/276987,"- in,252 relief camps, 10029 people have been accommodated",lives,32,2,42,0,76,moga
8/17/08,https://reliefweb.int/node/276987,- 116 mobile teams of doctors along with medicines have been deployed in the flood affected areas for providing medical care,lives,32,2,42,0,76,moga
8/17/08,https://reliefweb.int/node/276987,"- in all, about 6,14,000 people from 802 villages in 10 districts have been severally affected due to flood in the state",lives,32,2,42,0,76,moga
8/17/08,https://reliefweb.int/node/276987,- 50911 persons have been evacuated from the affected areas so far,lives,32,2,42,0,76,moga
8/17/08,https://reliefweb.int/node/276987,- 05 relief camps have been opened in the flood affected area in which 2792 people have been accommodated,lives,32,2,42,0,76,moga
8/17/08,https://reliefweb.int/node/276987,"- in all, 4.93 lakh people are reported to have been affected in the state due to flood so far",lives,32,2,42,0,76,moga
8/17/08,https://reliefweb.int/node/276987,"- in 22 relief camps about 15,865 people have been accommodated",lives,32,2,42,0,76,moga
8/17/08,https://reliefweb.int/node/276987,"- about 37.06 lakh people, in all, are reported to have been affected in the state due to flood so far",lives,32,2,42,0,76,moga
8/17/08,https://reliefweb.int/node/276987,- 500 people continued to be accommodated in 10 relief camps in the state,lives,32,2,42,0,76,moga
8/17/08,https://reliefweb.int/node/276987,"human deaths - as per provisional information received from the affected states/uts, 02 human deaths were reported from punjab state during last 24 hours, raising the total death toll to 1282 from 1280",lives,32,2,42,0,76,moga
8/16/08,https://reliefweb.int/node/277005,- about 17.20 lakh people in 10 districts are reported to have been affected,lives,31,3,36,0,70,punjab
8/16/08,https://reliefweb.int/node/277005,"- 5161 feeders, 477 transformers and 2853 electricity poles in 10469 villages have been damaged",lives,31,3,36,0,70,punjab
8/16/08,https://reliefweb.int/node/277005,- 154 villages in 05 districts have been affected severally,lives,31,3,36,0,70,punjab
8/16/08,https://reliefweb.int/node/277005,"- in 44 relief camps, about 5978 people continued to be accommodated",lives,31,3,36,0,70,punjab
8/16/08,https://reliefweb.int/node/277005,- about 253586 people in 05 districts have been severally affected,lives,31,3,36,0,70,punjab
8/16/08,https://reliefweb.int/node/277005,- in 51 relief camps about 19631 people continued to be accommodated,lives,31,3,36,0,70,punjab
8/16/08,https://reliefweb.int/node/277005,- 405 medical camps established in the affected areas,lives,31,3,36,0,70,punjab
8/16/08,https://reliefweb.int/node/277005,- 06th ndrf bn at arakanam has been alerted to keep the sar teams ready for move on short notice for rescue and relief operations,lives,31,3,36,0,70,punjab
8/16/08,https://reliefweb.int/node/277005,- total 1976 village in 06 districts have been affected severely,lives,31,3,36,0,70,punjab
8/16/08,https://reliefweb.int/node/277005,- in 35 relief camps about 462 people continued to be accommodated,lives,31,3,36,0,70,punjab
8/16/08,https://reliefweb.int/node/277005,- 02 teams consisting of 64 personnel have been deployed at chandrapur and kolhapur district for flood water rescue operation,lives,31,3,36,0,70,punjab
8/16/08,https://reliefweb.int/node/277005,"- in all, 15,13,342 people have been affected in 11 districts in the state",lives,31,3,36,0,70,punjab
8/16/08,https://reliefweb.int/node/277005,- 3239 villages have been affected severally and 674 villages have been marooned in the state,lives,31,3,36,0,70,punjab
8/16/08,https://reliefweb.int/node/277005,- in 252 relief camps about 10029 people continued to be accommodated,lives,31,3,36,0,70,punjab
8/16/08,https://reliefweb.int/node/277005,- 2009 boats and 116 mobile teams of doctors along with medicines have been deployed in the flood affected areas,lives,31,3,36,0,70,punjab
8/16/08,https://reliefweb.int/node/277005,"- in all, about 6,14,000 people from 802 villages in 10 districts have been severally affected",lives,31,3,36,0,70,punjab
8/16/08,https://reliefweb.int/node/277005,- 701 boats continued to be deployed in the flood affected areas,lives,31,3,36,0,70,punjab
8/16/08,https://reliefweb.int/node/277005,- in 05 relief camps about 2792 people continued to be accommodated,lives,31,3,36,0,70,punjab
8/16/08,https://reliefweb.int/node/277005,"- about 4.93 lakh people, in all, are reported to have been affected in the state due to flood so far",lives,31,3,36,0,70,punjab
8/16/08,https://reliefweb.int/node/277005,"- 15,865 people continued to be accommodated in 22 relief camps",lives,31,3,36,0,70,punjab
8/16/08,https://reliefweb.int/node/277005,"- about 37.06 lakh people, in all, are reported to have been affected in the state",lives,31,3,36,0,70,punjab
8/16/08,https://reliefweb.int/node/277005,- 500 people continued to be accommodated in 10 relief camps,lives,31,3,36,0,70,punjab
8/16/08,https://reliefweb.int/node/277005,- 199 medical teams and 15 boats continued to be deployed in the affected areas,lives,31,3,36,0,70,punjab
8/16/08,https://reliefweb.int/node/277005,"human deaths - as per provisional information received from the affected states/uts, 04 human deaths were reported from uttarakhand state during last 24 hours, raising the total death toll to 1280 from 1276",lives,31,3,36,0,70,punjab
8/16/08,https://reliefweb.int/node/276738,india: 30 people rescued from flood-affected areas in punjab  jalandhar: army on saturday rescued 30 people from the flood-affected areas along the sutlej river after 10 villages in the district submerged due to 100-feet breach in its embankments,lives,9,3,22,0,34,"ferozepur, jalandhar"
8/15/08,https://reliefweb.int/node/277055,- about 17.20 lakh people in 10 districts have been affected,lives,29,5,41,0,75,punjab
8/15/08,https://reliefweb.int/node/277055,- 12 state and 57 panchayat roads are reportedly damaged due to heavy rainfall in the state,lives,29,5,41,0,75,punjab
8/15/08,https://reliefweb.int/node/277055,- 154 villages in 05 districts have been affected severally due to flood so far,lives,29,5,41,0,75,punjab
8/15/08,https://reliefweb.int/node/277055,"- in, 44 relief camps 5978 people have been accommodated",lives,29,5,41,0,75,punjab
8/15/08,https://reliefweb.int/node/277055,- about 253586 people in 05 districts have been severally affected,lives,29,5,41,0,75,punjab
8/15/08,https://reliefweb.int/node/277055,"- in, 51 relief camps, 19631 people have been accommodated",lives,29,5,41,0,75,punjab
8/15/08,https://reliefweb.int/node/277055,- 1976 village in 06 districts have been affected severely due heavy rainfall,lives,29,5,41,0,75,punjab
8/15/08,https://reliefweb.int/node/277055,"- in, 35 relief camps, 462 people have been accommodated",lives,29,5,41,0,75,punjab
8/15/08,https://reliefweb.int/node/277055,- 02 teams consisting of 64 personnel have been deployed at chandrapur and kolhapur district for flood water rescue operation,lives,29,5,41,0,75,punjab
8/15/08,https://reliefweb.int/node/277055,"- in all, 15,13,342 people have been affected in 11 districts in the state",lives,29,5,41,0,75,punjab
8/15/08,https://reliefweb.int/node/277055,- 3239 villages have been affected severally and 674 villages have been marooned in the state,lives,29,5,41,0,75,punjab
8/15/08,https://reliefweb.int/node/277055,- about 5367 people from the affected areas have been evacuated so far,lives,29,5,41,0,75,punjab
8/15/08,https://reliefweb.int/node/277055,- 252 relief camps have been opened in the flood affected areas in which 10029 people have been accommodated,lives,29,5,41,0,75,punjab
8/15/08,https://reliefweb.int/node/277055,"- in all, about 6,14,000 people from 10 districts have been affected in the state",lives,29,5,41,0,75,punjab
8/15/08,https://reliefweb.int/node/277055,- 1874 houses are reported to have been damaged due to flood so far,lives,29,5,41,0,75,punjab
8/15/08,https://reliefweb.int/node/277055,- 701 boats have been pressed into service for rescue and relief operations in the flood affected areas of the state,lives,29,5,41,0,75,punjab
8/15/08,https://reliefweb.int/node/277055,- 50911 persons have been evacuated from the affected areas so far,lives,29,5,41,0,75,punjab
8/15/08,https://reliefweb.int/node/277055,- 05 relief camps have been opened in the flood affected area in which 2792 people have been accommodated,lives,29,5,41,0,75,punjab
8/15/08,https://reliefweb.int/node/277055,"- about 4.93 lakh people, in all, are reported to have been affected in the state due to flood so far",lives,29,5,41,0,75,punjab
8/15/08,https://reliefweb.int/node/277055,"- 15,865 people continued to be accommodated in 22 relief camps in the flood affected areas of the state",lives,29,5,41,0,75,punjab
8/15/08,https://reliefweb.int/node/277055,"- about 37.06 lakh people, in all, are reported to have been affected in the state due to flood so far",lives,29,5,41,0,75,punjab
8/15/08,https://reliefweb.int/node/277055,"- in, 10 relief camps about 500 people continued to be accommodated",lives,29,5,41,0,75,punjab
8/15/08,https://reliefweb.int/node/277055,- 199 medical teams continued to be deployed in the affected areas,lives,29,5,41,0,75,punjab
8/15/08,https://reliefweb.int/node/277055,"human deaths - as per provisional information received from the affected states/uts, 32 human deaths (andhra pradesh -15, west bengal-11, kerala & maharashtra -02 each and goa & karnataka - 01 each) were reported during last 24 hours, raising the total death toll to 1276 from 1244",lives,29,5,41,0,75,punjab
8/14/08,https://reliefweb.int/node/276931,- about 17.20 lakh people in 10 districts have been affected so far,lives,33,3,38,0,74,mansa
8/14/08,https://reliefweb.int/node/276931,- in 34 relief camps about 7855 people have been accommodated,lives,33,3,38,0,74,mansa
8/14/08,https://reliefweb.int/node/276931,- 330 medical teams consisting of 136 medical officers and 1035 paramedical staff have been deployed in the affected areas,lives,33,3,38,0,74,mansa
8/14/08,https://reliefweb.int/node/276931,"- 12 state, 57 panchayat roads, 5161 feeders, 477 transformers and 2853 electricity poles in 10469 villages have been damaged",lives,33,3,38,0,74,mansa
8/14/08,https://reliefweb.int/node/276931,- 64 villages in 05 districts have been affected severally so far,lives,33,3,38,0,74,mansa
8/14/08,https://reliefweb.int/node/276931,- in 44 relief camps about 5978 people have been accommodated,lives,33,3,38,0,74,mansa
8/14/08,https://reliefweb.int/node/276931,- about 245514 people in 05 districts have been severally affected,lives,33,3,38,0,74,mansa
8/14/08,https://reliefweb.int/node/276931,- in 51 relief camps about 19631 people have been accommodated,lives,33,3,38,0,74,mansa
8/14/08,https://reliefweb.int/node/276931,- 06th ndrf bn at arakanam has been alerted to keep the sar teams ready for move on short notice for rescue and relief operations,lives,33,3,38,0,74,mansa
8/14/08,https://reliefweb.int/node/276931,- total 1976 village in 06 districts have been affected severely,lives,33,3,38,0,74,mansa
8/14/08,https://reliefweb.int/node/276931,- in 35 relief camps about 462 people have been accommodated,lives,33,3,38,0,74,mansa
8/14/08,https://reliefweb.int/node/276931,- 02 teams consisting of 64 personnel have been deployed at chandrapur and kolhapur district for flood water rescue operation,lives,33,3,38,0,74,mansa
8/14/08,https://reliefweb.int/node/276931,"- in all, 15.13 lakh people have been affected in 11 districts in the state",lives,33,3,38,0,74,mansa
8/14/08,https://reliefweb.int/node/276931,- 3239 villages have been affected severally and 674 villages have been marooned in the state,lives,33,3,38,0,74,mansa
8/14/08,https://reliefweb.int/node/276931,- in 252 relief camps about 10029 people continued to be accommodated,lives,33,3,38,0,74,mansa
8/14/08,https://reliefweb.int/node/276931,- 116 mobile teams of doctors along with medicines have been deployed in the flood affected areas,lives,33,3,38,0,74,mansa
8/14/08,https://reliefweb.int/node/276931,- 17 companies of pac have been deployed with 184 motorized boats and 88 wooden boats in the affected areas for relief and rescue operations,lives,33,3,38,0,74,mansa
8/14/08,https://reliefweb.int/node/276931,"- in all, about 6,14,000 people from 802 villages in 10 districts have been severally affected in the state",lives,33,3,38,0,74,mansa
8/14/08,https://reliefweb.int/node/276931,- in 05 relief camps about 2792 people continued to be accommodated,lives,33,3,38,0,74,mansa
8/14/08,https://reliefweb.int/node/276931,"- about 4.93 lakh people, in all, are reported to have been affected so far",lives,33,3,38,0,74,mansa
8/14/08,https://reliefweb.int/node/276931,"- in 22 relief camps about 15,865 people continued to be accommodated",lives,33,3,38,0,74,mansa
8/14/08,https://reliefweb.int/node/276931,"- about 37.06 lakh people, in all, are reported to have been affected so far",lives,33,3,38,0,74,mansa
8/14/08,https://reliefweb.int/node/276931,- in 81 relief camps about 17300 people continued to be accommodated,lives,33,3,38,0,74,mansa
8/14/08,https://reliefweb.int/node/276931,- 199 medical teams and 15 boats continued to be deployed in the affected areas,lives,33,3,38,0,74,mansa
8/14/08,https://reliefweb.int/node/276931,"human deaths - as per provisional information received from the affected states/uts, 37 human deaths (gujarat-14, karnataka-13, uttar pradesh-6, kerala-2 and bihar & maharashtra-1 each) were reported during last 24 hours, raising the total death toll to 1244 from 1207",lives,33,3,38,0,74,mansa
8/9/08,https://reliefweb.int/node/275899,- about 6286 people in 05 districts have been severally affected,lives,21,3,33,0,57,punjab
8/9/08,https://reliefweb.int/node/275899,- 07 relief camps have been opened in the flood affected areas in which 7808 people have been accommodated,lives,21,3,33,0,57,punjab
8/9/08,https://reliefweb.int/node/275899,"- in all, 14,36,135 people have been affected in 11 districts in the state",lives,21,3,33,0,57,punjab
8/9/08,https://reliefweb.int/node/275899,- 3134 villages have been affected severally and 531 villages have been marooned in the state,lives,21,3,33,0,57,punjab
8/9/08,https://reliefweb.int/node/275899,- 22294 houses have been damaged so far,lives,21,3,33,0,57,punjab
8/9/08,https://reliefweb.int/node/275899,"- in 247 relief camps, 8875 people have been accommodated",lives,21,3,33,0,57,punjab
8/9/08,https://reliefweb.int/node/275899,"- in all, 5,92,000 people from 789 villages in 10 districts have been severally affected",lives,21,3,33,0,57,punjab
8/9/08,https://reliefweb.int/node/275899,- 1874 houses are reported to have been damaged due to flood so far,lives,21,3,33,0,57,punjab
8/9/08,https://reliefweb.int/node/275899,"- in 05 relief camps, 2792 people have been accommodated",lives,21,3,33,0,57,punjab
8/9/08,https://reliefweb.int/node/275899,"- in all, about 4.93 lakh people have been affected in the state",lives,21,3,33,0,57,punjab
8/9/08,https://reliefweb.int/node/275899,"- in 22 relief camps, about 15,865 people have been accommodated",lives,21,3,33,0,57,punjab
8/9/08,https://reliefweb.int/node/275899,"- in all, about 37.06 lakh people are reported to have been affected",lives,21,3,33,0,57,punjab
8/9/08,https://reliefweb.int/node/275899,"- in 81 relief camps, about 17300 people have been accommodated",lives,21,3,33,0,57,punjab
8/9/08,https://reliefweb.int/node/275899,- 199 medical teams continued to be deployed in the affected areas for providing medical care,lives,21,3,33,0,57,punjab
8/9/08,https://reliefweb.int/node/275899,- 398401 houses have been damaged due to flood,lives,21,3,33,0,57,punjab
8/9/08,https://reliefweb.int/node/275899,"human deaths - as per provisional information received from the affected states/uts, 08 human deaths (himachal pradesh-07 (previous deaths reported today) and punjab -01) were reported during last 24 hours, raising the total death toll to 1054 from 1046",lives,21,3,33,0,57,punjab
6/16/08,https://reliefweb.int/node/270161,"india: assam reels under floods, orissa sounds alert  new delhi: as people, particularly farmers, cheered the early monsoons in north india, those in assam blamed it on the rain god as army was called out to rescue marooned people in the flood-hit state even as rain- related incidents claimed over 10 lives elsewhere",lives,15,16,10,0,41,jalandhar
6/16/08,https://reliefweb.int/node/270161,a woman drowned and five houses were damaged in doda and reasi districts of jammu and kashmir following heavy rains and flash floods,lives,15,16,10,0,41,jalandhar
10/2/07,https://reliefweb.int/node/245244," - 3,03,800 people continue to be accommodated in 2059 relief camps",lives,6,3,20,0,29,punjab
10/2/07,https://reliefweb.int/node/245244,- 590772 (208805 fully & 381967 partially) houses are reported to have been damaged,lives,6,3,20,0,29,punjab
10/2/07,https://reliefweb.int/node/245244,- 25.85 lakh people in 3111 villages are reported so far to have been affected severely,lives,6,3,20,0,29,punjab
10/2/07,https://reliefweb.int/node/245244,"- so far, 10245 villages in 26 districts with population of 108.67 lakh are reported to have been affected in the state",lives,6,3,20,0,29,punjab
10/2/07,https://reliefweb.int/node/245244,"- about 35 relief camps in karimganj, hailakandi, cachar and lakhimpur districts continue to run in which about 52,000 people are accommodated",lives,6,3,20,0,29,punjab
10/2/07,https://reliefweb.int/node/245244," - so far, 10,843 villages in 22 districts (244 blocks & 3011 panchayats) with population of 226.73 lakh are reported to have been affected in the state - 1672 relief camps continue to run in the state in which about 10,05,637 people have been accommodated",lives,6,3,20,0,29,punjab
10/2/07,https://reliefweb.int/node/245244," loss of human lives as per provisional information received from the affected states, 07 human deaths have been reported during the last 24 hrs",lives,6,3,20,0,29,punjab
10/2/07,https://reliefweb.int/node/245244,the cumulative number of people who have lost their lives during the south west monsoon so far is 3195,lives,6,3,20,0,29,punjab
8/18/07,https://reliefweb.int/node/240663,about 52 persons were reported to have been washed away and 17 houses destroyed,lives,23,16,57,0,96,"roopnagar, sangrur, sas nagar"
8/18/07,https://reliefweb.int/node/240663,"out of the missing, dead bodies of only 08 persons have been recovered so far",lives,23,16,57,0,96,"roopnagar, sangrur, sas nagar"
8/18/07,https://reliefweb.int/node/240663, - one army column and para-military personnel continue to be engaged for rescue and relief operations,lives,23,16,57,0,96,"roopnagar, sangrur, sas nagar"
8/18/07,https://reliefweb.int/node/240663, - 01 state and 36 panchayat roads were damaged in the state,lives,23,16,57,0,96,"roopnagar, sangrur, sas nagar"
8/18/07,https://reliefweb.int/node/240663,"total 17 feeders, 43 transformers and 2920 electricity poles in these villages have been damaged/uprooted",lives,23,16,57,0,96,"roopnagar, sangrur, sas nagar"
8/18/07,https://reliefweb.int/node/240663,- 575 medical teams consisting of 313 medical officers and 1391 para medical staff continue to be deployed in the affected districts of the state for providing medical care,lives,23,16,57,0,96,"roopnagar, sangrur, sas nagar"
8/18/07,https://reliefweb.int/node/240663, - 1437 villages in 19 districts with population of about 11.88 lakh are reported to have been affected in the state,lives,23,16,57,0,96,"roopnagar, sangrur, sas nagar"
8/18/07,https://reliefweb.int/node/240663,#NAME?,lives,23,16,57,0,96,"roopnagar, sangrur, sas nagar"
8/18/07,https://reliefweb.int/node/240663,"- 13 relief camps continue to run in the state in which 68,000 people have been accommodated",lives,23,16,57,0,96,"roopnagar, sangrur, sas nagar"
8/18/07,https://reliefweb.int/node/240663,- 06 pac companies continue to be deployed in the affected districts of the state for rescue and relief operations,lives,23,16,57,0,96,"roopnagar, sangrur, sas nagar"
8/18/07,https://reliefweb.int/node/240663,- 7612 villages in 19 districts (195 blocks & 2081 panchayats) with population of 152.93 lakh are reported to have been affected in the state,lives,23,16,57,0,96,"roopnagar, sangrur, sas nagar"
8/18/07,https://reliefweb.int/node/240663,- 474 medical teams continue to be deployed in the affected districts of the state for providing medical care,lives,23,16,57,0,96,"roopnagar, sangrur, sas nagar"
8/18/07,https://reliefweb.int/node/240663,"- 1129 relief camps continue to run in the state in which about 3,05,793 people have been accommodated",lives,23,16,57,0,96,"roopnagar, sangrur, sas nagar"
8/18/07,https://reliefweb.int/node/240663, - 5989 boats continue to be deployed in the affected areas of the state for rescue and relief operations,lives,23,16,57,0,96,"roopnagar, sangrur, sas nagar"
8/18/07,https://reliefweb.int/node/240663,- 341 cattle camps continue to run in the affected districts of the state,lives,23,16,57,0,96,"roopnagar, sangrur, sas nagar"
8/18/07,https://reliefweb.int/node/240663,"- 5946 villages in 26 districts with population of 68,16 lakh are reported to have been affected in the state",lives,23,16,57,0,96,"roopnagar, sangrur, sas nagar"
8/18/07,https://reliefweb.int/node/240663,- 1412 villages in 25 districts with population of 11.29 lakh are reported to have been affected in the state,lives,23,16,57,0,96,"roopnagar, sangrur, sas nagar"
8/18/07,https://reliefweb.int/node/240663,"- 123 relief camps continue to run in the state in which about 22,000 people are accommodated",lives,23,16,57,0,96,"roopnagar, sangrur, sas nagar"
8/18/07,https://reliefweb.int/node/240663," - in 14 districts, 17.63 lakh population is reported to have been affected in the state",lives,23,16,57,0,96,"roopnagar, sangrur, sas nagar"
8/18/07,https://reliefweb.int/node/240663,- 38 relief camps continue to run in the state where 1727 people are accommodated,lives,23,16,57,0,96,"roopnagar, sangrur, sas nagar"
8/18/07,https://reliefweb.int/node/240663,"- 03 teams of ndrf (kozhikode, alappuzha & idukki) continue to be deployed in the state for rescue and relief work",lives,23,16,57,0,96,"roopnagar, sangrur, sas nagar"
8/18/07,https://reliefweb.int/node/240663,"loss of human lives - as per provisional information received from the affected states, 14 human deaths have been reported during the last 24 hrs",lives,23,16,57,0,96,"roopnagar, sangrur, sas nagar"
8/18/07,https://reliefweb.int/node/240663,the cumulative number of people who lost their lives during the south west monsoon so far is 1936,lives,23,16,57,0,96,"roopnagar, sangrur, sas nagar"
8/17/07,https://reliefweb.int/node/240777,- about 26 villages are reported to have been affected severely,lives,24,11,61,0,96,"roopnagar, sangrur, sas nagar"
8/17/07,https://reliefweb.int/node/240777," - about 6,000 people are reported to have been affected",lives,24,11,61,0,96,"roopnagar, sangrur, sas nagar"
8/17/07,https://reliefweb.int/node/240777,about 52 persons are reported to have been washed away and 17 houses destroyed,lives,24,11,61,0,96,"roopnagar, sangrur, sas nagar"
8/17/07,https://reliefweb.int/node/240777,"out of the missing, dead bodies of only 08 persons have been recovered so far",lives,24,11,61,0,96,"roopnagar, sangrur, sas nagar"
8/17/07,https://reliefweb.int/node/240777,#NAME?,lives,24,11,61,0,96,"roopnagar, sangrur, sas nagar"
8/17/07,https://reliefweb.int/node/240777, - 01 state and 36 panchayat roads continue to be damaged in the state,lives,24,11,61,0,96,"roopnagar, sangrur, sas nagar"
8/17/07,https://reliefweb.int/node/240777,"total 20 feeders, 52 transformers and 3205 electricity poles in these villages have been damaged/uprooted",lives,24,11,61,0,96,"roopnagar, sangrur, sas nagar"
8/17/07,https://reliefweb.int/node/240777,- 563 medical teams consisting of 327 medical officers and 1387 para medical staff continue to be deployed in the affected districts of the state for providing medical care,lives,24,11,61,0,96,"roopnagar, sangrur, sas nagar"
8/17/07,https://reliefweb.int/node/240777, - 1437 villages in 19 districts with population of about 11.88 lakh are reported to have been affected in the state,lives,24,11,61,0,96,"roopnagar, sangrur, sas nagar"
8/17/07,https://reliefweb.int/node/240777,"- 15 relief camps continue to run in the state in which 68,000 people have been accommodated",lives,24,11,61,0,96,"roopnagar, sangrur, sas nagar"
8/17/07,https://reliefweb.int/node/240777,- 02 pac companies continue to be deployed in the affected districts of the state for rescue and relief operations,lives,24,11,61,0,96,"roopnagar, sangrur, sas nagar"
8/17/07,https://reliefweb.int/node/240777,- 460 boats continue to be deployed in the affected areas of the state for rescue and relief operations,lives,24,11,61,0,96,"roopnagar, sangrur, sas nagar"
8/17/07,https://reliefweb.int/node/240777,- 7612 villages in 19 districts (195 blocks & 2081 panchayats) with population of 152.93 lakh are reported to have been affected in the state,lives,24,11,61,0,96,"roopnagar, sangrur, sas nagar"
8/17/07,https://reliefweb.int/node/240777,- 474 medical teams continue to be deployed in the affected districts of the state for providing medical care,lives,24,11,61,0,96,"roopnagar, sangrur, sas nagar"
8/17/07,https://reliefweb.int/node/240777,"- 1129 relief camps continue to run in the state in which about 3,05,793 people have been accommodated",lives,24,11,61,0,96,"roopnagar, sangrur, sas nagar"
8/17/07,https://reliefweb.int/node/240777, - 5989 boats continue to be deployed in the affected areas of the state for rescue and relief operations,lives,24,11,61,0,96,"roopnagar, sangrur, sas nagar"
8/17/07,https://reliefweb.int/node/240777,- 341 cattle camps continue to run in the affected districts of the state,lives,24,11,61,0,96,"roopnagar, sangrur, sas nagar"
8/17/07,https://reliefweb.int/node/240777, - 5946 villages in 26 districts with population of 68.16 lakh are reported to have been affected in the state,lives,24,11,61,0,96,"roopnagar, sangrur, sas nagar"
8/17/07,https://reliefweb.int/node/240777,"- 12 relief camps accommodating 4,320 people and 17 relief centres accommodating 7,500 people are running in the state",lives,24,11,61,0,96,"roopnagar, sangrur, sas nagar"
8/17/07,https://reliefweb.int/node/240777, - 1412 villages in 25 districts with population of 11.29 lakh are reported to have been affected in the state,lives,24,11,61,0,96,"roopnagar, sangrur, sas nagar"
8/17/07,https://reliefweb.int/node/240777,"- 123 relief camps continue to run in the state in which about 21,636 people are accommodated",lives,24,11,61,0,96,"roopnagar, sangrur, sas nagar"
8/17/07,https://reliefweb.int/node/240777," - in 14 districts, 17.63 lakh population is reported to have been affected in the state",lives,24,11,61,0,96,"roopnagar, sangrur, sas nagar"
8/17/07,https://reliefweb.int/node/240777,- 68 relief camps continue to run in the state where 2876 people are accommodated,lives,24,11,61,0,96,"roopnagar, sangrur, sas nagar"
8/17/07,https://reliefweb.int/node/240777,"- 03 teams of ndrf (kozhikode, alappuzha & idukki) continue to be deployed in the state for rescue and relief work",lives,24,11,61,0,96,"roopnagar, sangrur, sas nagar"
8/17/07,https://reliefweb.int/node/240777,"loss of human lives - as per provisional information received from the affected states, 32 human deaths have been reported during the last 24 hrs",lives,24,11,61,0,96,"roopnagar, sangrur, sas nagar"
8/17/07,https://reliefweb.int/node/240777,the cumulative number of people who lost their lives during the south west monsoon so far is 1915,lives,24,11,61,0,96,"roopnagar, sangrur, sas nagar"
7/17/07,https://reliefweb.int/node/244592,"about 20,000 people, who were staying in 120 temporary shelters and 01 relief camp continue to stay there",lives,5,10,22,0,37,punjab
7/17/07,https://reliefweb.int/node/244592,- 26 panchayat and 06 state roads which were damaged are under repair,lives,5,10,22,0,37,punjab
7/17/07,https://reliefweb.int/node/244592,- 791 medical teams consisting 278 medical officers and 1788 para-medical staff continues to be deployed in the affected districts,lives,5,10,22,0,37,punjab
7/17/07,https://reliefweb.int/node/244592,- 8239 people are staying in 93 relief centres,lives,5,10,22,0,37,punjab
7/17/07,https://reliefweb.int/node/244592,"- due to landslide in darjeeling, the national highway-55, between  darjeeling & siliguri has been damaged at 02 different places causing disruption in traffic movement on this section",lives,5,10,22,0,37,punjab
7/17/07,https://reliefweb.int/node/244592,- about 105378 people are still staying in 373 relief centres,lives,5,10,22,0,37,punjab
7/17/07,https://reliefweb.int/node/244592,"loss of human lives -as per provisional information received from the affected states 33 human deaths (kerala-14, gujarat & maharashtra 06 each, karnataka & punjab-2 each, madhya pradesh, chhattisgarh & west bengal-01 each) have been reported during the last 24 hrs",lives,5,10,22,0,37,punjab
7/17/07,https://reliefweb.int/node/244592,the cumulative number of people who lost their lives during the south west monsoon so far is 888,lives,5,10,22,0,37,punjab
10/21/19,https://www.tribuneindia.com/news/punjab/flood-hit-farmers-to-get-9k-quintal-wheat-seed/849947.html,flood-hit farmers to get 9k-quintal wheat seed,agri,2,43,10,1,56,jalandhar
10/21/19,https://www.tribuneindia.com/news/punjab/flood-hit-farmers-to-get-9k-quintal-wheat-seed/849947.html,"jalandhar, october 20  in a major initiative aimed at providing succour to farmers of flood-affected villages in the district, the punjab government will distribute around 9,000 quintals of high-yielding varieties of wheat seeds to food growers free of cost",agri,2,43,10,1,56,jalandhar
10/21/19,https://www.tribuneindia.com/news/punjab/flood-hit-farmers-to-get-9k-quintal-wheat-seed/849947.html,"he said in total, 25,000 quintals of wheat seeds would be supplied to farmers in flood-affected villages across the state",agri,2,43,10,1,56,jalandhar
10/21/19,https://www.tribuneindia.com/news/punjab/flood-hit-farmers-to-get-9k-quintal-wheat-seed/849947.html,"he said of this, nearly 9,000 quintals of seeds would be distributed to farmers who had suffered losses during floods in the sutlej",agri,2,43,10,1,56,jalandhar
10/21/19,https://www.tribuneindia.com/news/punjab/flood-hit-farmers-to-get-9k-quintal-wheat-seed/849947.html,"  chief agriculture officer naazar singh said 9,000 quintal of wheat seed was expected to reach jalandhar in the coming week",agri,2,43,10,1,56,jalandhar
10/16/19,https://www.tribuneindia.com/news/punjab/debt-relief-likely-for-flood-hit-farmers/847607.html,"ruchika m khanna tribune news service chandigarh, october 15  the state government is mulling deferment of repayment of crop loans availed by farmers in flood-hit villages of doaba and malwa region by three years",agri,2,64,14,0,80,punjab
10/16/19,https://www.tribuneindia.com/news/punjab/debt-relief-likely-for-flood-hit-farmers/847607.html," according to a proposal, farmers in 14 districts (794 villages) of the state, whose standing crops were damaged in the floods that occurred in august, would be able to repay the crop loans that they took in april this year within the next three years",agri,2,64,14,0,80,punjab
10/16/19,https://www.tribuneindia.com/news/punjab/debt-relief-likely-for-flood-hit-farmers/847607.html," as much as rs 9,700 crore worth of crop loan was disbursed by cooperative banks in punjab in april to 7.50 lakh farmers",agri,2,64,14,0,80,punjab
10/16/19,https://www.tribuneindia.com/news/punjab/debt-relief-likely-for-flood-hit-farmers/847607.html,"while marginal farmers (having up to 2.5 acres) got rs 57,000 per acre as loan, small farmers (having up to 5 acres) got rs 78,000 per acre as crop loan",agri,2,64,14,0,80,punjab
10/16/19,https://www.tribuneindia.com/news/punjab/debt-relief-likely-for-flood-hit-farmers/847607.html,"large farmers get up to rs 27,000 per acre as crop loan",agri,2,64,14,0,80,punjab
10/16/19,https://www.tribuneindia.com/news/punjab/debt-relief-likely-for-flood-hit-farmers/847607.html,"ush({ });  according to estimates prepared by the revenue department, which conducted a special girdawari to assess the crop losses, paddy worth rs 507 crore on 51,364 hectares, maize on 5,553 hectares and sugarcane on 863 hectares, besides fruits and vegetables on 1,304 on 1,306 hectares was damaged in the floods",agri,2,64,14,0,80,punjab
10/14/19,https://www.tribuneindia.com/news/punjab/no-wheat-seed-disbursal-farmers-livid/846770.html,"aparna banerji tribune news service jalandhar, october 13  the free of cost wheat seed disbursal in 13 villages of kapurthala has been hit due to the election code of conduct for the phagwara bypolls",agri,3,78,9,2,92,"jalandhar, kapurthala"
10/14/19,https://www.tribuneindia.com/news/punjab/no-wheat-seed-disbursal-farmers-livid/846770.html,the government‚Äôs decision to disburse wheat seed to flood-affected villagers from october 21 (after the phagwara bypolls) has earned them farming community‚Äôs ire,agri,3,78,9,2,92,"jalandhar, kapurthala"
10/14/19,https://www.tribuneindia.com/news/punjab/no-wheat-seed-disbursal-farmers-livid/846770.html, farmers say their fields will be ready for sowing in a week or 10 days and the government should ensure early disbursal of wheat seed keeping in view the bypoll,agri,3,78,9,2,92,"jalandhar, kapurthala"
10/14/19,https://www.tribuneindia.com/news/punjab/no-wheat-seed-disbursal-farmers-livid/846770.html,they said seed disbursal after october 21 will considerably delay wheat sowing putting farmers in the flood-hit areas in a fix,agri,3,78,9,2,92,"jalandhar, kapurthala"
10/14/19,https://www.tribuneindia.com/news/punjab/no-wheat-seed-disbursal-farmers-livid/846770.html,"ush({ });  paramjit singh from channwindi village said, ‚Äúthe ideal time to sow wheat crop is till october 25",agri,3,78,9,2,92,"jalandhar, kapurthala"
10/14/19,https://www.tribuneindia.com/news/punjab/no-wheat-seed-disbursal-farmers-livid/846770.html,the provision of seeds after october 21 will be too late and will hit wheat sowing,agri,3,78,9,2,92,"jalandhar, kapurthala"
10/14/19,https://www.tribuneindia.com/news/punjab/no-wheat-seed-disbursal-farmers-livid/846770.html,"after incurring huge losses in the foods, farmers will now be forced to shell rs 5,000 to rs 10,000 per acre on wheat sowing",agri,3,78,9,2,92,"jalandhar, kapurthala"
10/14/19,https://www.tribuneindia.com/news/punjab/no-wheat-seed-disbursal-farmers-livid/846770.html,the seeds shall readily be distributed among farmers if need be from october 21 in the evening itself after the bypolls,agri,3,78,9,2,92,"jalandhar, kapurthala"
10/14/19,https://www.tribuneindia.com/news/punjab/no-wheat-seed-disbursal-farmers-livid/846770.html,the time formally designated by the government for wheat sowing is from october 21 to november 15,agri,3,78,9,2,92,"jalandhar, kapurthala"
10/14/19,https://www.tribuneindia.com/news/punjab/farmers-in-flood-affected-areas-to-get-free-wheat-seed/846749.html,"tribune news service  moga, october 13 the state government will provide high-quality wheat crop seeds to flood-hit farmers in moga, jalandhar, kapurthala, ferozepur, fazilka and other flood-affected districts for the upcoming rabi season",agri,2,54,11,3,70,"fazilka, ferozepur, jalandhar, kapurthala, moga"
10/14/19,https://www.tribuneindia.com/news/punjab/farmers-in-flood-affected-areas-to-get-free-wheat-seed/846749.html,"accordingly, 30,000 quintals of wheat seed will be provided by the punjab state seeds corporation in the next few weeks",agri,2,54,11,3,70,"fazilka, ferozepur, jalandhar, kapurthala, moga"
10/14/19,https://www.tribuneindia.com/news/punjab/farmers-in-flood-affected-areas-to-get-free-wheat-seed/846749.html,"the quality seed of wheat crop costs around rs 3,000 per quintal",agri,2,54,11,3,70,"fazilka, ferozepur, jalandhar, kapurthala, moga"
10/14/19,https://www.tribuneindia.com/news/punjab/farmers-in-flood-affected-areas-to-get-free-wheat-seed/846749.html,"meanwhile, chief agriculture officer, moga, dr balwinder singh, and plant protection officer dr jaswinder singh brar said 7,000 hectares was affected by the floods in the district",agri,2,54,11,3,70,"fazilka, ferozepur, jalandhar, kapurthala, moga"
10/11/19,https://www.tribuneindia.com/news/punjab/business-sinks-in-mandis-of-flood-hit-lohian/845334.html,"owning four acres of land, he made good money last season",agri,1,23,9,1,34,jalandhar
10/10/19,https://www.tribuneindia.com/news/punjab/no-festive-cheer-flood-hit-areas-grapple-with-gloom/844861.html," ‚Äúi will borrow money from relatives or friends to at least give them sweets,‚Äù says kala singh, whose standing paddy crop on two acres was ruined in the recent floods",agri,3,15,13,2,33,jalandhar
10/10/19,https://www.tribuneindia.com/news/punjab/no-festive-cheer-flood-hit-areas-grapple-with-gloom/844861.html," out to feed his cattle, sukhdev singh, a septuagenarian, said of his 18 cows, only eight were left",agri,3,15,13,2,33,jalandhar
10/10/19,https://www.tribuneindia.com/news/punjab/no-festive-cheer-flood-hit-areas-grapple-with-gloom/844861.html,he has two acres of land along with two more on lease but the crop has been destroyed,agri,3,15,13,2,33,jalandhar
9/19/19,https://www.tribuneindia.com/news/punjab/flood-leaves-white-layer-in-fields-of-muktsar/834669.html,"archit watts tribune news service muktsar, september 18 after the dewatering work, a white layer called ‚Äòshora‚Äô (efflorescence) can be seen on the agricultural land in some parts of muktsar district",agri,4,29,15,2,50,sri muktsar sahib
9/19/19,https://www.tribuneindia.com/news/punjab/flood-leaves-white-layer-in-fields-of-muktsar/834669.html," notably, rains in mid-july had inundated nearly 25,000 acres and some residential areas in 58 villages",agri,4,29,15,2,50,sri muktsar sahib
9/19/19,https://www.tribuneindia.com/news/punjab/flood-leaves-white-layer-in-fields-of-muktsar/834669.html,"notably, the state government gives rs 12,000 per acre in such cases",agri,4,29,15,2,50,sri muktsar sahib
9/19/19,https://www.tribuneindia.com/news/punjab/flood-leaves-white-layer-in-fields-of-muktsar/834669.html,"as per the existing norms, farmers will get rs 12,000 per acre for their loss",agri,4,29,15,2,50,sri muktsar sahib
9/18/19,https://www.tribuneindia.com/news/punjab/akalis-for-release-of-sikh-prisoners/834054.html," the committee demanded rs 25,000 per acre as compensation for the crop loss or damage and a matching grant to farm labourers affected by the floods",agri,2,7,9,3,21,punjab
9/18/19,https://www.tribuneindia.com/news/punjab/post-floods-contamination-threat-looms-over-35-villages/834045.html,"you or your animals should do so at your own risk) booms a gurdwara microphone at chananwindi village in kapurthala, issuing a warning to villagers not to drink water from the overhead tank",agri,5,9,22,0,36,"jalandhar, kapurthala"
9/14/19,https://www.tribuneindia.com/news/punjab/parties-spar-over-drugs-economic-slump/832152.html,"ush({ }); shiromani akali dal    shiromani akali dal (sad) chief and former deputy chief minister sukhbir singh badal called the state government a ‚Äúcomplete failure‚Äù and alleged that contrary to the claims, nothing concrete had been done for farmers of flood-hit areas in punjab",agri,1,8,1,6,16,"amritsar, fatehgarh sahib, ludhiana, patiala, sangrur"
9/14/19,https://www.tribuneindia.com/news/punjab/jalandhar-kapurthala-losses-pegged-at-rs-526-cr/832145.html," with a total of 75,000 acres submerged in floodwaters in both districts, jalandhar pegged its losses at rs 270 crore while kapurthala reported losses to the tune of rs 256 crore to the central team which visited flood-hit areas here today",agri,2,58,49,4,113,"jalandhar, kapurthala"
9/14/19,https://www.tribuneindia.com/news/punjab/jalandhar-kapurthala-losses-pegged-at-rs-526-cr/832145.html," in jalandhar, the divisional commissioner and deputy commissioner sought compensation of rs 224 crore for agricultural losses, rs 78.25 lakh for loss of animals and provision of fodder, rs 15 crore for damage to more than 3,000 houses in 29 villages, rs 20 crore for plugging breaches and for further strengthening embankments, rs 7 crore for repair of the 83-km link road, rs 1.50 crore for repair of 15 down feeders, 200 transformers and a 66-kv sub-station at mehrajwala besides rs 1 crore for the repair of water works in flood-affected villages",agri,2,58,49,4,113,"jalandhar, kapurthala"
9/14/19,https://www.tribuneindia.com/news/punjab/jalandhar-kapurthala-losses-pegged-at-rs-526-cr/832145.html,"ush({ });  in kapurthala, crop losses have been pegged at rs 160 crore which includes rs 60 crore for bandh repairs and rs 85 lakh for damaged roads and houses, including 1,618 cattle deaths",agri,2,58,49,4,113,"jalandhar, kapurthala"
9/14/19,https://www.tribuneindia.com/news/punjab/jalandhar-kapurthala-losses-pegged-at-rs-526-cr/832145.html,"rs40k/acre girdawari sought  in both districts, farmers sought rs 40,000 compensation for per-acre crop loss rather than the rs 12,000 per acre as per current government norms",agri,2,58,49,4,113,"jalandhar, kapurthala"
9/14/19,https://www.tribuneindia.com/news/punjab/jalandhar-kapurthala-losses-pegged-at-rs-526-cr/832145.html,"due to the polluted water, three crops of farmers have been lost",agri,2,58,49,4,113,"jalandhar, kapurthala"
9/14/19,https://www.tribuneindia.com/news/punjab/jalandhar-kapurthala-losses-pegged-at-rs-526-cr/832145.html,"as per msp and yield estimates, farmers had losses of rs 50,850 per acre",agri,2,58,49,4,113,"jalandhar, kapurthala"
9/14/19,https://www.tribuneindia.com/news/punjab/jalandhar-kapurthala-losses-pegged-at-rs-526-cr/832145.html," telling numbers  total loss¬† rs 526 crore¬† total land submerged¬†75,000 acres¬† total crop loss¬† rs 384 crore¬† breach/bandh repair¬†¬† rs 80 crore¬† animal, fodder loss¬† rs 78.25 lakh damage to houses in jalandhar¬† rs 15 crore¬† link road repair (jalandhar)¬† rs 7 crore¬† ",agri,2,58,49,4,113,"jalandhar, kapurthala"
9/13/19,https://www.tribuneindia.com/news/punjab/fight-over-ration-hits-relief/831670.html,"with acute labour shortage in these villages, farmers say those getting free ration, food and water aren‚Äôt even willing to work for rs 600 a day",agri,8,4,30,0,42,"jalandhar, kapurthala"
9/13/19,https://www.tribuneindia.com/news/punjab/state-pitches-for-aid-as-central-team-visits-flood-affected-areas/831669.html," according to a report submitted by the district administration, 46,300 residents in 182 villages were affected while standing crop on 11,580 acres and 313 houses were damaged completely",agri,9,21,32,0,62,"amritsar, ferozepur, gurdaspur, jalandhar, kapurthala, ludhiana, moga, pathankot, roopnagar, sas nagar, sbs nagar, tarn taran"
9/13/19,https://www.tribuneindia.com/news/punjab/state-pitches-for-aid-as-central-team-visits-flood-affected-areas/831669.html,the farmers have suffered a loss of rs 14 crore,agri,9,21,32,0,62,"amritsar, ferozepur, gurdaspur, jalandhar, kapurthala, ludhiana, moga, pathankot, roopnagar, sas nagar, sbs nagar, tarn taran"
9/12/19,https://www.tribuneindia.com/news/punjab/punjab-govt-centre-team-meet-to-discuss-flood-damage-in-11-districts/831226.html,"as many as six persons lost their lives, 1,400 suffered injuries, over 2,400 were evacuated from areas spread over 1 lakh acres and relief has been provided to over 1,530 families",agri,15,25,41,0,81,"amritsar, ferozepur, gurdaspur, jalandhar, kapurthala, ludhiana, moga, pathankot, sbs nagar, tarn taran"
9/12/19,https://www.tribuneindia.com/news/punjab/punjab-govt-centre-team-meet-to-discuss-flood-damage-in-11-districts/831226.html, standing paddy crop in 794 villages worth rs 506.06 crore; maize rs 31.82 crore; sugarcane rs 21.40 crore and horticulture crops worth rs 16.44 crore were damaged in floods,agri,15,25,41,0,81,"amritsar, ferozepur, gurdaspur, jalandhar, kapurthala, ludhiana, moga, pathankot, sbs nagar, tarn taran"
9/12/19,https://www.tribuneindia.com/news/punjab/punjab-govt-centre-team-meet-to-discuss-flood-damage-in-11-districts/831226.html,"initial assessment  6¬†persons died¬† 1,400¬†injured 2,400¬†evacuated 1,530¬†families¬†provided relief rs 506-crore¬†paddy crop damaged ",agri,15,25,41,0,81,"amritsar, ferozepur, gurdaspur, jalandhar, kapurthala, ludhiana, moga, pathankot, sbs nagar, tarn taran"
9/9/19,https://www.tribuneindia.com/news/punjab/floods-hope-relations-washed-away/829761.html,the crop on two-acre land he owned and the other two acre which he had taken on lease has got destroyed due to the rain fury,agri,14,14,23,2,53,jalandhar
9/3/19,https://www.tribuneindia.com/news/punjab/rs-4-lakh-for-kin-of-victims/826745.html," the dc said after preliminary assessment it was found that the standing crops on nearly 6,810 acres have been damaged completely or partially in 19 villages of fazilka district",agri,10,22,20,2,54,fazilka
9/3/19,https://www.tribuneindia.com/news/punjab/rs-4-lakh-for-kin-of-victims/826745.html,"ush({ });  soon, relief for livestock loss  chandigarh: floods in punjab have taken a heavy toll on the livestock with the fall of 445 large animals/cattle, 90 pigs, 38 goats and 29,200 poultry birds, an official spokesman said",agri,10,22,20,2,54,fazilka
9/3/19,https://www.tribuneindia.com/news/punjab/rs-4-lakh-for-kin-of-victims/826745.html,"besides, 18 veterinary teams have also been deployed to examine the livestock as about 1,300 animals have been affected due to floods",agri,10,22,20,2,54,fazilka
9/3/19,https://www.tribuneindia.com/news/punjab/rs-4-lakh-for-kin-of-victims/826745.html," soon, relief for livestock loss  chandigarh: floods in punjab have taken a heavy toll on the livestock with the fall of 445 large animals/cattle, 90 pigs, 38 goats and 29,200 poultry birds, an official spokesman said",agri,10,22,20,2,54,fazilka
9/2/19,https://www.tribuneindia.com/news/punjab/ahead-of-sc-hearing-on-syl-capt-amarinder-meets-union-jalshakti-minister/826710.html," he said that the flood had caused damage to 1.72 lakh acres of crop, and destroyed some 500 houses",agri,1,6,10,0,17,punjab
9/2/19,https://www.tribuneindia.com/news/punjab/flood-hit-want-to-sell-land-move-out/826303.html,"most of the farmers in around 50 villages, which are worst affected with rains and floods, and who have lost everything in the deluge have started looking for ways to move out of these villages",agri,9,35,18,0,62,jalandhar
9/2/19,https://www.tribuneindia.com/news/punjab/flood-hit-want-to-sell-land-move-out/826303.html,he has lost crop in 20 acres of his fields ‚Äî 10 acres of his own and 10 he had taken on lease,agri,9,35,18,0,62,jalandhar
9/1/19,https://www.tribuneindia.com/news/punjab/flood-fury-in-ropar-alone-46-300-hit-rs-152-cr-loss/825940.html,"ropar, august 31  the damage to crops and government and private properties during last week‚Äôs floods in ropar district ‚Äî owing to incessant rain followed by the release of water from the bhakra dam ‚Äî has been put at over rs 152 crore",agri,4,20,19,1,44,punjab
9/1/19,https://www.tribuneindia.com/news/punjab/flood-fury-in-ropar-alone-46-300-hit-rs-152-cr-loss/825940.html," a report submitted by the district administration said 46,300 residents in 182 villages were affected, while standing crop on 11,580 acres and 313 houses were completely damaged",agri,4,20,19,1,44,punjab
9/1/19,https://www.tribuneindia.com/news/punjab/flood-fury-in-ropar-alone-46-300-hit-rs-152-cr-loss/825940.html," besides standing crop, 366.60-km link roads and 91.77-km plan roads had been washed away",agri,4,20,19,1,44,punjab
9/1/19,https://www.tribuneindia.com/news/punjab/flood-fury-in-ropar-alone-46-300-hit-rs-152-cr-loss/825940.html," farmers suffered a loss of rs 14 crore as the average per acre loss has been pegged at rs 12,000",agri,4,20,19,1,44,punjab
9/1/19,https://www.tribuneindia.com/news/punjab/sutlej-fury-fuelled-by-mining-encroachments/825854.html,"the encroachments on riverbeds and along the banks of the sutlej, large-scale mining of sand and inability of the government in clearing crops, poplar tree plantations and wild growth from riverbeds collectively led to the massive flooding in six districts",agri,2,20,11,1,34,jalandhar
9/1/19,https://www.tribuneindia.com/news/punjab/sutlej-fury-fuelled-by-mining-encroachments/825854.html,"ush({ });  wherever the ownership of dried-up riverbeds is in private hands, farmers have gone for poplar plantation or grown crops",agri,2,20,11,1,34,jalandhar
9/1/19,https://www.tribuneindia.com/news/punjab/sutlej-fury-fuelled-by-mining-encroachments/825854.html,over 1.47 lakh acres of the sutlej floodplain (land adjacent to the river) has been encroached upon,agri,2,20,11,1,34,jalandhar
9/1/19,https://www.tribuneindia.com/news/punjab/sutlej-fury-fuelled-by-mining-encroachments/825854.html,"dc varinder kumar sharma said as per preliminary report, crops in 82 villages in the district had been destroyed due to floods",agri,2,20,11,1,34,jalandhar
8/31/19,https://www.tribuneindia.com/news/punjab/post-floods-land-demarcation-new-worry/825353.html,"kanksha n bhardwaj  tribune news service  jalandhar, august 30  farmers in flood-affected areas are worried about the cumbersome process of demarcation that they will have to go through now",agri,3,36,13,1,53,jalandhar
8/31/19,https://www.tribuneindia.com/news/punjab/post-floods-land-demarcation-new-worry/825353.html,"‚Äúdue to the vast amount of sludge which has covered everything, including tubewells, pumps, motors, starters, etc, almost 70-80 per cent of tubewells will become redundant and new bores will have to be dug which will cost high,‚Äù a farmer said",agri,3,36,13,1,53,jalandhar
8/31/19,https://www.tribuneindia.com/news/punjab/post-floods-land-demarcation-new-worry/825353.html,"‚Äúhad everything been alright, basmati would have started coming in the mandis and after that paddy, but this time, thousands of farmers in over 50 affected villages will not be able to sell anything,‚Äù he added",agri,3,36,13,1,53,jalandhar
8/31/19,https://www.tribuneindia.com/news/punjab/post-floods-land-demarcation-new-worry/825353.html,"the farmers said they would have earned rs 50,000-60,000 per acre for their crop but due to the deluge, they had suffered huge losses",agri,3,36,13,1,53,jalandhar
8/29/19,https://www.tribuneindia.com/news/punjab/water-from-pak-inundates-fazilka-village/824265.html,"hansa singh said of the 1,435 acres of the agricultural land, the paddy crop in about 800-900 acres had been damaged due to the floods",agri,2,11,15,0,28,fazilka
8/29/19,https://www.tribuneindia.com/news/punjab/crores-spent-on-bundhs-washed-away/824263.html," as many as 21 villages remained flooded in phillaur and shahkot subdivisions for nearly a week with huge losses incurred by all departments, including the pspcl, railways, school education and agriculture",agri,3,6,12,0,21,"hoshiarpur, jalandhar, kapurthala, ludhiana, sbs nagar"
8/28/19,https://www.tribuneindia.com/news/punjab/inter-ministerial-central-team-to-visit-punjab-to-assess-damage-by-floods/824234.html," people in several punjab districts, including jalandhar, kapurthala, ferozepur, rupnagar, moga, ludhiana, have lost their houses, belongings, and standing crops in the recent floods, which are said to be the worst since 1988",agri,1,16,27,0,44,"ferozepur, jalandhar, kapurthala, ludhiana, moga, sas nagar"
8/28/19,https://www.tribuneindia.com/news/punjab/nambardar-union-to-give-rs-14-cr-to-cm-fund/823788.html,"tns farmers to get 25,000 quintal wheat seed  chandigarh: the punjab state seeds corporation will give around 25,000 quintal high-quality wheat seed to flood-hit farmers for the upcoming rabi season, said an official government spokesman",agri,7,36,19,2,64,"jalandhar, kapurthala, moga, sangrur"
8/28/19,https://www.tribuneindia.com/news/punjab/nambardar-union-to-give-rs-14-cr-to-cm-fund/823788.html,"he said as per the initial crop damage reports, 100 per cent crop damage has been reported in about 25,000 hectares of farmland",agri,7,36,19,2,64,"jalandhar, kapurthala, moga, sangrur"
8/28/19,https://www.tribuneindia.com/news/punjab/nambardar-union-to-give-rs-14-cr-to-cm-fund/823788.html,"extending a major relief to farmers, the high quality seed of the wheat crop, which costs around  rs 3,000 per quintal, taking the cost of initial seed requirement to the tune of  rs 7.50 crore, will be provided for free to the affected farmers",agri,7,36,19,2,64,"jalandhar, kapurthala, moga, sangrur"
8/28/19,https://www.tribuneindia.com/news/punjab/nambardar-union-to-give-rs-14-cr-to-cm-fund/823788.html,"he said the markfed district office in jalandhar had provided 300 ldpe sheets, 2,000 pp bags, 300 bags of cattlefeed, 15 kg refined oil (15 tins), besides 50 packets of garam masala, haldi and lal mirch to the district administration for distribution to the needy",agri,7,36,19,2,64,"jalandhar, kapurthala, moga, sangrur"
8/28/19,https://www.tribuneindia.com/news/punjab/nambardar-union-to-give-rs-14-cr-to-cm-fund/823788.html,the administration has advised markfed to arrange 100 more sheets and 200 bags of cattlefeed for emergency,agri,7,36,19,2,64,"jalandhar, kapurthala, moga, sangrur"
8/28/19,https://www.tribuneindia.com/news/punjab/nambardar-union-to-give-rs-14-cr-to-cm-fund/823788.html,he said the kapurthala district office has provided 350 bags of cattlefeed and 50 specially prepared ration kits to administration officials,agri,7,36,19,2,64,"jalandhar, kapurthala, moga, sangrur"
8/28/19,https://www.tribuneindia.com/news/punjab/month-on-muktsar-farmers-await-special-girdawari/823774.html,"archit watts  tribune news service  muktsar, august 27   it‚Äôs been over a month after the rain flooded agricultural fields in a large number of villages in the district, but the work of special girdawari to assess crop damage is yet to finish",agri,1,31,18,1,51,sri muktsar sahib
8/28/19,https://www.tribuneindia.com/news/punjab/month-on-muktsar-farmers-await-special-girdawari/823774.html," notably, the rainwater in mid-july damaged the paddy and cotton crops in nearly 8,000 acres, as per an estimate of the district administration",agri,1,31,18,1,51,sri muktsar sahib
8/28/19,https://www.tribuneindia.com/news/punjab/manmade-disaster-1-5-lakh-acres-sutlej-plains-encroached-upon/823764.html,manmade disaster? 1.5 lakh acres sutlej plains encroached upon,agri,2,32,1,3,38,punjab
8/28/19,https://www.tribuneindia.com/news/punjab/manmade-disaster-1-5-lakh-acres-sutlej-plains-encroached-upon/823764.html,"vishav bharti  tribune news service  chandigarh, august 27  with most of the fertile land on the sutlej banks encroached upon for farming and other activities, the recent flood fury in punjab was a tragedy waiting to happen",agri,2,32,1,3,38,punjab
8/28/19,https://www.tribuneindia.com/news/punjab/manmade-disaster-1-5-lakh-acres-sutlej-plains-encroached-upon/823764.html," since independence, a total of 1.47 lakh acres (57 per cent) of the sutlej floodplain (land adjacent to river) falling in punjab have slowly been encroached upon",agri,2,32,1,3,38,punjab
8/28/19,https://www.tribuneindia.com/news/punjab/manmade-disaster-1-5-lakh-acres-sutlej-plains-encroached-upon/823764.html,the total land on the sutlej banks in punjab is 2.57 lakh acre,agri,2,32,1,3,38,punjab
8/28/19,https://www.tribuneindia.com/news/punjab/manmade-disaster-1-5-lakh-acres-sutlej-plains-encroached-upon/823764.html,"ush({ });  the study found that 1975 onwards, there was a clear dominance of human activities, including agriculture and construction, over the land near the river",agri,2,32,1,3,38,punjab
8/28/19,https://www.tribuneindia.com/news/punjab/manmade-disaster-1-5-lakh-acres-sutlej-plains-encroached-upon/823764.html,  the biggest chunk of this encroachment was done for the two activities ‚Äî agriculture and construction,agri,2,32,1,3,38,punjab
8/28/19,https://www.tribuneindia.com/news/punjab/manmade-disaster-1-5-lakh-acres-sutlej-plains-encroached-upon/823764.html,"like between 1975-1989, just 9,367 acre was encroached for the two activities",agri,2,32,1,3,38,punjab
8/28/19,https://www.tribuneindia.com/news/punjab/manmade-disaster-1-5-lakh-acres-sutlej-plains-encroached-upon/823764.html,"however, it increased to 12,025 acre between 1989-2000",agri,2,32,1,3,38,punjab
8/28/19,https://www.tribuneindia.com/news/punjab/manmade-disaster-1-5-lakh-acres-sutlej-plains-encroached-upon/823764.html,"in next five years, the figure stood at 13,920 acres",agri,2,32,1,3,38,punjab
8/28/19,https://www.tribuneindia.com/news/punjab/manmade-disaster-1-5-lakh-acres-sutlej-plains-encroached-upon/823764.html,"it was 14,558 acre between 2005-2011",agri,2,32,1,3,38,punjab
8/27/19,https://www.tribuneindia.com/news/punjab/not-paid-cane-growers-on-warpath-against-govt-mills/823222.html," in december last year, after private sugar mills refused to pay the state advised price (sap) of rs 310 per quintal to the farmers, citing steep fall in prices of sugar, the government had agreed to bear part of the sap (rs 25 per quintal)",agri,1,25,2,2,30,hoshiarpur
8/27/19,https://www.tribuneindia.com/news/punjab/not-paid-cane-growers-on-warpath-against-govt-mills/823222.html,"the private sugar mills, owned by politicians from across the political spectrum, had expressed their inability to pay ‚Äúhigh‚Äù sap for sugarcane, as sugar prices then had dropped to rs 2,900 per quintal",agri,1,25,2,2,30,hoshiarpur
8/27/19,https://www.tribuneindia.com/news/punjab/not-paid-cane-growers-on-warpath-against-govt-mills/823222.html," data collected by the tribune shows that of rs 136.62 crore that the state had to pay to the farmers, rs 70 crore has been disbursed",agri,1,25,2,2,30,hoshiarpur
8/27/19,https://www.tribuneindia.com/news/punjab/not-paid-cane-growers-on-warpath-against-govt-mills/823222.html,"while private sugar mills (other than the one in amloh that has cleared all its dues) have to pay rs 440 crore to farmers, the cooperative mills are yet to clear payment of rs 275 crore to farmers, which includes rs 25 crore of 2017-18.",agri,1,25,2,2,30,hoshiarpur
8/27/19,https://www.tribuneindia.com/news/punjab/farmers-to-get-free-wheat-seed/823211.html,"chandigarh, august 26  chief minister capt amarinder singh on monday ordered a slew of additional measures for relief and rehabilitation of flood victims, including supply of free high quality wheat seed to farmers for the upcoming rabi season",agri,1,26,8,0,35,punjab
8/26/19,https://www.tribuneindia.com/news/punjab/punjab-seeks-rs-1-000-cr-special-aid-from-centre/822847.html,"a person was feared drowned in the sutlej in fazilka while death of 176 cattle heads and damage to 161 houses had been reported from ropar, said officials",agri,11,11,42,0,64,"fazilka, ferozepur, jalandhar, kapurthala, ludhiana, patiala, sas nagar, sbs nagar"
8/26/19,https://www.tribuneindia.com/news/punjab/punjab-seeks-rs-1-000-cr-special-aid-from-centre/822847.html," rescue operation on¬† ferozepur:¬†500 evacuated, 630 given relief in 15 marooned villages in makhu and hussainiwala jalandhar: 31 evacuated, 389 families given medical aid, 655 treated at opds while 4,600 treated at medical camps kapurthala:¬† dry rations and other relief material provided to people; 1,415 given medical aid; veterinary care provided to 640 cattle ropar: 500 evacuated, drinking water and power supply restored in affected villages; 3,300 provided medical aid fortify banks along pakistan border: captain¬†  chandigarh: punjab chief minister capt amarinder singh on sunday asked the water resources department to work out a joint action plan to strengthen¬†embankment along the india-pakistan border to avert flooding of nearby villages.",agri,11,11,42,0,64,"fazilka, ferozepur, jalandhar, kapurthala, ludhiana, patiala, sas nagar, sbs nagar"
8/26/19,https://www.tribuneindia.com/news/punjab/cong-mla-gives-month-s-salary/822779.html,"he said flooding in the sutlej due to the discharge of water from bhakra, the heaviest since 1988, had caused extensive damage to the standing crops and inundation residential areas in the villages",agri,2,3,5,0,10,punjab
8/26/19,https://www.tribuneindia.com/news/punjab/crops-on-6-000-acres-damaged-in-fazilka/822777.html,"crops on 6,000 acres damaged in fazilka",agri,5,31,23,1,60,"fazilka, ferozepur, sas nagar"
8/26/19,https://www.tribuneindia.com/news/punjab/crops-on-6-000-acres-damaged-in-fazilka/822777.html,"our correspondent fazilka, august 25  standing  crops of paddy, maize, fodder, moong, etc",agri,5,31,23,1,60,"fazilka, ferozepur, sas nagar"
8/26/19,https://www.tribuneindia.com/news/punjab/crops-on-6-000-acres-damaged-in-fazilka/822777.html," on about 6,000 acres has been inundated due to floods in fazilka district",agri,5,31,23,1,60,"fazilka, ferozepur, sas nagar"
8/26/19,https://www.tribuneindia.com/news/punjab/crops-on-6-000-acres-damaged-in-fazilka/822777.html, some farmers said about 400 acres of the fields were inundated and their paddy crop had been damaged,agri,5,31,23,1,60,"fazilka, ferozepur, sas nagar"
8/25/19,https://www.tribuneindia.com/news/punjab/capt-amarinder-seeks-joint-action-plan-with-army-to-strengthen-tendiwala-embankment/822677.html," ¬†in addition, nearly 950 food packets had been distributed to the people, and adequate arrangements has been made for supply of feed and fodder to the livestock",agri,19,16,35,0,70,"ferozepur, jalandhar, kapurthala"
8/25/19,https://www.tribuneindia.com/news/punjab/capt-amarinder-seeks-joint-action-plan-with-army-to-strengthen-tendiwala-embankment/822677.html,"  as per the information given by the dc kapurthala, 1415 persons were given requisite treatment, with¬† veterinary care provided to 640 cattle",agri,19,16,35,0,70,"ferozepur, jalandhar, kapurthala"
8/25/19,https://www.tribuneindia.com/news/punjab/capt-amarinder-seeks-joint-action-plan-with-army-to-strengthen-tendiwala-embankment/822677.html,"apart from this, 20 teams of animal husbandry department had been deputed in the district to ensure adequate supply of feed and fodder, besides providing veterinary care to the livestock",agri,19,16,35,0,70,"ferozepur, jalandhar, kapurthala"
8/25/19,https://www.tribuneindia.com/news/punjab/100-crop-damage-in-jalandhar-kapurthala-districts-say-farmers/822274.html,"100% crop damage in jalandhar, kapurthala districts, say farmers",agri,6,106,53,2,167,"jalandhar, kapurthala"
8/25/19,https://www.tribuneindia.com/news/punjab/100-crop-damage-in-jalandhar-kapurthala-districts-say-farmers/822274.html,"60,000 acres¬†inundated in jalandhar¬†  26,000 acres¬†inundated in kapurthala¬†  60,000 farmers¬†affected by floods aparna banerji tribune news service jalandhar, august 24  with the farmers being primarily at the receiving end due to the sutlej floods, which have ravaged over 50 villages in the district, they are now planning to conduct their own parallel survey of the affected fields after the water recedes",agri,6,106,53,2,167,"jalandhar, kapurthala"
8/25/19,https://www.tribuneindia.com/news/punjab/100-crop-damage-in-jalandhar-kapurthala-districts-say-farmers/822274.html," estimating losses of over 70,000 acres of paddy in jalandhar alone, farmers are now demanding rs 40,000 per acre as ‚Äògirdawari‚Äô for crop loss",agri,6,106,53,2,167,"jalandhar, kapurthala"
8/25/19,https://www.tribuneindia.com/news/punjab/100-crop-damage-in-jalandhar-kapurthala-districts-say-farmers/822274.html,"ush({ });  the district administrations, however, estimated the damage to crops over 86,000 acres (60,000 acres in jalandhar and 26,000 acres in kapurthala)",agri,6,106,53,2,167,"jalandhar, kapurthala"
8/25/19,https://www.tribuneindia.com/news/punjab/100-crop-damage-in-jalandhar-kapurthala-districts-say-farmers/822274.html," while water is taking the longest to recede in shahkot villages (lohian), this area alone has over 25,000 acres of submerged paddy fields",agri,6,106,53,2,167,"jalandhar, kapurthala"
8/25/19,https://www.tribuneindia.com/news/punjab/100-crop-damage-in-jalandhar-kapurthala-districts-say-farmers/822274.html," of over 1 lakh people hit by the floods in jalandhar, 60% belong to the farming community",agri,6,106,53,2,167,"jalandhar, kapurthala"
8/25/19,https://www.tribuneindia.com/news/punjab/100-crop-damage-in-jalandhar-kapurthala-districts-say-farmers/822274.html," kuldip singh, a farmer of janian chahal village, said, ‚Äúit took ages for farmers affected by the 1988 floods to recover from losses",agri,6,106,53,2,167,"jalandhar, kapurthala"
8/25/19,https://www.tribuneindia.com/news/punjab/100-crop-damage-in-jalandhar-kapurthala-districts-say-farmers/822274.html,"we are expecting relief of at leastrs 40,000 per acre",agri,6,106,53,2,167,"jalandhar, kapurthala"
8/25/19,https://www.tribuneindia.com/news/punjab/100-crop-damage-in-jalandhar-kapurthala-districts-say-farmers/822274.html,"he said, ‚Äúover 60,000 farmers are hit",agri,6,106,53,2,167,"jalandhar, kapurthala"
8/25/19,https://www.tribuneindia.com/news/punjab/100-crop-damage-in-jalandhar-kapurthala-districts-say-farmers/822274.html,"an estimated crop over 70,000 acres in jalandhar is affected",agri,6,106,53,2,167,"jalandhar, kapurthala"
8/25/19,https://www.tribuneindia.com/news/punjab/100-crop-damage-in-jalandhar-kapurthala-districts-say-farmers/822274.html,"  meanwhile, jalandhar dc varinder kumar sharma said, ‚Äúdamage to crop on about 60,000 acres is estimated",agri,6,106,53,2,167,"jalandhar, kapurthala"
8/25/19,https://www.tribuneindia.com/news/punjab/100-crop-damage-in-jalandhar-kapurthala-districts-say-farmers/822274.html,"in phillaur, crops died in a day while lohian has been submerged for six days",agri,6,106,53,2,167,"jalandhar, kapurthala"
8/25/19,https://www.tribuneindia.com/news/punjab/100-crop-damage-in-jalandhar-kapurthala-districts-say-farmers/822274.html,"  kapurthala dc dps kharbanda, however, said, ‚Äúabout 26,000 acres has been damaged after 20,000 villages were marooned here",agri,6,106,53,2,167,"jalandhar, kapurthala"
8/25/19,https://www.tribuneindia.com/news/punjab/100-crop-damage-in-jalandhar-kapurthala-districts-say-farmers/822274.html,the losses to crops are estimated to be 100 per cent,agri,6,106,53,2,167,"jalandhar, kapurthala"
8/25/19,https://www.tribuneindia.com/news/punjab/amid-deluge-jalandhar-welcomes-flood-babies/822267.html,"her husband jaswinder singh, a marginal farmer, too thanked god but was yet to name his child as he was worried for his two-year-old daughter whom he had left with neighbours back home amid heavy rain and floods",agri,2,6,13,0,21,jalandhar
8/24/19,https://www.tribuneindia.com/news/punjab/to-plug-breach-neighbours-flood-shahkot/821758.html,"  dhussi bundh  45-50 ft deep & 150 m wide  2 weeks required to plug it  120 soldiers deployed¬†at both ends  fodder shortage hits cattle  along with the losses suffered by people, volunteers and relief workers on ground have pointed out the shortage of fodder for cattle",agri,11,8,18,0,37,jalandhar
8/23/19,https://www.tribuneindia.com/news/punjab/relief-camps-flooded/821455.html,"dc dps kharbanda said, ‚Äúthe relief teams will ensure fodder of 2.5 kg per cattle head and medication",agri,1,1,11,0,13,kapurthala
8/23/19,https://www.tribuneindia.com/news/punjab/-flood-relief-govt-priority/821303.html,"tribune news service gidderpindi/sultanpur lodhi, august 22  during his meetings to listen to the grievances of the flood-affected farmers at gidderpindi village of jalandhar and sarupwal village of sultanpur lodhi, chief minister captain amarinder singh said: ‚Äúwe will stop every project for the time being",agri,5,8,14,1,28,jalandhar
8/23/19,https://www.tribuneindia.com/news/punjab/toxins-from-pak-tanneries-add-to-border-areas-woes/821301.html," due to ‚Äúdeliberate breach‚Äù in embankment along the sutlej on pakistan side, several villages, including gatti rajoke, tiniwala, kamalewala and nihalewala, get flooded, damaging thousands of acres of standing crop",agri,6,10,15,0,31,"fazilka, ferozepur"
8/22/19,https://www.tribuneindia.com/news/punjab/2-new-breaches-worsen-situation-in-jalandhar-kapurthala/820673.html,"over 30,000 acres in jalandhar has been inundated",agri,8,12,21,0,41,"jalandhar, kapurthala"
8/22/19,https://www.tribuneindia.com/news/punjab/2-new-breaches-worsen-situation-in-jalandhar-kapurthala/820673.html," not much relief 30,000 acres inundated in jalandhar¬† 138 villages affected in jalandhar, kapurthala 27 boats, 7 helicopters roped in for relief ops",agri,8,12,21,0,41,"jalandhar, kapurthala"
8/22/19,https://www.tribuneindia.com/news/punjab/farmers-stare-at-losses-govt-empty-coffers/820671.html,"ruchika m khanna  tribune news service  chandigarh, august 21  even as the state remained on the edge, with almost 75,000 cusecs water being released by the bbmb, the government is grappling with the issue of compensating farmers, who have suffered losses worth crores",agri,8,86,38,3,135,"fazilka, ferozepur, jalandhar, kapurthala, ludhiana, moga"
8/22/19,https://www.tribuneindia.com/news/punjab/farmers-stare-at-losses-govt-empty-coffers/820671.html," the government has been dilly-dallying on formulating a crop insurance policy, which could have been useful to compensate farmers whose losses are now estimated at rs 750 crore",agri,8,86,38,3,135,"fazilka, ferozepur, jalandhar, kapurthala, ludhiana, moga"
8/22/19,https://www.tribuneindia.com/news/punjab/farmers-stare-at-losses-govt-empty-coffers/820671.html,"in such a situation, the relief that the state can offer is just rs 12,200 per hectare (or rs 5,083.33 per acre) from the state disaster relief management fund, unless the centre recognises flooding in punjab as a natural disaster and gives it a flood relief package",agri,8,86,38,3,135,"fazilka, ferozepur, jalandhar, kapurthala, ludhiana, moga"
8/22/19,https://www.tribuneindia.com/news/punjab/farmers-stare-at-losses-govt-empty-coffers/820671.html,"at places, where the farmers have suffered a loss of more than one crop (in fazilka- abohar, where besides horticulture crops, cotton is grown), rs 5,625 per acre would be given for loss of horticulture crops and rs 5,083.33 per acre for other crops sown along with kinnows",agri,8,86,38,3,135,"fazilka, ferozepur, jalandhar, kapurthala, ludhiana, moga"
8/22/19,https://www.tribuneindia.com/news/punjab/farmers-stare-at-losses-govt-empty-coffers/820671.html," chief minister capt amarinder singh today wrote to the prime minister, seeking a rs 1,000-crore special package, besides asking him to instruct the authorities to waive crop loans taken by farmers in affected villages for the current cropping season",agri,8,86,38,3,135,"fazilka, ferozepur, jalandhar, kapurthala, ludhiana, moga"
8/22/19,https://www.tribuneindia.com/news/punjab/farmers-stare-at-losses-govt-empty-coffers/820671.html,"the flooding in the sutlej due to discharge of water from bhakra dam has caused extensive damage to crops, inundating 326 villages of ropar, ludhiana, jalandhar, moga, ferozepur and kapurthala",agri,8,86,38,3,135,"fazilka, ferozepur, jalandhar, kapurthala, ludhiana, moga"
8/22/19,https://www.tribuneindia.com/news/punjab/farmers-stare-at-losses-govt-empty-coffers/820671.html,it is estimated that crop on 1.20 lakh acres of cultivated area is submerged,agri,8,86,38,3,135,"fazilka, ferozepur, jalandhar, kapurthala, ludhiana, moga"
8/22/19,https://www.tribuneindia.com/news/punjab/farmers-stare-at-losses-govt-empty-coffers/820671.html," three years on, the state government is still considering on whether to come up with a crop insurance scheme or set up a crop compensation fund",agri,8,86,38,3,135,"fazilka, ferozepur, jalandhar, kapurthala, ludhiana, moga"
8/22/19,https://www.tribuneindia.com/news/punjab/farmers-stare-at-losses-govt-empty-coffers/820671.html," they had recommended that farmers pay a levy of re 1 per bag, with a matching levy to be paid by the state to create a corpus of rs 250 crore each year (considering 2.50 crore bags of wheat and paddy reach mandis each year)",agri,8,86,38,3,135,"fazilka, ferozepur, jalandhar, kapurthala, ludhiana, moga"
8/22/19,https://www.tribuneindia.com/news/punjab/farmers-stare-at-losses-govt-empty-coffers/820671.html," the sources agree that on an average, punjab has had to release rs 100-150 crore crop damage compensation to farmers each year for the past seven years",agri,8,86,38,3,135,"fazilka, ferozepur, jalandhar, kapurthala, ludhiana, moga"
8/22/19,https://www.tribuneindia.com/news/punjab/farmers-stare-at-losses-govt-empty-coffers/820671.html," in 2015, because of the whitefly attack on cotton, crop worth rs 650 crore was damaged",agri,8,86,38,3,135,"fazilka, ferozepur, jalandhar, kapurthala, ludhiana, moga"
8/22/19,https://www.tribuneindia.com/news/punjab/farmers-stare-at-losses-govt-empty-coffers/820671.html," 326 villages & 1.20 lakh acres flooded across state  rs 750-cr loss estimated on account of damage to crops 5,023 people rescued from¬†affected villages",agri,8,86,38,3,135,"fazilka, ferozepur, jalandhar, kapurthala, ludhiana, moga"
8/22/19,https://www.tribuneindia.com/news/punjab/help-pours-in-for-flood-hit-in-ropar/820668.html," while a truck carrying flour, rice, refined oil and other food items was sent by the residents of muktsar and fatehgarh sahib, 500 sets of clothes for children have been sent by the ludhiana district administration",agri,16,2,4,0,22,"fatehgarh sahib, ludhiana, sri muktsar sahib"
8/21/19,https://www.tribuneindia.com/news/punjab/punjab-cm-writes-to-pm-for-rs-1000-crore-special-flood-relief-package/820655.html," the flooding in river sutlej due to the discharge of water from bhakra dam, the heaviest since 1958, had caused extensive damage to the standing crops and inundation of residential areas in the villages, the chief minister said, adding that an early estimate suggested the damage to be to the extent of rs 1700 crore",agri,24,22,42,0,88,"ferozepur, jalandhar, kapurthala, ludhiana"
8/21/19,https://www.tribuneindia.com/news/punjab/punjab-cm-writes-to-pm-for-rs-1000-crore-special-flood-relief-package/820655.html,"  he said though necessary assistance was given by the army authorities, the floods in river sutlej had severely damaged standing crops, houses and other rural and urban infrastructure at many places, especially in the districts of ropar, ludhiana, jalandhar and kapurthala covering over 100 villages",agri,24,22,42,0,88,"ferozepur, jalandhar, kapurthala, ludhiana"
8/21/19,https://www.tribuneindia.com/news/punjab/punjab-cm-writes-to-pm-for-rs-1000-crore-special-flood-relief-package/820655.html," the request from the chief minister came amid reports that 326 villages across the state had been adversely impacted, with loss of standing crops on nearly 1.20 lakh acres of area submerged under water",agri,24,22,42,0,88,"ferozepur, jalandhar, kapurthala, ludhiana"
8/21/19,https://www.tribuneindia.com/news/punjab/300-punjab-villages-badly-affected-by-floods/820611.html,"chandigarh, august 21more than 300 villages, mainly in punjab's ropar, jalandhar and ferozepur districts, were badly affected in floods by the satluj river, damaging crops in thousands of acres and forcing thousands of villagers to spend nights on rooftops",agri,8,8,22,0,38,"ferozepur, gurdaspur, jalandhar, pathankot, sas nagar"
8/21/19,https://www.tribuneindia.com/news/punjab/rainfall-subsides-rivers-still-swollen/820229.html,"  in july,¬† floods had damaged standing crops over 10,000 acres in bhundar bhaini, surjan bhaini, salemgarh, phullad villages and surrounding areas",agri,34,15,52,1,102,"jalandhar, kapurthala, sangrur"
8/21/19,https://www.tribuneindia.com/news/punjab/flooded-ropar-villages-left-high-and-dry/820215.html,bhai amrik singh of sanoli majara along with his followers also served langar in many villages of anandpur sahib and brought two trolleys and a truck loaded with fodder to distribute among the needy cattle owners,agri,9,6,32,0,47,punjab
8/21/19,https://www.tribuneindia.com/news/punjab/500-acres-inundated-in-fazilka-water-rising/820212.html,500 acres inundated in fazilka; water rising,agri,5,9,18,0,32,"fazilka, ferozepur, sas nagar"
8/21/19,https://www.tribuneindia.com/news/punjab/500-acres-inundated-in-fazilka-water-rising/820212.html,"fazilka, august 20  the paddy and moong crop along the bed and the creek of the swollen sutlej has submerged around 500 acres in fazilka district",agri,5,9,18,0,32,"fazilka, ferozepur, sas nagar"
8/21/19,https://www.tribuneindia.com/news/punjab/residents-on-edge/820209.html,"around 30,000 acres had reportedly been submerged",agri,15,28,23,2,68,"jalandhar, kapurthala"
8/21/19,https://www.tribuneindia.com/news/punjab/residents-on-edge/820209.html, farmers who owned barely 4-10 acres said they were unsure of their survival,agri,15,28,23,2,68,"jalandhar, kapurthala"
8/21/19,https://www.tribuneindia.com/news/punjab/residents-on-edge/820209.html,jasvir singh from gidderpindi said: ‚Äúi own 4 acres and had sown paddy by taking loans worth lakhs of rupees,agri,15,28,23,2,68,"jalandhar, kapurthala"
8/21/19,https://www.tribuneindia.com/news/punjab/residents-on-edge/820209.html,"  sukhdev singh, another farmer, said his 10 acres were completely destroyed",agri,15,28,23,2,68,"jalandhar, kapurthala"
8/21/19,https://www.tribuneindia.com/news/punjab/punjab-rain-loss-rs-1-700-crore/820174.html," though the exact extent of damage will be known only after the special¬†  girdawri is carried out, initial reports by the revenue department show that 30,000 acres of cultivated land was submerged in jalandhar; 21,000 acres in tarn taran; 14,500 in ludhiana; 13,000 in moga; and 7,000 acres in ferozepur",agri,8,29,31,0,68,"fazilka, ferozepur, jalandhar, kapurthala, ludhiana, moga, sas nagar, tarn taran"
8/21/19,https://www.tribuneindia.com/news/punjab/punjab-rain-loss-rs-1-700-crore/820174.html,"as many as 824 roads still remain closed the met office has predicted rains and thunderstorm in lower, mid and higher hills in the next six days from august 21 to august 26  hry flood-hit shifted¬† sonepat & karnal: 25 families evacuated in the two districts 11,000 acres submerged karnal fields: 7,100 acres of paddy, 3,000 of sugarcane and¬†900 acres of maize submerged 35 villages affected yamunanagar: standing crops on 1,972 hectares, 35 villages affected, as per initial reports",agri,8,29,31,0,68,"fazilka, ferozepur, jalandhar, kapurthala, ludhiana, moga, sas nagar, tarn taran"
8/21/19,https://www.tribuneindia.com/news/punjab/displaced-ferozepur-residents-demand-permanent-solution/820167.html,"standing crop over 5,000 acres has been flooded by overflowing sutlej in makhu and ferozepur areas",agri,22,6,18,1,47,ferozepur
8/20/19,https://www.tribuneindia.com/news/punjab/standing-crops-hit-farmers-seek-damages/819846.html, crops on hundreds of acres in samrala and machhiawa region were badly hit due to flooding of fields,agri,8,66,38,2,114,"fatehgarh sahib, ludhiana, moga, sangrur, tarn taran"
8/20/19,https://www.tribuneindia.com/news/punjab/standing-crops-hit-farmers-seek-damages/819846.html,"‚Äúwe had cultivated vegetables on 10 acres along the machhiwara-rattipur road, hoping to earn a livelihood for a year",agri,8,66,38,2,114,"fatehgarh sahib, ludhiana, moga, sangrur, tarn taran"
8/20/19,https://www.tribuneindia.com/news/punjab/standing-crops-hit-farmers-seek-damages/819846.html,"there are reports that crops on 10,000 acres have been washed away",agri,8,66,38,2,114,"fatehgarh sahib, ludhiana, moga, sangrur, tarn taran"
8/20/19,https://www.tribuneindia.com/news/punjab/punjab-on-edge-rivers-in-spate/819828.html,"chandigarh, august 19  as punjab struggled to brace the onslaught of water from the swollen sutlej and its tributaries, breaching river protection at several places and inundating hundreds of acres of agricultural land, the state government today declared the flood situation a natural calamity",agri,4,14,14,0,32,"fazilka, ferozepur, jalandhar, ludhiana, pathankot, sbs nagar"
8/20/19,https://www.tribuneindia.com/news/punjab/70-ft-breach-in-sutlej-adds-to-misery-rescue-ops-on/819818.html,  hundreds of acres of agricultural land has submerged in the affected villages,agri,12,11,31,0,54,"jalandhar, ludhiana"
8/20/19,https://www.tribuneindia.com/news/punjab/cm-orders-girdawari-rs-100-cr-relief/819814.html,"tribune news service ropar, august 19  chief minister capt amarinder singh on monday ordered a special girdawari to assess the loss suffered by farmers and announced¬†  rs 100 crore for emergency relief and rehabilitation measures in the flood-hit areas of the state",agri,10,6,19,0,35,punjab
8/19/19,https://www.tribuneindia.com/news/punjab/chief-secy-meets-dcs-demands-ground-report/819447.html,"‚Äúwater is standing in the fields and if it subsides within two-three days, the crops will be safe,‚Äù he said, adding that he had issued instructions to all field staff to help farmers drain out the standing water from fields",agri,2,17,5,0,24,"ferozepur, gurdaspur, jalandhar, ludhiana, pathankot, sbs nagar"
8/19/19,https://www.tribuneindia.com/news/punjab/naggal-dam-breach-causes-flash-flood/819444.html,"akash ghai  tribune news service  mohali, august 18  a major breach in naggal earthen dam, located in the forest area opposite new chandigarh, caused flash flood in the area, which resulted in washing away of at least 15 head of cattle, six houses and around four-five bridges at chotti naggal, badi naggal, parol, mirzapur and nearby villages",agri,5,8,12,0,25,sas nagar
8/19/19,https://www.tribuneindia.com/news/punjab/naggal-dam-breach-causes-flash-flood/819444.html," the floodwater, which was said to be around 5 metre high, also flattened corn crop in a number of fields in the area",agri,5,8,12,0,25,sas nagar
8/19/19,https://www.tribuneindia.com/news/punjab/naggal-dam-breach-causes-flash-flood/819444.html,"in all, 15 cattle of two families and two tractors were washed away,"" chand added",agri,5,8,12,0,25,sas nagar
8/19/19,https://www.tribuneindia.com/news/punjab/jalandhar-villagers-caught-unawares-blame-authorities/819441.html,ush({ });  over 200 acres of fields are already inundated at janian village,agri,14,22,31,0,67,"jalandhar, sbs nagar"
8/19/19,https://www.tribuneindia.com/news/punjab/jalandhar-villagers-caught-unawares-blame-authorities/819441.html,  sources said over 100 villages and crops across thousands of acres were submerged,agri,14,22,31,0,67,"jalandhar, sbs nagar"
8/19/19,https://www.tribuneindia.com/news/punjab/jalandhar-villagers-caught-unawares-blame-authorities/819441.html," army rescues 2 men, cattle from sutlej  an army team deputed at nawanshahr saved two people, besides nine rearing animals, from the sutlej near mattewara bridge at begowal village of the district on sunday a migrant labourer living in a room in the fields of a farmer was stuck as the flow of river water increased suddenly",agri,14,22,31,0,67,"jalandhar, sbs nagar"
8/19/19,https://www.tribuneindia.com/news/punjab/52-low-lying-ferozepur-areas-inundated-shifting-ordered/819439.html," even before that, hundreds of acres of fertile agriculture land in these villages, most of which are situated on the riverbed, is feared marooned and more damage is anticipated after about 2.40 lakh cusecs of water released from bhakhra reaches downstream harike in a few hours",agri,2,5,14,0,21,ferozepur
8/17/19,https://www.tribuneindia.com/news/punjab/torrential-rain-lashes-northern-states-alert-sounded-in-punjab/818855.html," andhra pradesh too received heavy showers, with a swollen krishna river leaving 87 villages and hundreds of acres of farm land under a sheet of water in two districts",agri,17,13,16,0,46,"amritsar, ludhiana, sas nagar"
8/5/19,https://www.tribuneindia.com/news/punjab/release-compensation-to-flood-hit-dhindsa/813067.html,"tribune news service sangrur, august 4  even after thousands of acres of standing crops was destroyed after a breach in the ghaggar last month, the authorities concerned are yet to take action to strengthen the river embankments",agri,3,11,6,4,24,sangrur
7/29/19,https://www.tribuneindia.com/news/punjab/ludhiana-cycle-valley-to-be-operational-by-2022/809300.html,"tribune news service chandigarh, july 28  the state government will establish a high-tech cycle valley spread over 383 acres in dhanansu village of ludhiana district as part of its efforts to bolster the industrial sector and create jobs",agri,0,11,5,1,17,ludhiana
7/29/19,https://www.tribuneindia.com/news/punjab/ludhiana-cycle-valley-to-be-operational-by-2022/809300.html,"the industries and commerce minister added that a 100-acre plot had been allotted and the possession given to hero cycles limited, ludhiana, in december 2018 to set up its main unit",agri,0,11,5,1,17,ludhiana
7/29/19,https://www.tribuneindia.com/news/punjab/ludhiana-cycle-valley-to-be-operational-by-2022/809300.html,ush({ });  he said the punjab state transmission corporation limited (pstcl) would set up an electricity sub-station of 400 kw on 30 acres for which the land had been allotted and payment of rs 9.45 crore made,agri,0,11,5,1,17,ludhiana
7/29/19,https://www.tribuneindia.com/news/punjab/ludhiana-cycle-valley-to-be-operational-by-2022/809300.html,spread over 383 acres¬†  the cycle valley is coming up over 383 acres at dhanansu village in ludhiana district as part of govt‚Äôs efforts to bolster the industrial sector¬†and create jobs the cycle valley will be connected with the chandigarh-ludhiana national highway by¬†constructing a 100-ft wide four-laned and 8.5-km long external road the project involves an investment of  rs 300 crore basic infrastructure is expected to be put in place by march 2021 ,agri,0,11,5,1,17,ludhiana
7/23/19,https://www.tribuneindia.com/news/punjab/ghaggar-flood-capt-urges-haryana-to-join-hands-says-relief-after-survey/806555.html,"tribune news service  sangrur/patiala, july 23  blaming the akalis for the control of the ghaggar river going to  the central water commission (cwc), chief minister capt amarinder singh  on tuesday said he would meet central ministers and officials to press  for reinforcement of the embankments of the river, which had breached  causing serious damage to standing crop and other assets in sangrur and  patiala",agri,3,30,40,3,76,"bathinda, patiala, sangrur"
7/23/19,https://www.tribuneindia.com/news/punjab/ghaggar-flood-capt-urges-haryana-to-join-hands-says-relief-after-survey/806555.html," the cm, who flew over rajpura, ghanaur and shutrana before stopping  over at moonak, said about 50,000 acres of crop had been lost in patiala  and another 10,000 acres in sangrur due to the breach",agri,3,30,40,3,76,"bathinda, patiala, sangrur"
7/23/19,https://www.tribuneindia.com/news/punjab/decide-petition-on-changed-course-of-beas-high-court/806123.html,"tribune news service  chandigarh, july 22 acting on a petition filed in public interest alleging that the beas had unnaturally changed its course by about 2 km resulting in loss of about 2,500 acres of cultivable land due to illegal mining and illegal extension of boundaries of a dera, the punjab and haryana high court today directed the state government to decide a representation in the matter",agri,3,13,5,1,22,punjab
7/22/19,https://www.tribuneindia.com/news/punjab/amarinder-to-conduct-aerial-survey-of-punjab-s-flood-hit-areas-on-tuesday/806064.html,"amarinder singh was informed that agricultural lands were hit in the three villages, but settlements were not affected",agri,3,9,17,0,29,"patiala, sangrur"
7/21/19,https://www.tribuneindia.com/news/punjab/over-22-000-acres-flooded-in-muktsar/805106.html,"over 22,000 acres flooded in muktsar",agri,0,44,11,0,55,"amritsar, bathinda, faridkot, ferozepur, moga, sri muktsar sahib"
7/21/19,https://www.tribuneindia.com/news/punjab/over-22-000-acres-flooded-in-muktsar/805106.html,"tribune news service muktsar, july 20  a large number of farmers, belonging to 58 villages of muktsar district, would be unable to reap any crop this season as rainwater has inundated fields in 22,862 acres",agri,0,44,11,0,55,"amritsar, bathinda, faridkot, ferozepur, moga, sri muktsar sahib"
7/21/19,https://www.tribuneindia.com/news/punjab/over-22-000-acres-flooded-in-muktsar/805106.html,"as per an estimate prepared by the agriculture department, 18,951 acres under paddy crop and 3,951 acres under cotton crop are presently waterlogged",agri,0,44,11,0,55,"amritsar, bathinda, faridkot, ferozepur, moga, sri muktsar sahib"
7/21/19,https://www.tribuneindia.com/news/punjab/over-22-000-acres-flooded-in-muktsar/805106.html," meanwhile, gurpreet singh, agriculture officer, muktsar, said ‚Äúif the paddy fields remain waterlogged for three-four days, then the crop gets devastated",agri,0,44,11,0,55,"amritsar, bathinda, faridkot, ferozepur, moga, sri muktsar sahib"
7/20/19,https://www.tribuneindia.com/news/punjab/cotton-on-6-500-hectares-inundated/804780.html,"perneet singh  tribune news service  bathinda, july 19  following the heavy spell of rainfall in the region this week, farm leaders are claiming huge losses to cotton and paddy crops while seeking immediate ‚Äògirdawari‚Äô followed by adequate relief to the farming community",agri,1,70,43,0,114,"bathinda, mansa"
7/20/19,https://www.tribuneindia.com/news/punjab/cotton-on-6-500-hectares-inundated/804780.html,"subsequently, hundreds of acres of agricultural land got inundated",agri,1,70,43,0,114,"bathinda, mansa"
7/20/19,https://www.tribuneindia.com/news/punjab/cotton-on-6-500-hectares-inundated/804780.html,"  chief agriculture officer, bathinda, gs sidhu said they had got reports that cotton in 6,500 hectares and paddy in 4,000 hectares of area were submerged in the district, but there was no information of crop damage as yet",agri,1,70,43,0,114,"bathinda, mansa"
7/20/19,https://www.tribuneindia.com/news/punjab/cotton-on-6-500-hectares-inundated/804780.html,"  mansa unit chief of the bku ekta ugrahan ram singh bhainibagha said hundreds of acres of paddy and cotton crop were under water in the district over the last two-three days, virtually spelling a doom for the farmers",agri,1,70,43,0,114,"bathinda, mansa"
7/20/19,https://www.tribuneindia.com/news/punjab/cotton-on-6-500-hectares-inundated/804780.html,"he claimed that over 3,000 acres of paddy crop and more than 1,000 acres of cotton crop had been adversely hit by the rainfall in the district",agri,1,70,43,0,114,"bathinda, mansa"
7/20/19,https://www.tribuneindia.com/news/punjab/cotton-on-6-500-hectares-inundated/804780.html," however, chief agriculture officer, mansa, gurmail singh chahal, said 62 acres of crop had been damaged in jhunir block due to canal breach",agri,1,70,43,0,114,"bathinda, mansa"
7/20/19,https://www.tribuneindia.com/news/punjab/cotton-on-6-500-hectares-inundated/804780.html,"besides, 76 acres of crop loss in bhikhi and 42 acres in budhlada had been reported",agri,1,70,43,0,114,"bathinda, mansa"
7/20/19,https://www.tribuneindia.com/news/punjab/cotton-on-6-500-hectares-inundated/804780.html," meanwhile, pau farm economist gs romana said both cotton and paddy crops could not survive, if rainwater remained stagnant in the field for two to three days",agri,1,70,43,0,114,"bathinda, mansa"
7/19/19,https://www.tribuneindia.com/news/punjab/rain-water-enters-muktsar-villages-locals-blame-admn/804083.html,"tribune news service muktsar, july 18  the recent rain has caused damage to paddy and cotton crops and green fodder in the district",agri,8,9,22,0,39,sri muktsar sahib
7/19/19,https://www.tribuneindia.com/news/punjab/breach-in-ghaggar-floods-3-000-acres-of-paddy-fields/804079.html,"breach in ghaggar floods 3,000 acres of paddy fields",agri,2,21,7,1,31,sangrur
7/19/19,https://www.tribuneindia.com/news/punjab/breach-in-ghaggar-floods-3-000-acres-of-paddy-fields/804079.html," water has spread to around 3,000 acres of paddy fields of surrounding villages and also reached the outskirts of moonak",agri,2,21,7,1,31,sangrur
7/18/19,https://www.tribuneindia.com/news/punjab/ghaggar-threat-abates-in-patiala/803584.html,"however, paddy crop on 1,000 acres continues to be submerged for over two days now and farmers have raised concerns over crop loss",agri,12,25,42,0,79,"patiala, sangrur"
7/18/19,https://www.tribuneindia.com/news/punjab/ghaggar-threat-abates-in-patiala/803584.html,"over 300 acres at bolar kalan, 300 acres at chappad village and 100 acres at rathian and adjoining villages are affected",agri,12,25,42,0,79,"patiala, sangrur"
7/18/19,https://www.tribuneindia.com/news/punjab/ghaggar-threat-abates-in-patiala/803584.html,"ush({ });  ‚Äúpaddy crop can remain submerged till three days and remain unaffected,‚Äù said se davinder singh",agri,12,25,42,0,79,"patiala, sangrur"
7/16/19,https://www.tribuneindia.com/news/punjab/paddy-crop-on-hundreds-of-acres-submerged-in-moga-villages/802986.html,paddy crop on hundreds of acres submerged in moga villages,agri,1,29,23,0,53,moga
7/16/19,https://www.tribuneindia.com/news/punjab/paddy-crop-on-hundreds-of-acres-submerged-in-moga-villages/802986.html,"kulwinder sandhu  tribune news service  sanghera (moga), july 16  hundreds of acres of standing paddy crop and green fodder have been submerged in many villages located inside the dhussi bandh of sutlej river in dharamkot sub-division of moga district as the water level rose due to rain in the past 24 hours",agri,1,29,23,0,53,moga
7/16/19,https://www.tribuneindia.com/news/punjab/paddy-crop-on-hundreds-of-acres-submerged-in-moga-villages/802986.html," sanghera village sarpanch balkar singh claimed that paddy, green fodder and mint crops had been damaged on more than 1,500 acres of land inside the dhussi bandh in at least six villages and settlements",agri,1,29,23,0,53,moga
7/10/19,https://www.tribuneindia.com/news/punjab/maize-growers-opt-for-drip-irrigation/799660.html,"kulwinder sandhu tribune news service moga, july 9  with the state government promoting drip irrigation for cotton, maize and horticultural crops to conserve groundwater, at least 68 farmers in moga district have shown interest in cultivating maize using this technique this year",agri,1,43,2,1,47,moga
7/10/19,https://www.tribuneindia.com/news/punjab/maize-growers-opt-for-drip-irrigation/799660.html, chief agriculture officer (cao) paramjit singh brar said the state government had been providing 90 per cent subsidy on the installation of drip irrigation system,agri,1,43,2,1,47,moga
7/10/19,https://www.tribuneindia.com/news/punjab/maize-growers-opt-for-drip-irrigation/799660.html," according to an estimate, the installation of drip irrigation system on an acre costs around rs 1 lakh",agri,1,43,2,1,47,moga
7/10/19,https://www.tribuneindia.com/news/punjab/maize-growers-opt-for-drip-irrigation/799660.html,"as such, a farmer has to pay just rs 10,000 for installing drip irrigation in the fields",agri,1,43,2,1,47,moga
7/10/19,https://www.tribuneindia.com/news/punjab/maize-growers-opt-for-drip-irrigation/799660.html,"ush({ });  he said against the target of establishing drip irrigation on 100 acres in the district for maize crop, they have already received applications from 68 farmers to install this system on 114 acres",agri,1,43,2,1,47,moga
7/10/19,https://www.tribuneindia.com/news/punjab/maize-growers-opt-for-drip-irrigation/799660.html," meanwhile, dr jaswinder singh brar, plant protection officer of moga, said, ‚Äúwith the drip irrigation system farmers can irrigate an acre in just 30 minutes, which not only conserves water but also increases crop yield",agri,1,43,2,1,47,moga
7/10/19,https://www.tribuneindia.com/news/punjab/maize-growers-opt-for-drip-irrigation/799660.html," pritpal singh, a farmer of badhni kalan village who registered himself to install the system on his four acres, said, ‚Äúmaize requires less water and he is hopeful that this technique of conserving water will give good produce as per studies conducted by agro-scientists",agri,1,43,2,1,47,moga
7/10/19,https://www.tribuneindia.com/news/punjab/maize-growers-opt-for-drip-irrigation/799660.html,"  the agriculture department has achieved the target of bringing 2,500 hectares in the district under maize cultivation this year.",agri,1,43,2,1,47,moga
3/20/19,https://www.tribuneindia.com/news/punjab/kartarpur-corridor-villagers-in-pak-demand-compensation-for-their-land/746196.html,hussain said there has been consensus among the villagers to sacrifice their agricultural land but none of them is ready to leave their ancestral houses,agri,17,16,19,7,59,gurdaspur
3/20/19,https://www.tribuneindia.com/news/punjab/kartarpur-corridor-villagers-in-pak-demand-compensation-for-their-land/746196.html,deputy commissioner waheed asghar says the government is acquiring the land under section 4 of the punjab land acquisition act 1894 and it will pay compensation for the crop and land,agri,17,16,19,7,59,gurdaspur
10/1/18,https://www.tribuneindia.com/news/punjab/enforce-ngt-orders-dms-told/661325.html," anticipating the paddy procurement to last up to november 15, the government is worried over short period available for the straw management before the start of rabi cropping season",agri,0,14,1,0,15,moga
10/1/18,https://www.tribuneindia.com/news/punjab/enforce-ngt-orders-dms-told/661325.html,"the farm organisations are demanding rs 6,000 per acre or rs 200 per quintal as financial assistance for the scientific management of paddy straw",agri,0,14,1,0,15,moga
10/1/18,https://www.tribuneindia.com/news/punjab/enforce-ngt-orders-dms-told/661325.html, principal secretary of the agriculture department kahan singh pannu said the state government has announced a stubble management scheme which provides a subsidy of up to 50 per cent to individuals and 80 per cent to cooperative societies and customer hiring centres for the purchase of straw management equipments,agri,0,14,1,0,15,moga
10/1/18,https://www.tribuneindia.com/news/punjab/enforce-ngt-orders-dms-told/661325.html," farm organisations are demanding  rs 6,000 per acre or  rs 200 per quintal as financial assistance for the scientific management of paddy straw",agri,0,14,1,0,15,moga
9/28/18,https://www.tribuneindia.com/news/punjab/91-000-bags-of-illegally-stocked-rice-found/659951.html,"91,000 bags of illegally stocked rice found",agri,5,9,5,0,19,"amritsar, ferozepur, jalandhar, moga, sangrur, sri muktsar sahib"
9/28/18,https://www.tribuneindia.com/news/punjab/91-000-bags-of-illegally-stocked-rice-found/659951.html,"chandigarh: a team of the chief vigilance officer (cvo) of the food and civil supply department today found 91,000 bags of illegally stocked rice in ferozepur, an official press release said here",agri,5,9,5,0,19,"amritsar, ferozepur, jalandhar, moga, sangrur, sri muktsar sahib"
9/28/18,https://www.tribuneindia.com/news/punjab/ghaggar-closer-to-danger-mark/659914.html,"tns water enters villages, 1,000 acres affected moga: water in the sutlej has suddenly increased to alarming levels in the district during the past 24 hours due to heavy rainfall in the catchments areas",agri,10,22,21,0,53,"faridkot, fazilka, moga, sangrur, sri muktsar sahib"
9/28/18,https://www.tribuneindia.com/news/punjab/ghaggar-closer-to-danger-mark/659914.html,"more than 1,000 acres of paddy, maize and other crops have been submerged",agri,10,22,21,0,53,"faridkot, fazilka, moga, sangrur, sri muktsar sahib"
9/27/18,https://www.tribuneindia.com/news/punjab/compensation-for-2017-still-due-fresh-girdawari-ordered/659578.html,"deepkamal kaur tribune news service sultanpur lodhi, september26amidst complaints by farmers that they were yet to receive compensation for the crop loss assessed by the state government last year, punjab chief minister capt amarinder singh today¬†  conducted a survey of the same flood-affected villages along the beas",agri,6,30,25,5,66,"gurdaspur, hoshiarpur, kapurthala, tarn taran"
9/27/18,https://www.tribuneindia.com/news/punjab/compensation-for-2017-still-due-fresh-girdawari-ordered/659578.html," the villagers of qadir baksh, bhaini bahadur, rampur gora, mohamadabad and middewal gave a written representation to the cm that they were yet to receive any compensation for the crop losses incurred around this time in 2017",agri,6,30,25,5,66,"gurdaspur, hoshiarpur, kapurthala, tarn taran"
9/27/18,https://www.tribuneindia.com/news/punjab/compensation-for-2017-still-due-fresh-girdawari-ordered/659578.html,  the cm asked the deputy commissioners to prepare girdawari reports to compensate the farmers for paddy loss within three days,agri,6,30,25,5,66,"gurdaspur, hoshiarpur, kapurthala, tarn taran"
9/27/18,https://www.tribuneindia.com/news/punjab/compensation-for-2017-still-due-fresh-girdawari-ordered/659578.html,"kulwant singh of qadir baksh village and amrik singh of baupur rued, ‚Äúabout 7,000 acres of cultivated land in 16 villages has been completely affected",agri,6,30,25,5,66,"gurdaspur, hoshiarpur, kapurthala, tarn taran"
9/27/18,https://www.tribuneindia.com/news/punjab/cm-surveys-waterlogged-areas/659406.html,"  farmers‚Äô dharna enters day 2  tarn taran: the dharna of the kisan mazdoor sangharsh committee in front of the sdm office, patti, entered the second day on wednesday",agri,10,25,14,2,51,tarn taran
9/27/18,https://www.tribuneindia.com/news/punjab/cm-surveys-waterlogged-areas/659406.html,residents want rainwater drained out from fields which has caused loss to the paddy crop on over 400 acres,agri,10,25,14,2,51,tarn taran
9/25/18,https://www.tribuneindia.com/news/punjab/red-alert-after-heavy-rain-schools-colleges-shut-today/658394.html, army on alert  the army has been asked to remain on alert to help the state deal with any eventuality the cm orders special girdawari to assess crop damage leave of irrigation and drainage staff cancelled¬† people advised to exercise restraint while moving out of their houses during the next 24 hours¬† ,agri,6,4,13,0,23,punjab
7/22/18,https://www.tribuneindia.com/news/punjab/bku-gives-ultimatum-to-admn-on-waterlogging/624471.html,"tribune news service sangrur, july 21  the bhartiya kisan union (bku-ugrahan) on saturday announced to intensify their agitation if the administration failed to make immediate arrangements to drain out rainwater from hundreds of acres of paddy fields in the district",agri,1,21,5,0,27,sangrur
7/22/18,https://www.tribuneindia.com/news/punjab/bku-gives-ultimatum-to-admn-on-waterlogging/624471.html," ‚Äúduring survey, our teams have found that around 2,000 acres of paddy fields have been lying submerged for the last more than a week",agri,1,21,5,0,27,sangrur
4/1/18,https://www.tribuneindia.com/news/punjab/three-killed-as-bike-hits-tree/566939.html,"biker dies in mishap  a farmer, nirmal singh (60) of jhurarkhera village, died and his son amarjit singh (35) was grievously injured as their motorcycle collided with an oil tanker on the city bypass here on saturday afternoon",agri,7,6,5,0,18,faridkot
3/15/18,https://www.tribuneindia.com/news/punjab/more-fury-than-fire-image-takes-a-hit/557888.html,"even though the temptation of getting a finger in the sand-mining pie claimed the ministership of rana gurjit singh and threatens to unsettle charanjit singh channi too, the prices of sand and¬†gravel have come down by almost rs 3,000-5,000 per 900 cubic ft (one tipper)",agri,30,76,15,11,132,"amritsar, bathinda, jalandhar, ludhiana, moga, pathankot, patiala, sas nagar, sbs nagar, tarn taran"
3/15/18,https://www.tribuneindia.com/news/punjab/more-fury-than-fire-image-takes-a-hit/557888.html,"‚Äî capt amarinder singh, who holds the charge of mining department  agriculture tale of drop in the ocean what‚Äôs done  small steps have been taken to ameliorate the suffering of indebted farmers through a crop-loan waiver scheme",agri,30,76,15,11,132,"amritsar, bathinda, jalandhar, ludhiana, moga, pathankot, patiala, sas nagar, sbs nagar, tarn taran"
3/15/18,https://www.tribuneindia.com/news/punjab/more-fury-than-fire-image-takes-a-hit/557888.html,"after three years, the state managed to ensure smooth procurement of both wheat and paddy",agri,30,76,15,11,132,"amritsar, bathinda, jalandhar, ludhiana, moga, pathankot, patiala, sas nagar, sbs nagar, tarn taran"
3/15/18,https://www.tribuneindia.com/news/punjab/more-fury-than-fire-image-takes-a-hit/557888.html," after several years, the state advised price (sap) for sugarcane was raised by rs 10 per quintal",agri,30,76,15,11,132,"amritsar, bathinda, jalandhar, ludhiana, moga, pathankot, patiala, sas nagar, sbs nagar, tarn taran"
3/15/18,https://www.tribuneindia.com/news/punjab/more-fury-than-fire-image-takes-a-hit/557888.html,"after several exclusions, only a small percentage of farmers will get a waiver of up to rs 2 lakh on crop loans",agri,30,76,15,11,132,"amritsar, bathinda, jalandhar, ludhiana, moga, pathankot, patiala, sas nagar, sbs nagar, tarn taran"
3/15/18,https://www.tribuneindia.com/news/punjab/more-fury-than-fire-image-takes-a-hit/557888.html,"farmer suicides have continued unabated, with some estimates saying over 400 indebted farmers have ended their life since the congress government took over",agri,30,76,15,11,132,"amritsar, bathinda, jalandhar, ludhiana, moga, pathankot, patiala, sas nagar, sbs nagar, tarn taran"
3/15/18,https://www.tribuneindia.com/news/punjab/more-fury-than-fire-image-takes-a-hit/557888.html,"we are incentivising farmers to go for crop diversification through various measures, including 80 per cent subsidy on drip irrigation as well as subsidy on the use of solar power for agriculture",agri,30,76,15,11,132,"amritsar, bathinda, jalandhar, ludhiana, moga, pathankot, patiala, sas nagar, sbs nagar, tarn taran"
3/15/18,https://www.tribuneindia.com/news/punjab/more-fury-than-fire-image-takes-a-hit/557888.html,"‚Äî capt amarinder singh, who holds the charge of agriculture  education lessons in staffing what‚Äôs done  despite opposition from anganwari workers, the department has gone ahead with its programme of pre-primary education in 13,000 government schools",agri,30,76,15,11,132,"amritsar, bathinda, jalandhar, ludhiana, moga, pathankot, patiala, sas nagar, sbs nagar, tarn taran"
3/15/18,https://www.tribuneindia.com/news/punjab/more-fury-than-fire-image-takes-a-hit/557888.html,deal with chennai-based firm to set up 400 plants to convert crop residue into bio-energy,agri,30,76,15,11,132,"amritsar, bathinda, jalandhar, ludhiana, moga, pathankot, patiala, sas nagar, sbs nagar, tarn taran"
3/15/18,https://www.tribuneindia.com/news/punjab/more-fury-than-fire-image-takes-a-hit/557888.html,"government re-notifies over 21,000 acres of eco-fragile land around chandigarh under the punjab land preservation act (plpa) 1900",agri,30,76,15,11,132,"amritsar, bathinda, jalandhar, ludhiana, moga, pathankot, patiala, sas nagar, sbs nagar, tarn taran"
3/15/18,https://www.tribuneindia.com/news/punjab/more-fury-than-fire-image-takes-a-hit/557888.html,"this includes 3,725 acre of siswan village, where capt amarinder singh has bought land",agri,30,76,15,11,132,"amritsar, bathinda, jalandhar, ludhiana, moga, pathankot, patiala, sas nagar, sbs nagar, tarn taran"
3/15/18,https://www.tribuneindia.com/news/punjab/more-fury-than-fire-image-takes-a-hit/557888.html,"fencing of forest areas begins; 1,000-acre forestland freed from encroachments",agri,30,76,15,11,132,"amritsar, bathinda, jalandhar, ludhiana, moga, pathankot, patiala, sas nagar, sbs nagar, tarn taran"
3/15/18,https://www.tribuneindia.com/news/punjab/more-fury-than-fire-image-takes-a-hit/557888.html,"a rs 650-cr project, fully funded by the centre, approved for providing machinery like happy seeder and bailing rigs to farmers for paddy straw management",agri,30,76,15,11,132,"amritsar, bathinda, jalandhar, ludhiana, moga, pathankot, patiala, sas nagar, sbs nagar, tarn taran"
3/15/18,https://www.tribuneindia.com/news/punjab/more-fury-than-fire-image-takes-a-hit/557888.html, what remains  state‚Äôs demand for a bonus of rs 100 per quintal of paddy for farmers who do not burn straw not met yet,agri,30,76,15,11,132,"amritsar, bathinda, jalandhar, ludhiana, moga, pathankot, patiala, sas nagar, sbs nagar, tarn taran"
2/14/18,https://www.tribuneindia.com/news/punjab/roadmap-to-control-prices-of-veggies-soon-harsimrat/543722.html,"tribune news service  new delhi, february 13 food processing minister harsimrat kaur badal today said the centre would soon draw a roadmap to control the soaring prices of tomato, onions and potatoes (top)",agri,0,9,1,0,10,punjab
2/14/18,https://www.tribuneindia.com/news/punjab/roadmap-to-control-prices-of-veggies-soon-harsimrat/543722.html," the minister said her department would hold a meeting with stakeholders on march 20 to put on ground the framework for the preservation of tomato, onion and potato by promoting farmer produce organisations, agri-logistics processing facilities and professional management",agri,0,9,1,0,10,punjab
10/18/17,https://www.tribuneindia.com/news/punjab/markfed-launches-kit-for-farmers/483799.html,"tribune news servicechandigarh, october 17  markfed has launched a kisan kit comprising the entire range of agricultural chemicals required from sowing to harvesting of wheat",agri,0,25,1,2,28,punjab
10/18/17,https://www.tribuneindia.com/news/punjab/markfed-launches-kit-for-farmers/483799.html,"amra said markfed had always taken into account the interest of farmers, adding that one kit would provide solutions for controlling weeds, insects and diseases for 11 acres at the cost of 10 acres",agri,0,25,1,2,28,punjab
10/18/17,https://www.tribuneindia.com/news/punjab/markfed-launches-kit-for-farmers/483799.html,the farmers will save rs 600-rs 700 per acre by getting free pesticides for additional acres on buying every kit,agri,0,25,1,2,28,punjab
8/18/17,https://www.tribuneindia.com/news/punjab/jakhar-makers-of-spurious-pesticide-abetting-suicides/453482.html,"tribune news service jalandhar, august 17  state congress chief sunil jakhar today said owners of companies found manufacturing spurious pesticides should be booked for abetting suicide of farmers under a new policy to be formulated by the vidhan sabha",agri,0,21,3,1,25,"jalandhar, mansa, tarn taran"
8/18/17,https://www.tribuneindia.com/news/punjab/jakhar-makers-of-spurious-pesticide-abetting-suicides/453482.html," ‚Äúas per a report from the agriculture department, 36 pesticide samples failed in the past 10 years",agri,0,21,3,1,25,"jalandhar, mansa, tarn taran"
8/18/17,https://www.tribuneindia.com/news/punjab/jakhar-makers-of-spurious-pesticide-abetting-suicides/453482.html,"the girdawari will take place once water starts receding and farmers will be paid rs12,000 per acre in compensation as against rs8,000 paid earlier",agri,0,21,3,1,25,"jalandhar, mansa, tarn taran"
8/10/17,https://www.tribuneindia.com/news/punjab/flood-alert-in-fazilka/449794.html,"kalia has directed the officials concerned to make necessary arrangements in flood-prone villages to safeguard the lives of border area people, their livestock and crops",agri,3,3,4,0,10,fazilka
8/7/17,https://www.tribuneindia.com/news/punjab/how-centre-state-failed-farmers-on-insurance/448344.html,"amarjit thind tribune news service chandigarh, august 6  crop loss for any reason is a setback farmers of punjab ‚Äì most of whom are small ‚Äì can hardly sustain",agri,5,121,20,12,158,"kapurthala, ludhiana"
8/7/17,https://www.tribuneindia.com/news/punjab/how-centre-state-failed-farmers-on-insurance/448344.html,"but this mostly remains meaningless, as often the relief is rs 5,000, or even smaller amounts, paid by the state government for losses of up to rs 40,000-50,000 per acre",agri,5,121,20,12,158,"kapurthala, ludhiana"
8/7/17,https://www.tribuneindia.com/news/punjab/how-centre-state-failed-farmers-on-insurance/448344.html, old-timers like bishan singh and bachan singh of khaira dona village in kapurthala district recall that farmers have been the losers in all farm insurance schemes implemented by the centre since the individual approach basis scheme was launched in 1972,agri,5,121,20,12,158,"kapurthala, ludhiana"
8/7/17,https://www.tribuneindia.com/news/punjab/how-centre-state-failed-farmers-on-insurance/448344.html,"officially, nearly 20 per cent of the cropped area was damaged in floods that year as compared to 13 per cent and 10 per cent in 2009 (15 dead) and 1988 (200 dead), respectively",agri,5,121,20,12,158,"kapurthala, ludhiana"
8/7/17,https://www.tribuneindia.com/news/punjab/how-centre-state-failed-farmers-on-insurance/448344.html," in well-irrigated punjab, those were the heady days of the green revolution (paddy was recording an increase of 5.30 per cent per annum), whereas most of the insurance schemes were tailor-made for rain-fed agriculture of many other states",agri,5,121,20,12,158,"kapurthala, ludhiana"
8/7/17,https://www.tribuneindia.com/news/punjab/how-centre-state-failed-farmers-on-insurance/448344.html," the comprehensive crop insurance scheme (ccis- 1985) focused largely on drought, whereas the state‚Äôs farmers wanted only insurance for hailstorm but with higher indemnity",agri,5,121,20,12,158,"kapurthala, ludhiana"
8/7/17,https://www.tribuneindia.com/news/punjab/how-centre-state-failed-farmers-on-insurance/448344.html,"why pmfby doesn‚Äôt work  in its present avatar, the major flaw in the farm insurance scheme is that it comes into play only if there is 40 per cent crop damage in a village, which is counted as a single unit for availing any relief, says rajewal",agri,5,121,20,12,158,"kapurthala, ludhiana"
8/7/17,https://www.tribuneindia.com/news/punjab/how-centre-state-failed-farmers-on-insurance/448344.html," first, farmers want that instead of being village-specific, the scheme should be farm plot-specific, with crop indemnity (compensation) levels above 95 per cent",agri,5,121,20,12,158,"kapurthala, ludhiana"
8/7/17,https://www.tribuneindia.com/news/punjab/how-centre-state-failed-farmers-on-insurance/448344.html," secondly, farmers demand that the 10-year benchmark for assessing ‚Äònormal‚Äô yield levels while deciding on the insurance premium should be scrapped, and the latest yield should be taken into account",agri,5,121,20,12,158,"kapurthala, ludhiana"
8/7/17,https://www.tribuneindia.com/news/punjab/how-centre-state-failed-farmers-on-insurance/448344.html," the premium should also be standardised to 1 per cent for all crops, as crop losses in punjab are very low as compared to the rest of the country",agri,5,121,20,12,158,"kapurthala, ludhiana"
8/7/17,https://www.tribuneindia.com/news/punjab/how-centre-state-failed-farmers-on-insurance/448344.html," haryana implemented the scheme and its farmers have alleged that the insurance companies collected over rs 750 crore in premium, but only disbursed rs 112 crore as compensation",agri,5,121,20,12,158,"kapurthala, ludhiana"
8/7/17,https://www.tribuneindia.com/news/punjab/how-centre-state-failed-farmers-on-insurance/448344.html,"farmers pay 2 per cent of the premium for kharif crops, 1.5 per cent for rabi and 5 per cent for horticulture crops",agri,5,121,20,12,158,"kapurthala, ludhiana"
8/7/17,https://www.tribuneindia.com/news/punjab/how-centre-state-failed-farmers-on-insurance/448344.html,"on an average, a farmer has to pay rs 800 per acre for rabi and kharif crops and rs 1,250 per acre for cotton as premium",agri,5,121,20,12,158,"kapurthala, ludhiana"
8/7/17,https://www.tribuneindia.com/news/punjab/how-centre-state-failed-farmers-on-insurance/448344.html," the mandi board is equipped to buy the produce from the farmers, and everyone would be more than willing to clean the crop, weigh it and transport it to the nearest state godown",agri,5,121,20,12,158,"kapurthala, ludhiana"
8/7/17,https://www.tribuneindia.com/news/punjab/how-centre-state-failed-farmers-on-insurance/448344.html,"this would not only provide employment to the landless labourers, but also mean an additional income for the farmers on freight charges, he pointed out",agri,5,121,20,12,158,"kapurthala, ludhiana"
8/7/17,https://www.tribuneindia.com/news/punjab/how-centre-state-failed-farmers-on-insurance/448344.html,"unresponsive state govts  punjab‚Äôs reluctance to implement the pmfby also drew the attention of union agriculture minister radha mohan singh, who told the rajya sabha recently that the state should seriously consider implementing the scheme as it had neither sent a draft for drought relief nor done crop insurance in the past five years",agri,5,121,20,12,158,"kapurthala, ludhiana"
8/7/17,https://www.tribuneindia.com/news/punjab/how-centre-state-failed-farmers-on-insurance/448344.html,"‚Äúeven if the balance premium (after farmers‚Äô contribution) is 90 per cent, it will be borne by the government,‚Äù according to an official",agri,5,121,20,12,158,"kapurthala, ludhiana"
8/7/17,https://www.tribuneindia.com/news/punjab/how-centre-state-failed-farmers-on-insurance/448344.html,"solution in guaranteed income; production, market risk both covered  while farmer unions have been agitating for implementing the ms swaminathan commission recommendations and bureaucrats are clueless on what to do, a report¬†by punjab agricultural university (pau), ludhiana, in¬†2014 suggested that a study of all insurance schemes¬†since 1974 till date had revealed that opting for the farm income insurance scheme (fiis-2003-04) would be¬†the best bet for punjab",agri,5,121,20,12,158,"kapurthala, ludhiana"
8/7/17,https://www.tribuneindia.com/news/punjab/how-centre-state-failed-farmers-on-insurance/448344.html, it envisages targeting two critical components that decides a farmer‚Äôs income ‚Äî yield and price ‚Äî through a single¬†policy instrument by ensuring a ‚Äúminimum guaranteed income‚Äù determined by using the average yield for the previous seven years and the msp,agri,5,121,20,12,158,"kapurthala, ludhiana"
8/7/17,https://www.tribuneindia.com/news/punjab/india-set-for-record-kharif-crop-harvest/448343.html,"new delhi, august 6  foodgrain output in the ongoing kharif season is likely to surpass last year‚Äôs record of 138.04 million tonnes due to higher acreage and good monsoon for the second straight year, agriculture secretary shobhana k pattanayak said today",agri,0,38,2,0,40,punjab
8/7/17,https://www.tribuneindia.com/news/punjab/india-set-for-record-kharif-crop-harvest/448343.html,"so far, more than 80 per cent of the sowing of kharif crops ‚Äî paddy, pulses, oilseeds, cotton, sugarcane and jute ‚Äî has been completed and the planting would continue in some parts till next month, pattanayak said",agri,0,38,2,0,40,punjab
8/7/17,https://www.tribuneindia.com/news/punjab/india-set-for-record-kharif-crop-harvest/448343.html,"about 19 lakh hectare of crop area has been affected by floods across the country and farmers are likely to take up other kharif crops once the water recedes, he said, expressing concern about poor rain in some parts of karnataka",agri,0,38,2,0,40,punjab
8/7/17,https://www.tribuneindia.com/news/punjab/india-set-for-record-kharif-crop-harvest/448343.html,"while there were floods in some states, there was a drought-like situation in parts of karnataka, pattanayak said, adding that there had still been close to 3 per cent jump in the acreage under kharif crops so far",agri,0,38,2,0,40,punjab
8/7/17,https://www.tribuneindia.com/news/punjab/india-set-for-record-kharif-crop-harvest/448343.html,pattanayak said farmers in flood-hit areas would replant other crops in 19 lakh hectare once the water receded,agri,0,38,2,0,40,punjab
8/7/17,https://www.tribuneindia.com/news/punjab/india-set-for-record-kharif-crop-harvest/448343.html,"till last week, farmers had sown kharif crops on 878.23 lakh hectares as against 855.85 lakh in the year-ago period, as per the agriculture ministry‚Äôs latest data",agri,0,38,2,0,40,punjab
8/7/17,https://www.tribuneindia.com/news/punjab/india-set-for-record-kharif-crop-harvest/448343.html,"ush({ });paddy ‚Äî the main kharif  crop ‚Äî was sown on 280.03 lakh hectares as against 266.93 lakh, while pulses covered 121.28 lakh hectares as against 116.95 lakh in the same period",agri,0,38,2,0,40,punjab
8/7/17,https://www.tribuneindia.com/news/punjab/india-set-for-record-kharif-crop-harvest/448343.html,"however, oilseeds acreage was down at 148.88 lakh hectare till last week of the kharif season from 165.49 lakh hectare in the same period last year",agri,0,38,2,0,40,punjab
8/7/17,https://www.tribuneindia.com/news/punjab/india-set-for-record-kharif-crop-harvest/448343.html,cotton acreage has increased to 114.34 lakh hectare so far in the 2017-18 kharif season from 96.48 lakh in the year-ago period on account of good rain and better prices,agri,0,38,2,0,40,punjab
7/31/17,https://www.tribuneindia.com/news/punjab/polls-probes-kept-officials-busy-flooding-may-be-the-price-to-pay/444763.html,"sanjeev singh bariana tribune news service chandigarh, july 30  punjab may have to pay a price in terms of flooding in many areas as a consequence of the unearthing of alleged scams in the government, which diverted the attention of the irrigation ministry, and the assembly elections earlier this year",agri,0,18,10,0,28,"fatehgarh sahib, hoshiarpur, jalandhar, kapurthala, ludhiana, patiala, sas nagar, sbs nagar"
7/31/17,https://www.tribuneindia.com/news/punjab/polls-probes-kept-officials-busy-flooding-may-be-the-price-to-pay/444763.html,my paddy crop was washed away in 2012,agri,0,18,10,0,28,"fatehgarh sahib, hoshiarpur, jalandhar, kapurthala, ludhiana, patiala, sas nagar, sbs nagar"
7/6/17,https://www.tribuneindia.com/news/punjab/canal-cleaning-govt-laxity-to-cost-paddy-growers-dear/432290.html,"sanjeev singh bariana tribune news service chandigarh, july 5  more than a dozen leakages in canals and drains of the state flooding agricultural land in scores of villages during the last fortnight are a clear indication that punjab farmers, mainly paddy growers will have to bear the brunt of flooding in the monsoon this year",agri,0,16,14,2,32,"barnala, gurdaspur, mansa, sangrur"
7/3/17,https://www.tribuneindia.com/news/punjab/crops-on-3k-acres-submerged/430876.html,crops on 3k acres submerged,agri,3,86,30,2,121,barnala
7/3/17,https://www.tribuneindia.com/news/punjab/crops-on-3k-acres-submerged/430876.html,"parvesh sharma tribune news service barnala, july 2  standing crop on thousands of acres is submerged in rain and canal water¬†for the past three days¬†in various villages of this district",agri,3,86,30,2,121,barnala
7/3/17,https://www.tribuneindia.com/news/punjab/crops-on-3k-acres-submerged/430876.html," farmers claim to have suffered losses of crops on above 3,000 acres due to inundation of their fields",agri,3,86,30,2,121,barnala
7/3/17,https://www.tribuneindia.com/news/punjab/crops-on-3k-acres-submerged/430876.html,"the agriculture department, however, puts the figure at around 2,000 acres",agri,3,86,30,2,121,barnala
7/3/17,https://www.tribuneindia.com/news/punjab/crops-on-3k-acres-submerged/430876.html,"ush({ });  farmers said incessant rains for two days, a breach in a sub-canal and overflowing kurd drain flooded 3,000 acres of farm land in cheema, kaire, jodhpur and some other surrounding villages",agri,3,86,30,2,121,barnala
7/3/17,https://www.tribuneindia.com/news/punjab/crops-on-3k-acres-submerged/430876.html," according to initial estimates of the agriculture department, around 2,000 acres in various villages are submerged",agri,3,86,30,2,121,barnala
7/3/17,https://www.tribuneindia.com/news/punjab/crops-on-3k-acres-submerged/430876.html,"  ‚Äúaround 2,000 acres are under water",agri,3,86,30,2,121,barnala
7/3/17,https://www.tribuneindia.com/news/punjab/crops-on-3k-acres-submerged/430876.html, farmers from thikriwala said survival of their crops was impossible as these were lying under water for the past three days,agri,3,86,30,2,121,barnala
7/3/17,https://www.tribuneindia.com/news/punjab/crops-on-3k-acres-submerged/430876.html,"making efforts to drain out water: agri official  around 2,000 acres are under water",agri,3,86,30,2,121,barnala
5/11/17,https://www.tribuneindia.com/news/community/fake-cotton-seeds-flood-malwa/405329.html, ‚Äúa packet of 450 gm was being sold to farmers for rs 800,agri,0,32,3,0,35,"fazilka, mansa, sri muktsar sahib"
5/11/17,https://www.tribuneindia.com/news/community/fake-cotton-seeds-flood-malwa/405329.html,"the cellphone number printed on it has been found to be fake,‚Äù said parminder dhanju, agricultural development officer (ado), fazilka",agri,0,32,3,0,35,"fazilka, mansa, sri muktsar sahib"
3/31/17,https://www.tribuneindia.com/news/courts/mandi-board-sat-on-u-khand-flood-relief-for-3-years-cag/384905.html,"amaninder pal tribune news service chandigarh, march 30 almost four years ago, the punjab state agricultural marketing board (mandi board) collected rs23 lakh as relief meant for victims of the 2013 uttarakhand floods after deducting one-day salary of around 3,000 employees of the board and market committees associated with it",agri,2,2,7,1,12,punjab
3/7/17,https://www.tribuneindia.com/news/community/gaushalas-got-free-power-without-pserc-go-ahead/373881.html,"ush({ });  official sources said the pspcl allowed rs 4.7-crore subsidy to gaushalas, rs 11.17 crore to flood-affected villages and another rs 50 lakh to mushroom farmers in violation of the punjab state electricity regulatory commission (pserc) rules and the electricity act",agri,0,6,7,2,15,patiala
2/11/17,https://www.tribuneindia.com/news/community/nod-to-desilting-repair-of-harike-barrage-gates/362578.html,"silt and hyacinth reduced the storage of harike reservoir from 67,900 acre feet to 9,300 acre feet",agri,0,6,3,0,9,"ferozepur, sas nagar"
1/31/17,https://www.tribuneindia.com/news/politics/tota-singh-on-sticky-wicket-in-dharamkot/357293.html,"kulwinder sandhu tribune news service moga, january 30  akali heavyweight and agriculture minister jathedar tota singh is locked in a tough contest with congress candidate kaka sukhjit singh lohgarh and aap nominee daljit singh sadarpura in the dharamkot constituency of moga district",agri,2,5,4,2,13,moga
9/3/16,https://www.tribuneindia.com/news/community/water-supply-to-gang-canal-slashed/289502.html,"122, farmers were assisting scores of labourers in the repair of the damaged sidewalls near burji numbers 140 and 144, but the strips used for patrolling had also got damaged during the recent rains",agri,1,12,11,0,24,ferozepur
9/3/16,https://www.tribuneindia.com/news/community/water-supply-to-gang-canal-slashed/289502.html,"about 11,200 acres of crop area is irrigated using the canal water",agri,1,12,11,0,24,ferozepur
7/25/16,https://www.tribuneindia.com/news/community/agri-dept-on-toes-as-rodents-target-bundh/270829.html,"in the makhu block, the agriculture department staff has already started distributing this medicine in villages which are prone to floods",agri,2,15,9,0,26,ferozepur
3/11/16,https://www.tribuneindia.com/news/community/now-money-to-be-credited-in-workers-accounts-by-centre/207349.html,"  the ambit of the scheme has been expanded to include construction of anganwadi, rural toilets, goat shelters, hiring of small marginal farmers who own less than 5 acres of land",agri,0,7,1,2,10,ludhiana
1/9/16,https://www.tribuneindia.com/news/community/capt-warns-of-similar-attack/181312.html,"ush({ }); mes electrician under lens  a military engineering service (mes) electrician, who along with some other colleagues, was responsible for the maintenance of flood lights installed at the periphery of the 1,900-acre air force station, is being questioned by a national investigation agency (nia) team",agri,5,2,1,0,8,"amritsar, jalandhar, pathankot, patiala"
12/3/15,https://www.tribuneindia.com/news/governance/admn-begins-process-to-grant-compensation/165995.html,a compensation of rs 3 lakh will be given to the families of debt-ridden farmers and farm labourers who had committed suicides,agri,2,13,2,8,25,sangrur
12/3/15,https://www.tribuneindia.com/news/governance/admn-begins-process-to-grant-compensation/165995.html, sources said over 50 suicide cases of farmers and farm labourers of the old policy‚Äôs period (before july 23) from this district would also be taken up at the meeting on december 8,agri,2,13,2,8,25,sangrur
11/9/15,https://www.tribuneindia.com/news/community/won-t-grow-basmati-again-farmers/156256.html,"praful chander nagpal our correspondent fazilka, november 8  dismayed over the poor price the 1121 basmati paddy variety fetched this season, farmers might not grow the crop next year",agri,0,61,3,3,67,fazilka
11/9/15,https://www.tribuneindia.com/news/community/won-t-grow-basmati-again-farmers/156256.html," sources said the average yield of parmal paddy per acre was about 33 quintal this year and its minimum support price (msp) was rs 1,450 per quintal",agri,0,61,3,3,67,fazilka
11/9/15,https://www.tribuneindia.com/news/community/won-t-grow-basmati-again-farmers/156256.html,"thus, farmers earn about rs 47,850 per acre",agri,0,61,3,3,67,fazilka
11/9/15,https://www.tribuneindia.com/news/community/won-t-grow-basmati-again-farmers/156256.html," on the other hand, the average yield per acre for 1121 basmati paddy variety is about 19 quintals, while its price per quintal is rs 1,650",agri,0,61,3,3,67,fazilka
11/9/15,https://www.tribuneindia.com/news/community/won-t-grow-basmati-again-farmers/156256.html,"so the farmers cultivating this variety earn only rs 31,350 per acre",agri,0,61,3,3,67,fazilka
11/9/15,https://www.tribuneindia.com/news/community/won-t-grow-basmati-again-farmers/156256.html,"ush({ });  ‚Äúwe will sow parmal paddy in the future as growing basmati proved to be costly,‚Äù said farmer jawinder singh of nurpura village, who grew basmati on 8 acres",agri,0,61,3,3,67,fazilka
11/9/15,https://www.tribuneindia.com/news/community/won-t-grow-basmati-again-farmers/156256.html,‚Äúfarmers have to spray pesticide on the basmati crop nearly three times more compared to parmal variety,agri,0,61,3,3,67,fazilka
10/12/15,https://www.tribuneindia.com/news/community/basmati-unlikely-to-fetch-better-price/144893.html,"praful chander nagpal  fazilka, october 11  rice mill owners have criticised the government‚Äôs decision to impose 7 per cent tax on them",agri,1,39,5,4,49,fazilka
10/12/15,https://www.tribuneindia.com/news/community/basmati-unlikely-to-fetch-better-price/144893.html,"already incurring losses, rice millers fear with the arrival of aromatic fine 1121 variety of basmati in the grain market in a few days the crisis may deepen",agri,1,39,5,4,49,fazilka
10/12/15,https://www.tribuneindia.com/news/community/basmati-unlikely-to-fetch-better-price/144893.html, ‚Äúthe imposition of tax is likely to affect the equilibrium price of the market driven 1121 variety of paddy as the buying cost will increase,agri,1,39,5,4,49,fazilka
10/12/15,https://www.tribuneindia.com/news/community/basmati-unlikely-to-fetch-better-price/144893.html,"on the other hand, due to geo-political reasons, the prices of basmati rice slashed to 40 per cent last year,‚Äù said ashok grover, president, punjab basmati rice millers‚Äô association",agri,1,39,5,4,49,fazilka
10/12/15,https://www.tribuneindia.com/news/community/basmati-unlikely-to-fetch-better-price/144893.html," the rice millers purchased paddy on a higher rate and sold rice on lower prices last year, resulting in huge losses to the tune of hundreds of crores of rupees",agri,1,39,5,4,49,fazilka
10/12/15,https://www.tribuneindia.com/news/community/basmati-unlikely-to-fetch-better-price/144893.html,"ush({ });  the 1121 variety is purchased at a higher rate than the minimum support price of rs 1,450 per quintal",agri,1,39,5,4,49,fazilka
10/12/15,https://www.tribuneindia.com/news/community/basmati-unlikely-to-fetch-better-price/144893.html,"the traders are not going to offer higher rates to the farmers as they will have to shell out 7 per cent extra to the government,‚Äù said navdeep singh, a farmer in banwala village",agri,1,39,5,4,49,fazilka
10/12/15,https://www.tribuneindia.com/news/community/basmati-unlikely-to-fetch-better-price/144893.html," the farmers have pleaded that 7 per cent tax is higher as compared to neighbouring state of haryana, which is geographically in an advantageous position being nearer to delhi",agri,1,39,5,4,49,fazilka
8/25/15,https://www.tribuneindia.com/news/crime/boy-s-death-four-booked/124069.html,"ush({ }); labourer electrocutedmanpreet singh (18), a farm labourer, was electrocuted while working in the fields at jodh singh wala village, 40 km from here, falling under the khalra police station",agri,11,4,4,0,19,"amritsar, sas nagar, tarn taran"
8/17/15,https://www.tribuneindia.com/news/punjab/having-no-machines-ferozepur-admn-makes-kids-fill-sandbags/120193.html," the 20-ft wide embankments have been raised in tendi wala village permanently by the bsf as a shield to protect its check posts, vulnerable to pakistan rangers‚Äô firing, and to save thousands of acres of agricultural land in the adjoining villages from the fury of the swollen sutlej during rains",agri,6,7,11,0,24,ferozepur
8/17/15,https://www.tribuneindia.com/news/punjab/having-no-machines-ferozepur-admn-makes-kids-fill-sandbags/120193.html," sukhpal singh nannu, former bjp mla who visited tendi wala village today, said many farmers have alleged that no work was done to strengthen these embankments for the past many years",agri,6,7,11,0,24,ferozepur
8/13/15,https://www.tribuneindia.com/news/community/ferozepur-villagers-start-shifting-belongings-to-safer-places/119221.html,"ush({ });  about 500 acres in my village are facing erosion, said mangal singh, a former sarpanch of chandiwala",agri,12,13,27,0,52,ferozepur
8/12/15,https://www.tribuneindia.com/news/community/sutlej-swells-moga-village-houses-flooded/118742.html,"more than 3,000 acres of paddy, maize and other crops have been submerged under water",agri,7,14,22,0,43,moga
7/21/15,https://www.tribuneindia.com/news/community/sutlej-swells-crops-on-2-000-acres-submerged-in-moga/109300.html,"sutlej swells, crops on 2,000 acres submerged in moga",agri,4,32,18,0,54,"ludhiana, moga"
7/21/15,https://www.tribuneindia.com/news/community/sutlej-swells-crops-on-2-000-acres-submerged-in-moga/109300.html,"tribune news service moga, july 20  the rise in water level in the sutlej has submerged crops on over 2,000 acres in moga district",agri,4,32,18,0,54,"ludhiana, moga"
7/21/15,https://www.tribuneindia.com/news/community/sutlej-swells-crops-on-2-000-acres-submerged-in-moga/109300.html," agriculture development officer dr jaswinder singh brar said that crops on 630 acres in sanghera village, 630 acres in boghewal village, 98 acres in melak, 120 acres in bandala, 700 acres in mandar, 100 acres in bhaini and 120 acres in madarpur have been submerged",agri,4,32,18,0,54,"ludhiana, moga"
7/18/15,https://www.tribuneindia.com/news/community/swan-in-spate-fields-inundated/108177.html,"tribune news service ropar, july 17  hundreds of acres were inundated in villages near anandpur sahib when the water level in the swan river rose sharply due to heavy rain in the region this morning",agri,2,11,15,3,31,amritsar
5/29/15,https://www.tribuneindia.com/news/governance/focus-on-key-pockets-not-on-all-round-development/86517.html,"ush({ });  no flights started from bathinda airport even after two years of its completion no steps taken to check pollution in the ghaggar, which is posing serious health problems to residents of sardulgarh failed to get relief for farmers hit by crop loss mann village, adopted by her, yet to get a vet hospital, health centre and a bank grievances of old-age pensioners not resolved   strengthening her mass base, harsimrat is spending considerable time in her constituency, meeting people and listening to their grievances",agri,22,24,22,1,69,"amritsar, bathinda, fatehgarh sahib, fazilka, ferozepur, gurdaspur, jalandhar, pathankot, sangrur, sas nagar"
5/29/15,https://www.tribuneindia.com/news/governance/focus-on-key-pockets-not-on-all-round-development/86517.html," gurdaspur  vinod khanna (bjp) questions asked: 6  mp lad funds utilised: rs 1.32 crore attendance: 97% initiatives taken  work started for mobile connectivity in bamial area near the indo-pak border food processing unit sanction in kalanaur on 1600 acres of panchayat land issue of low-hanging electricity wires on the amritsar-pathankot highway sorted sought tax holiday for industrial units in border belt tourism projects surrounding ranjit sagar dam lake  unkept promises  narrow gauge railway line through pathankot not upgraded no sign of all round development as most projects started near pathankot all other assembly segments ignored the qadian-beas rail line not restored   the actor-turned-politician, khanna joined the bjp in 1997",agri,22,24,22,1,69,"amritsar, bathinda, fatehgarh sahib, fazilka, ferozepur, gurdaspur, jalandhar, pathankot, sangrur, sas nagar"
5/29/15,https://www.tribuneindia.com/news/governance/focus-on-key-pockets-not-on-all-round-development/86517.html," performance in parliament  the 18 questions chaudhary santokh singh has asked pertain to poor lifting of wheat from mandis, manned and unmanned railway crossings in the country, cases of accidents pending with the railway tribunal and their status, old-age persons in the country who are below poverty line, rewards for medal winner sportspersons in punjab and state-wise fund allocation for roads covered under the pradhan mantri gram sadak yojna",agri,22,24,22,1,69,"amritsar, bathinda, fatehgarh sahib, fazilka, ferozepur, gurdaspur, jalandhar, pathankot, sangrur, sas nagar"
5/29/15,https://www.tribuneindia.com/news/governance/focus-on-key-pockets-not-on-all-round-development/86517.html,"ferozepur¬†  sher singh ghubaya (sad) questions asked: 14 attendance: 78%  mp lad funds utilised: rs 3.75 crore initiatives taken  sanctioned money for ro plants and toilets in schools spent rs 1.40 crore on the purchase of water tankers for panchayats was instrumental in getting ferozepur-chandigarh express resumed adopted dhandi qadim village in jalalabad to bring about its development raised the issue of poor rail and road connectivity in the region¬†  unkept promises  failed to reopen the hussainiwala border for trade and transit couldn‚Äôt reduce unemployment in this border region failed to review outdated laws in the cantonment area couldn‚Äôt compensate border farmers with land holdings across the fence didn‚Äôt connect ferozepur with shatabadi express   from being an accountant at a brick kiln to a two-time parliamentarian, ferozepur mp sher singh ghubaya today is one of the tallest ‚Äúrai sikh‚Äù leaders in the state",agri,22,24,22,1,69,"amritsar, bathinda, fatehgarh sahib, fazilka, ferozepur, gurdaspur, jalandhar, pathankot, sangrur, sas nagar"
4/13/15,https://www.tribuneindia.com/news/punjab/implement-crop-insurance-scheme-cm-to-centre/66646.html,"archit watts tribune news service muktsar, april 12  chief minister parkash singh badal today appealed to the centre to introduce crop insurance scheme at the earliest, terming it the remedy of all ills plaguing the farming community",agri,2,87,29,3,121,"fazilka, sri muktsar sahib"
4/13/15,https://www.tribuneindia.com/news/punjab/implement-crop-insurance-scheme-cm-to-centre/66646.html," badal demanded that the compensation amount be enhanced to rs 10,000 per acre for farmers affected by natural calamities",agri,2,87,29,3,121,"fazilka, sri muktsar sahib"
4/13/15,https://www.tribuneindia.com/news/punjab/implement-crop-insurance-scheme-cm-to-centre/66646.html,ush({ });  ‚Äúit is unfortunate that wheat crop over thousands of acres has been damaged due to untimely rain,agri,2,87,29,3,121,"fazilka, sri muktsar sahib"
4/13/15,https://www.tribuneindia.com/news/punjab/implement-crop-insurance-scheme-cm-to-centre/66646.html,"had sought higher relief from upa  badal, in august 2013 when the upa was in power, had sought a compensation of rs 20,000 per acre for flood-ravaged regions of the state",agri,2,87,29,3,121,"fazilka, sri muktsar sahib"
4/13/15,https://www.tribuneindia.com/news/punjab/implement-crop-insurance-scheme-cm-to-centre/66646.html,"in sharp contrast, the cm has now sought a compensation of rs 10,000 per acre for rain-hit farmers patwari accused of bribery, probe on  muktsar: some farmers of panniwala village in lambi on sunday complained to chief minister parkash singh badal that local patwari sukhdev singh was demanding rs 1,000 from every farmer to assess the loss to their crops",agri,2,87,29,3,121,"fazilka, sri muktsar sahib"
4/7/15,https://www.tribuneindia.com/news/community/haryana-to-get-more-water-from-bhakra/63910.html,"aman sood tribune news service patiala, april 6  farmers and politicians are on toes against increasing the height of the bhakra main line canal (bml) embankment near khanauri in sangrur by one-and-a-half feet by the punjab irrigation department",agri,1,16,5,2,24,"patiala, sangrur"
3/18/15,https://www.tribuneindia.com/news/punjab/punjab-budget-speech-text/55244.html," the budget also lays down steps to steer the state towards the 2 course of prudent fiscal consolidation, promote industrial development, revive the agriculture sector and promote all round inclusive development",agri,#N/A,#N/A,#N/A,#N/A,#N/A,#N/A
3/18/15,https://www.tribuneindia.com/news/punjab/punjab-budget-speech-text/55244.html,"¬†¬† as per advance estimates, the gsdp at current prices is estimated to grow at 10.16% in the current fiscal year (2014-15)",agri,#N/A,#N/A,#N/A,#N/A,#N/A,#N/A
3/18/15,https://www.tribuneindia.com/news/punjab/punjab-budget-speech-text/55244.html," during the year 2013-14, the gsdp at constant prices grew at 5.73% against the national growth rate of 4.74%",agri,#N/A,#N/A,#N/A,#N/A,#N/A,#N/A
3/18/15,https://www.tribuneindia.com/news/punjab/punjab-budget-speech-text/55244.html,the per capita income of the state at current prices is also estimated to increase from rs 92350 in 2013-14 to rs 99578 in 2014-15 (a),agri,#N/A,#N/A,#N/A,#N/A,#N/A,#N/A
3/18/15,https://www.tribuneindia.com/news/punjab/punjab-budget-speech-text/55244.html,agriculture 14,agri,#N/A,#N/A,#N/A,#N/A,#N/A,#N/A
3/18/15,https://www.tribuneindia.com/news/punjab/punjab-budget-speech-text/55244.html," agriculture is the mainstay of¬†punjab‚Äôs economy, providing livelihood to over 60% of the population in the state",agri,#N/A,#N/A,#N/A,#N/A,#N/A,#N/A
3/18/15,https://www.tribuneindia.com/news/punjab/punjab-budget-speech-text/55244.html,punjab¬†is set to become a leading state in horticulture research and i sincerely hope that the crop diversification process in the state will scale new heights with the establishment of this institute,agri,#N/A,#N/A,#N/A,#N/A,#N/A,#N/A
3/18/15,https://www.tribuneindia.com/news/punjab/punjab-budget-speech-text/55244.html,i have also made an allocation of rs 80 crore for recapitalisation of central cooperative banks in order to further strengthen them to increase their lending for agriculture,agri,#N/A,#N/A,#N/A,#N/A,#N/A,#N/A
3/18/15,https://www.tribuneindia.com/news/punjab/punjab-budget-speech-text/55244.html,agriculture crop husbandry 39,agri,#N/A,#N/A,#N/A,#N/A,#N/A,#N/A
3/18/15,https://www.tribuneindia.com/news/punjab/punjab-budget-speech-text/55244.html,¬†punjab¬†has been contributing about 50-60% of wheat and about 35-40% of rice procured by the government of india for food security of the country for the last four decades,agri,#N/A,#N/A,#N/A,#N/A,#N/A,#N/A
3/18/15,https://www.tribuneindia.com/news/punjab/punjab-budget-speech-text/55244.html,"during rabi 2013-14, the production of wheat was 176.20 lakh tonnes out of which 119 lakh tonnes has been procured by the state",agri,#N/A,#N/A,#N/A,#N/A,#N/A,#N/A
3/18/15,https://www.tribuneindia.com/news/punjab/punjab-budget-speech-text/55244.html,"the free power supplied to the farmers at a cost of about rs 4,778 crore has proved vital in this regard",agri,#N/A,#N/A,#N/A,#N/A,#N/A,#N/A
3/18/15,https://www.tribuneindia.com/news/punjab/punjab-budget-speech-text/55244.html,the state government invested rs 38765 crore for procurement of wheat and paddy in the state in the year 2014-15,agri,#N/A,#N/A,#N/A,#N/A,#N/A,#N/A
3/18/15,https://www.tribuneindia.com/news/punjab/punjab-budget-speech-text/55244.html,compensation for loss due to natural calamity has been enhanced from rs 2000 to rs 5000 per acre,agri,#N/A,#N/A,#N/A,#N/A,#N/A,#N/A
3/18/15,https://www.tribuneindia.com/news/punjab/punjab-budget-speech-text/55244.html,it is proposed to set-up a multi product mega food park in 200 acres of land at ladhowal,agri,#N/A,#N/A,#N/A,#N/A,#N/A,#N/A
3/18/15,https://www.tribuneindia.com/news/punjab/punjab-budget-speech-text/55244.html,"a centre of excellence for vegetable cultivation in collaboration with government of israel has been set up on 15 acres of land at kartarpur, jalandhar and a centre of excellence for potato is being set up at dhogri (jalandhar) 17 under indo-dutch agreement",agri,#N/A,#N/A,#N/A,#N/A,#N/A,#N/A
3/18/15,https://www.tribuneindia.com/news/punjab/punjab-budget-speech-text/55244.html, our government is committed to strengthen the agriculture and allied sectors in the state and i propose to allocate rs 3512 crores for the agriculture sector,agri,#N/A,#N/A,#N/A,#N/A,#N/A,#N/A
3/18/15,https://www.tribuneindia.com/news/punjab/punjab-budget-speech-text/55244.html,"¬∑¬†¬†¬†¬†¬†¬†¬†¬†¬†rs 300 crore - for¬†punjab¬†agricultural¬†university,¬†ludhiana",agri,#N/A,#N/A,#N/A,#N/A,#N/A,#N/A
3/18/15,https://www.tribuneindia.com/news/punjab/punjab-budget-speech-text/55244.html,¬∑¬†¬†¬†¬†¬†¬†¬†¬†¬†rs 230 crore ‚Äì for strengthening of agriculture and allied sectors under rkvy,agri,#N/A,#N/A,#N/A,#N/A,#N/A,#N/A
3/18/15,https://www.tribuneindia.com/news/punjab/punjab-budget-speech-text/55244.html,"a number of initiatives have been taken to address this issue like banning the early plantation of paddy, providing machines like happy seeders, rotavators, zero-till-drills, laser land levellers, balers and rakes to farmers on subsidy",agri,#N/A,#N/A,#N/A,#N/A,#N/A,#N/A
3/18/15,https://www.tribuneindia.com/news/punjab/punjab-budget-speech-text/55244.html,power tariff has been reduced from rs 7.75 per unit to rs 4.57 per unit for the allied farming sector,agri,#N/A,#N/A,#N/A,#N/A,#N/A,#N/A
3/18/15,https://www.tribuneindia.com/news/punjab/punjab-budget-speech-text/55244.html,farm debts 45,agri,#N/A,#N/A,#N/A,#N/A,#N/A,#N/A
3/18/15,https://www.tribuneindia.com/news/punjab/punjab-budget-speech-text/55244.html,rs 94 crore have been distributed during 2012-14 covering 4688 families affected by farmers‚Äô suicides from 2000-2011,agri,#N/A,#N/A,#N/A,#N/A,#N/A,#N/A
3/18/15,https://www.tribuneindia.com/news/punjab/punjab-budget-speech-text/55244.html,"to take care of the farmers‚Äô families, i have provided rs 20 crore for compensation to the families of the farmers who have committed suicide",agri,#N/A,#N/A,#N/A,#N/A,#N/A,#N/A
3/18/15,https://www.tribuneindia.com/news/punjab/punjab-budget-speech-text/55244.html, our government launched the atta dal scheme in order to 19 ensure that prices of essential commodities remain within the reach of the common man,agri,#N/A,#N/A,#N/A,#N/A,#N/A,#N/A
3/18/15,https://www.tribuneindia.com/news/punjab/punjab-budget-speech-text/55244.html,"in the annual plan 2015-16, rs 400 crore has been allocated for new atta dal scheme and it is estimated that 8,70,000 mts of wheat and 65,000 mts of pulses shall be distributed during the year",agri,#N/A,#N/A,#N/A,#N/A,#N/A,#N/A
3/18/15,https://www.tribuneindia.com/news/punjab/punjab-budget-speech-text/55244.html, other major housing initiatives during 2015-16 include: ¬∑¬†¬†¬†¬†¬†¬†¬†¬†¬†ecocity ‚Äì phase-ii to be developed in an area of 310 acres,agri,#N/A,#N/A,#N/A,#N/A,#N/A,#N/A
3/18/15,https://www.tribuneindia.com/news/punjab/punjab-budget-speech-text/55244.html,"¬∑¬†¬†¬†¬†¬†¬†¬†¬†¬†medicity phase-ii-160 acres of land acquired, of which 10 acres of land allotted to the max healthcare institute,chaitanya¬†hospital, jindal ivf nursing home and grewal eye institute",agri,#N/A,#N/A,#N/A,#N/A,#N/A,#N/A
3/18/15,https://www.tribuneindia.com/news/punjab/punjab-budget-speech-text/55244.html,¬∑¬†¬†¬†¬†¬†¬†¬†¬†¬†edu¬†city¬†- gmada is in process of acquiring 309 acres of land for development of¬†edu¬†city¬†and an amount of rs,agri,#N/A,#N/A,#N/A,#N/A,#N/A,#N/A
3/18/15,https://www.tribuneindia.com/news/punjab/punjab-budget-speech-text/55244.html, i have allocated rs 5484 crore in 2015-16 to compensate the power corporation for free power to farmers and rural poor,agri,#N/A,#N/A,#N/A,#N/A,#N/A,#N/A
3/18/15,https://www.tribuneindia.com/news/punjab/punjab-budget-speech-text/55244.html,"india‚Äôs largest roof top solar power plant of capacity 7.50 mw has been commissioned at dera beas district amritsar and world‚Äôs largest cattle dung based bio cng plant is under implementation at haiboval dairy complex,¬†ludhiana",agri,#N/A,#N/A,#N/A,#N/A,#N/A,#N/A
3/18/15,https://www.tribuneindia.com/news/punjab/punjab-budget-speech-text/55244.html,punjab biotechnology incubator‚Äôs facilities have been recognized by agriculture produce export development authority (apeda) in july 2014 and export inspection council (eic) in february 2015,agri,#N/A,#N/A,#N/A,#N/A,#N/A,#N/A
3/18/15,https://www.tribuneindia.com/news/punjab/punjab-budget-speech-text/55244.html," under the border area development programme, an amount of rs 40.00 crore is proposed for the 19 border blocks of six districts for upgrading infrastructure relating to education, health, agriculture and allied infrastructure in social sectors for the year 2015-16",agri,#N/A,#N/A,#N/A,#N/A,#N/A,#N/A
3/19/15,https://www.tribuneindia.com/news/punjab/dhindsa-takes-safe-route-shies-away-from-imposing-fresh-taxes/55207.html,"another rs 3,807.20 crore has been reserved for the power sector; rs 3,035 crore for transport, rs 1,723.39 crore for agriculture and allied services, rs 1,404.86 crore for rural development; and rs 1,005.31 crore for irrigation and flood channels",agri,0,2,1,2,5,punjab
3/19/15,https://www.tribuneindia.com/news/punjab/dhindsa-takes-safe-route-shies-away-from-imposing-fresh-taxes/55207.html,"  the plan allocation has been increased by rs 1,929 crore in social services; rs 758 crore in general economic services (construction of buildings, school and college infrastructure; untied funds of chief minister and deputy chief minister; development of kandi and border area, etc); rs 500 crore in agriculture; rs 330 crore in irrigation and flood control; and by rs 846 crore in the power sector",agri,0,2,1,2,5,punjab
10/29/19,https://www.tribuneindia.com/news/punjab/hc-raps-punjab-agri-dept-officials/853259.html,"saurabh malik tribune news service chandigarh, october 28  taking note of late filing of about 80 complaints alleging violation of the insecticides act, the punjab and haryana high court has asserted that criminal negligence on part of punjab agriculture department officials prima facie stood established",agri,0,3,2,0,5,punjab
9/23/19,https://www.tribuneindia.com/news/punjab/direct-paddy-sowing-saves-62-lakh-litres-water/836624.html,"kulwinder sandhu tribune news service moga, september 22  a farmer of talwandi bhangeria village in moga district has saved at least 62 lakh litres of water in his paddy fields in just two months",agri,1,42,2,0,45,moga
9/23/19,https://www.tribuneindia.com/news/punjab/direct-paddy-sowing-saves-62-lakh-litres-water/836624.html," as per the information, baldev had sown paddy on 7 acres with direct sowing technique and on another 7 acres with the traditional method of flooding the fields, on experimental basis",agri,1,42,2,0,45,moga
9/23/19,https://www.tribuneindia.com/news/punjab/direct-paddy-sowing-saves-62-lakh-litres-water/836624.html,"ush({ });  dr jaswinder singh brar, plant protection officer, who accompanied the team, said when they compared water usage after two months, the team found that the farmer had saved at least 62 lakh litres of water by using the new technique",agri,1,42,2,0,45,moga
9/23/19,https://www.tribuneindia.com/news/punjab/direct-paddy-sowing-saves-62-lakh-litres-water/836624.html," the farmer told the visiting team that he was practicing the technique for the past couple of years and had saved water as well as power worth around rs 1,100 per acre",agri,1,42,2,0,45,moga
9/20/19,https://www.tribuneindia.com/news/punjab/then-and-now-mining-biz-remains-in-political-domain/835054.html,"ruchika m khanna tribune news service chandigarh, september 19  illegal sand mining, allegedly controlled by akalis during 2008-14, and high prices of the basic construction material had led the people to reject the ‚Äúpanthic‚Äù party in the 2014 lok sabha elections",agri,2,6,4,1,13,"faridkot, jalandhar, sbs nagar"
9/20/19,https://www.tribuneindia.com/news/punjab/then-and-now-mining-biz-remains-in-political-domain/835054.html,but there is no shortage of material nor have the prices of sand and gravel gone up,agri,2,6,4,1,13,"faridkot, jalandhar, sbs nagar"
9/1/19,https://www.tribuneindia.com/news/punjab/floods-take-toll-on-houses-villagers-staying-outdoors/825853.html,"  as per the norms, rs 95,100 shall be paid to fully damaged pucca/kutcha houses, for partial (15%) damage rs 5,200 for pucca and rs 3,200 for kutcha houses; and rs 4,100 shall be paid for damaged huts and rs 2,100 for cattle sheds",agri,10,9,60,0,79,punjab
8/26/19,https://www.tribuneindia.com/news/punjab/inflow-from-pak-still-on-army-ndrf-on-alert/822775.html," muktiar, a villager helping army jawans in carrying out the rescue work, said his crop was damaged two years ago as well, but the compensation was still awaited",agri,16,10,27,1,54,ferozepur
8/26/19,https://www.tribuneindia.com/news/punjab/inflow-from-pak-still-on-army-ndrf-on-alert/822775.html," jagjit kumar, who owns eight acres, said the state should either construct a pontoon bridge or at least provide them a new boat",agri,16,10,27,1,54,ferozepur
8/20/19,https://www.tribuneindia.com/news/punjab/over-60-jalandhar-villages-inundated/819821.html,"aparna banerji tribune news servicemianwal/mao sahib (phillaur), august 19¬†  over 60 villages in jalandhar and its periphery were flooded after breaches in the beas and sutlej today and thousands of acres of paddy fields were submerged after water released from the ropar headworks made its way to the area",agri,21,29,37,0,87,"jalandhar, kapurthala"
8/20/19,https://www.tribuneindia.com/news/punjab/over-60-jalandhar-villages-inundated/819821.html,  crops in thousands of acres were submerged and at least 200 people were safely evacuated from jalandhar and kapurthala in relief operations launched by the administration and villagers,agri,21,29,37,0,87,"jalandhar, kapurthala"
8/20/19,https://www.tribuneindia.com/news/punjab/over-60-jalandhar-villages-inundated/819821.html,"while crops in 11,400 acres were destroyed in phillaur alone, the administration was assessing the damage in the remaining areas",agri,21,29,37,0,87,"jalandhar, kapurthala"
8/12/19,https://www.tribuneindia.com/news/punjab/sutlej-in-spate-damages-crops-on-1-000-acres-in-moga/816574.html,"sutlej in spate, damages crops on 1,000 acres in moga",agri,4,17,21,0,42,moga
8/12/19,https://www.tribuneindia.com/news/punjab/sutlej-in-spate-damages-crops-on-1-000-acres-in-moga/816574.html,"tribune news service moga, august 11  the water level has once again risen in the sutlej, inundating the standing paddy crop and fodder in many villages and settlements located in dharamkot subdivision of moga district during the past 24 hours",agri,4,17,21,0,42,moga
8/12/19,https://www.tribuneindia.com/news/punjab/sutlej-in-spate-damages-crops-on-1-000-acres-in-moga/816574.html,"‚Äúpaddy, fodder and vegetables have been damaged on more than 1,000 acres in at least six villages,‚Äù he said",agri,4,17,21,0,42,moga
8/9/19,https://www.tribuneindia.com/news/punjab/3-weeks-on-fields-still-inundated-in-muktsar/814993.html," sukhjinder singh, a resident of udekaran village, said, ‚Äúnearly 600 acres is still waterlogged in and around our village",agri,4,23,20,0,47,sri muktsar sahib
8/9/19,https://www.tribuneindia.com/news/punjab/3-weeks-on-fields-still-inundated-in-muktsar/814993.html,"  meanwhile, the district administration has informed the state government that crops on 24,975 acres have been damaged due to rain",agri,4,23,20,0,47,sri muktsar sahib
8/3/19,https://www.tribuneindia.com/news/punjab/rain-leaves-trail-of-destruction-in-muktsar/812092.html," baljinder singh, chief agriculture officer, muktsar, said, ‚Äúmaximum 47.6 mm rainfall is recorded in muktsar block, 27.2 mm in gidderbaha, 25 mm in malout and 8 mm in lambi",agri,3,3,13,0,19,"bathinda, sri muktsar sahib"
7/24/19,https://www.tribuneindia.com/news/punjab/will-take-up-ghaggar-issue-with-centre-cm/806748.html," five days after a 100-feet breach flooded thousands of acres of agricultural fields and villages, the sangrur administration with the help the ndrf, sdrf, army and locals today completely plugged the breach",agri,3,28,14,4,49,"patiala, sangrur"
7/24/19,https://www.tribuneindia.com/news/punjab/will-take-up-ghaggar-issue-with-centre-cm/806748.html," the cm, who flew over rajpura, ghanaur and shatrana, before stopping at moonak in sangrur, said about 50,000 acres of crop had been lost in patiala and another 10,000 acres in sangrur due to the breach in ghaggar",agri,3,28,14,4,49,"patiala, sangrur"
7/24/19,https://www.tribuneindia.com/news/punjab/will-take-up-ghaggar-issue-with-centre-cm/806748.html,"tns  compensation soon  about 50,000 acres of crop has been lost in patiala and another 10,000 acres in sangrur due to breach in the ghaggar",agri,3,28,14,4,49,"patiala, sangrur"
7/23/19,https://www.tribuneindia.com/news/punjab/crops-over-21k-acres-hit-govt-steps-up-relief-ops/806121.html,"crops over 21k acres hit, govt steps up relief ops",agri,0,33,11,0,44,sangrur
7/23/19,https://www.tribuneindia.com/news/punjab/crops-over-21k-acres-hit-govt-steps-up-relief-ops/806121.html," as per the latest report, the overflowing ghaggar has affected standing crop on 21,775 acres",agri,0,33,11,0,44,sangrur
7/23/19,https://www.tribuneindia.com/news/punjab/crops-over-21k-acres-hit-govt-steps-up-relief-ops/806121.html,"of this, crop on 15,569 acres was affected due to the breach in the river in the last five days",agri,0,33,11,0,44,sangrur
7/23/19,https://www.tribuneindia.com/news/punjab/crops-over-21k-acres-hit-govt-steps-up-relief-ops/806121.html,"  the flooding has affected crops such as paddy, vegetables, cotton, maize and fodder over 7,392 acres in moonak, 920 bhundar bhaini, 567 surjan bhaini, 1,883 salegarh and 1,622 phullad village",agri,0,33,11,0,44,sangrur
7/23/19,https://www.tribuneindia.com/news/punjab/crops-over-21k-acres-hit-govt-steps-up-relief-ops/806121.html,"apart from ghaggar, rain has also affected 6206 acres of standing crops in lehragaga, andana,sunam, dhuri and sangrur blocks",agri,0,33,11,0,44,sangrur
7/23/19,https://www.tribuneindia.com/news/punjab/crops-over-21k-acres-hit-govt-steps-up-relief-ops/806121.html,"ush({ });  senior officials of the agriculture department said after remaining waterlogged for five day, the chances of survival of various crops were dim as even after plugging of the breach, the drainage department would not be able to dewater the fields immediately",agri,0,33,11,0,44,sangrur
7/20/19,https://www.tribuneindia.com/news/punjab/ghaggar-breach-destroys-paddy/804677.html,"  ghaggar, flowing above the danger mark, has flooded 4,000 acres of agriculture land",agri,7,22,18,1,48,sangrur
7/20/19,https://www.tribuneindia.com/news/punjab/ghaggar-breach-destroys-paddy/804677.html,"a worried kamaljit singh said he had grown paddy on 12 acres, which was now submerged",agri,7,22,18,1,48,sangrur
7/20/19,https://www.tribuneindia.com/news/punjab/ghaggar-breach-destroys-paddy/804677.html," according to drainage department officials, from khanauri to makraud¬† sahib the width of the riverbedis102 feet, with the government acquiring adjoining land from farmers in 2006",agri,7,22,18,1,48,sangrur
7/17/19,https://www.tribuneindia.com/news/punjab/fields-in-moga-flooded-as-sutlej-swells/803033.html,"tribune news service  sanghera (moga), july 16   hundreds of acres of standing paddy crop and green fodder have been submerged in water in many villages/settlements located inside the dhusi bundh of the sutlej in dharamkot subdivision of the district as the water level in the river has increased due to moderate and heavy rainfall in its catchment areas during the past 24 hours",agri,1,21,18,0,40,moga
7/17/19,https://www.tribuneindia.com/news/punjab/fields-in-moga-flooded-as-sutlej-swells/803033.html," sarpanch of sanghera village balkar singh claimed that paddy, green fodder and mint crops were damaged on more than 1,500 acres of land inside the dhusi bundh in at least six villages and human settlements",agri,1,21,18,0,40,moga
7/15/19,https://www.tribuneindia.com/news/punjab/use-direct-paddy-seeding-to-save-water-suggests-study/802069.html,"kulwinder sandhu tribune news service moga, july 14 pushing for sustainable agriculture practices, the union government is carrying out a study with the help of the state agriculture department in moga and its adjoining districts to substantiate the worth of directly sowing paddy without puddling the fields",agri,2,54,2,0,58,moga
7/15/19,https://www.tribuneindia.com/news/punjab/use-direct-paddy-seeding-to-save-water-suggests-study/802069.html,he has sown paddy on seven acres with this technique and seven acres with the traditional practice of flooding the fields with water,agri,2,54,2,0,58,moga
7/15/19,https://www.tribuneindia.com/news/punjab/use-direct-paddy-seeding-to-save-water-suggests-study/802069.html,"the farmer told the visiting team that he was practicing the new technique for the past couple of years and has found that he saved around rs 1,100 per acre on power consumption, which comes out to rs 2,750 per hectare",agri,2,54,2,0,58,moga
7/15/19,https://www.tribuneindia.com/news/punjab/use-direct-paddy-seeding-to-save-water-suggests-study/802069.html,"jaswinder singh brar, plant protection officer of moga district, who accompanied the central team, said 41.58 lakh hectares in punjab was under cultivation of various crops",agri,2,54,2,0,58,moga
7/15/19,https://www.tribuneindia.com/news/punjab/use-direct-paddy-seeding-to-save-water-suggests-study/802069.html,"‚Äúgoing by the claims of this moga farmer, punjab could save rs 770 crore on powerpower by directly sowing paddy on 28 lakh hectares",agri,2,54,2,0,58,moga
7/14/19,https://www.tribuneindia.com/news/punjab/cases-worth-rs-2-76-cr-settled/801634.html,"tns ropar  seven labourers rescued  paddy crop on 500 acres was affected due to sudden increase of the water level in¬† the sarsa, which flooded fields in aaspur kotan, ranjit pura, manguwal diwari, sarsa nangal, kotbala, majri gujran, batarla, and dahirpur villages on saturday",agri,2,10,5,0,17,"amritsar, barnala, bathinda, faridkot, fatehgarh sahib, fazilka, gurdaspur, hoshiarpur, jalandhar"
7/14/19,https://www.tribuneindia.com/news/punjab/cases-worth-rs-2-76-cr-settled/801634.html,seven farm labourers staying at the tubewell in fields of aaspur kotan were trapped,agri,2,10,5,0,17,"amritsar, barnala, bathinda, faridkot, fatehgarh sahib, fazilka, gurdaspur, hoshiarpur, jalandhar"
2/25/19,https://www.tribuneindia.com/news/punjab/coming-to-rescue-of-alma-mater/734242.html,"ush({ });  gosal, who completed his msc (agriculture) from the pau, ludhiana, before moving to australia in 1996, has donated rs 75 lakh to refurbish the school",agri,5,2,10,2,19,"gurdaspur, ludhiana"
7/28/18,https://www.tribuneindia.com/news/punjab/how-ait-scam-fell-flat-after-a-decade/627817.html,"  this is how the vigilance bureau (vb) had concluded the fresh investigation to give the clean chit to chief minister capt amarinder singh and 17 others in the criminal and corruption case registered on the recommendation of the vidhan sabha, alleging a scam in granting exemption for transferring 32.1 acres of prime land of amritsar improvement trust (ait) to a private developer",agri,1,24,3,4,32,"amritsar, jalandhar, sas nagar"
7/28/18,https://www.tribuneindia.com/news/punjab/how-ait-scam-fell-flat-after-a-decade/627817.html," it calculated the entire costing and earning of veer coloniser and builders private limited, amritsar, in purchasing, developing and selling 32.1 acres of ‚Äòcontroversial‚Äô land exempted from acquisition",agri,1,24,3,4,32,"amritsar, jalandhar, sas nagar"
7/28/18,https://www.tribuneindia.com/news/punjab/how-ait-scam-fell-flat-after-a-decade/627817.html," trashing the charge of causing rs 60-crore loss to the ait through the development of veer enclave, the vb observed that the private developer not only benefitted the farmers, whose land it purchased at a higher rate than offered by the ait, but also helped the public, whom it sold residential and commercial sites at a lesser price than that offered by ait",agri,1,24,3,4,32,"amritsar, jalandhar, sas nagar"
7/28/18,https://www.tribuneindia.com/news/punjab/how-ait-scam-fell-flat-after-a-decade/627817.html," the vb probe further opined that veer enclave also caused no harm to the adjoining 188 acres, on which the ait had planned a separate development project",agri,1,24,3,4,32,"amritsar, jalandhar, sas nagar"
7/28/18,https://www.tribuneindia.com/news/punjab/how-ait-scam-fell-flat-after-a-decade/627817.html," ‚Äúthis private colony has complied with all internal and external development norms, which could prove no hindrance to the development of adjoining 188 acres by the ait,‚Äù observed the vigilance bureau investigation",agri,1,24,3,4,32,"amritsar, jalandhar, sas nagar"
7/28/18,https://www.tribuneindia.com/news/punjab/how-ait-scam-fell-flat-after-a-decade/627817.html,"as such, the government, considering all pros and cons, had deemed it necessary to exempt an area measuring 32.1 acres out of the total scheme area measuring 188 acres",agri,1,24,3,4,32,"amritsar, jalandhar, sas nagar"
7/22/18,https://www.tribuneindia.com/news/punjab/muktsar-dc-releases-rs-4-lakh-for-draining-out-water-from-fields/624470.html,"archit watts tribune news service muktsar, july 21  after the tribune highlighted the plight of farmers of pakki tibbi village (‚Äòfields inundated, dept awaits funds for water-lifting pumps‚Äô, july 21), muktsar deputy commissioner mk aravind kumar and other senior officials visited the flooded fields and immediately released rs 4 lakh to install more water-lifting pumps",agri,1,22,8,0,31,sri muktsar sahib
5/3/18,https://www.tribuneindia.com/news/punjab/rain-damages-wheat-hits-purchase/583302.html,"kulwinder sandhu tribune news service moga, may 2  thousands of metric tonnes (mt) of wheat lying in the open at grain markets got drenched in the light to moderate rainfall that lashed the district on wednesday",agri,0,37,8,0,45,"moga, sri muktsar sahib"
5/3/18,https://www.tribuneindia.com/news/punjab/rain-damages-wheat-hits-purchase/583302.html, state marketing board officials said 2 lakh mt of wheat in gunny bags were yet to be lifted from grain markets,agri,0,37,8,0,45,"moga, sri muktsar sahib"
5/3/18,https://www.tribuneindia.com/news/punjab/rain-damages-wheat-hits-purchase/583302.html,"‚Äúthe expected arrival of wheat in moga district is 9.23 lakh mt,‚Äù claimed jaswinder singh brar, an agro-scientist",agri,0,37,8,0,45,"moga, sri muktsar sahib"
5/3/18,https://www.tribuneindia.com/news/punjab/rain-damages-wheat-hits-purchase/583302.html,"ush({ });  district magistrate dilraj singh sandhawalia claimed that 7,19,054 mt of wheat had been procured by agencies out of the total of 7,19,187 mt arrived in the grain markets till tuesday evening",agri,0,37,8,0,45,"moga, sri muktsar sahib"
5/3/18,https://www.tribuneindia.com/news/punjab/rain-damages-wheat-hits-purchase/583302.html, he added that 91.54 per cent of the total payment for the purchased wheat had been released to farmers,agri,0,37,8,0,45,"moga, sri muktsar sahib"
5/3/18,https://www.tribuneindia.com/news/punjab/rain-damages-wheat-hits-purchase/583302.html,"he claimed that since 99.9 per cent of wheat brought to the moga grain markets till tuesday evening was purchased by the government agencies, farmers need not worry about the inclement weather",agri,0,37,8,0,45,"moga, sri muktsar sahib"
5/3/18,https://www.tribuneindia.com/news/punjab/rain-damages-wheat-hits-purchase/583302.html,"‚Äúwheat grains have the tendency to lose the humidity content quickly in bright sunshine,‚Äù said brar",agri,0,37,8,0,45,"moga, sri muktsar sahib"
11/27/17,https://www.tribuneindia.com/news/punjab/left-in-lurch-they-pine-for-bijli-paani/504049.html," rattan singh, a farmer union leader, says: ‚Äúwe have to gherao the subdivisional offices of the pspcl to get eight-hour of supply for tubewells every year",agri,28,11,66,4,109,"amritsar, fazilka, ferozepur, gurdaspur, tarn taran"
8/3/17,https://www.tribuneindia.com/news/punjab/canal-breach-in-fazilka-fields-flooded/446349.html,"our correspondent  fazilka, august 2 over 50 acres of paddy and cotton fields have been inundated following a 40-ft-wide breach in the alamshah minor canal near penchanwali village on the outskirts of this town last night",agri,4,12,6,0,22,fazilka
7/27/17,https://www.tribuneindia.com/news/punjab/stubble-burning-s-too-stubborn-even-for-a-million-dollars/442924.html," the question agitating experts and farmers is: can there be a one-point solution to the problem, which has at least three points of focus ‚Äî the harvest, processing of the straw, and the sowing of the subsequent crop? given the spread of challenges and the experience thus far, it will require a rather large dose of luck for someone to win that $1 million, however well-intentioned the initiative",agri,0,64,2,7,73,"amritsar, bathinda, gurdaspur, jalandhar, ludhiana"
7/27/17,https://www.tribuneindia.com/news/punjab/stubble-burning-s-too-stubborn-even-for-a-million-dollars/442924.html, progressive farmer kamaldeep singh of sultanpur lodhi says the high cost of a baler (rs 10-12 lakh) ‚Äî used to make bundles of straw ‚Äî is crippling,agri,0,64,2,7,73,"amritsar, bathinda, gurdaspur, jalandhar, ludhiana"
7/27/17,https://www.tribuneindia.com/news/punjab/stubble-burning-s-too-stubborn-even-for-a-million-dollars/442924.html,"he added this initiative would give farmers an extra rs 3,000-4,000 per acre",agri,0,64,2,7,73,"amritsar, bathinda, gurdaspur, jalandhar, ludhiana"
7/12/17,https://www.tribuneindia.com/news/punjab/flooded-drain-ruins-crops-relief-sought/435303.html,"nikhila pant dhawan tribune news service bathinda, july 11  the overflowing lower lasara drain has damaged crops in 450 acres in jethuke and kararwala villages of this district",agri,2,47,27,2,78,"barnala, bathinda, mansa"
7/12/17,https://www.tribuneindia.com/news/punjab/flooded-drain-ruins-crops-relief-sought/435303.html," farmers of the two villages claimed that their paddy, cotton, vegetables and fodder crops had been damaged as the water from the overflowing drain had inundated their fields and caused losses to them",agri,2,47,27,2,78,"barnala, bathinda, mansa"
7/12/17,https://www.tribuneindia.com/news/punjab/flooded-drain-ruins-crops-relief-sought/435303.html,"they demanded a compensation of rs 40,000 per acre",agri,2,47,27,2,78,"barnala, bathinda, mansa"
7/1/17,https://www.tribuneindia.com/news/punjab/farmers-urge-govt-to-remove-hyacinth/429961.html,"raj sadosh  abohar, june 30 as weather experts predicted mild showers and thunderstorms till july 4 in sriganganagar and abohar, farmers fear breaches in sub-canals that had been flooded with hyacinth flowing from the harike barrage",agri,0,17,2,0,19,"amritsar, ferozepur, sas nagar"
7/1/17,https://www.tribuneindia.com/news/punjab/farmers-urge-govt-to-remove-hyacinth/429961.html, farmers in arayan village informed water users forum chairman baljinder singh pannu that hyacinth had accumulated at a dilapidated bridge near 3rd (burji) in f minor (sub canal) emanating from the gang canal and a breach was feared,agri,0,17,2,0,19,"amritsar, ferozepur, sas nagar"
6/19/17,https://www.tribuneindia.com/news/punjab/canal-breach-leaves-cotton-fields-flooded/424382.html, villagers said the cotton crop on about hundred acres of land got submerged,agri,3,8,5,0,16,sas nagar
8/29/16,https://www.tribuneindia.com/news/community/canal-breach-leaves-fields-flooded-in-fazilka-abohar/286941.html,"tribune reporters fazilka/abohar, august 28  the badha minor canal suffered a 20-25 feet breach here today and inundated paddy crop in five acres of land, a government school and water works building in badha village on the outskirts of fazilka town",agri,8,13,13,0,34,"fazilka, sas nagar"
8/29/16,https://www.tribuneindia.com/news/community/canal-breach-leaves-fields-flooded-in-fazilka-abohar/286941.html," cotton crop on over 30 acres of land, besides some kinnow orchards, were submerged due to a breach in the daulatpura minor canal that was noticed at 8 am today",agri,8,13,13,0,34,"fazilka, sas nagar"
6/28/16,https://www.tribuneindia.com/news/community/water-mgmt-key-to-tackling-climate-change-says-expert/258028.html,"new delhi, june 27 at a time when climate change is set to impact rice production in asia, simple water management by farmers as an adaptation strategy will minimise the damage, an expert said",agri,0,25,6,1,32,punjab
6/28/16,https://www.tribuneindia.com/news/community/water-mgmt-key-to-tackling-climate-change-says-expert/258028.html,"it is estimated that up to 20 per cent of the anthropogenic releases of methane to the atmosphere are generated in agriculture, largely by livestock and in rice production,‚Äù he said",agri,0,25,6,1,32,punjab
6/27/16,https://www.tribuneindia.com/news/community/breach-in-fazilka-canal-floods-fields/257611.html,"agricultural plots spread over 50 acres were flooded due to a 65-foot-wide breach in a canal at theh kalandar village in fazilka district  farmers of the village said besides agricultural fields, the focal point of the village and a part of the state highway had been flooded due to the breach  the wild growth of water hyacinth has been choking a narrow bridge over the canal and causing breaches  ss dhaliwal, executive engineer, (irrigation), ferozepur division, said no damage had been caused to the standing crops and the breach was being plugged",agri,0,17,5,0,22,"fazilka, ferozepur"
11/10/15,https://www.tribuneindia.com/news/community/grow-recommended-wheat-varieties-state-farmers-told/156746.html,"ludhiana, november 9 with wheat sowing at its peak in the state, punjab agricultural university (pau) today advised farmers to opt for recommended variety of seeds of the cereal",agri,0,36,1,0,37,ludhiana
11/10/15,https://www.tribuneindia.com/news/community/grow-recommended-wheat-varieties-state-farmers-told/156746.html,"ns bains, senior plant breeder, pau, exhorted the farmers to go for varietal mosaic and diversify from pre-dominance of hd 2967 variety as diseases like yellow rust and karnal bunt were found in this variety at several fields in punjab in the last season",agri,0,36,1,0,37,ludhiana
11/10/15,https://www.tribuneindia.com/news/community/grow-recommended-wheat-varieties-state-farmers-told/156746.html,"he complimented punjab farmers for their rapid seed replacement as well as varietal replacement, and advised them to adopt new varieties especially pbw 677, hd 3086 and wh 1105 for cultivation under irrigated timely sown conditions",agri,0,36,1,0,37,ludhiana
11/10/15,https://www.tribuneindia.com/news/community/grow-recommended-wheat-varieties-state-farmers-told/156746.html,bain suggested farmers to grow more than one variety to avoid risks associated with monoculture,agri,0,36,1,0,37,ludhiana
11/10/15,https://www.tribuneindia.com/news/community/grow-recommended-wheat-varieties-state-farmers-told/156746.html,"the entire area on which the farmer plans to sow wheat should not be brought under one variety, he said",agri,0,36,1,0,37,ludhiana
10/26/15,https://www.tribuneindia.com/news/community/clouds-drizzle-worry-paddy-growers/150578.html,"tribune news service  moga, october 25 cloudy weather conditions coupled with a light drizzle in most parts of moga and its adjoining districts on sunday have caused concern in the farming community which is busy harvesting the paddy crop these days",agri,0,30,5,0,35,moga
9/29/15,https://www.tribuneindia.com/news/community/60-cotton-crop-lost-punjab-offers-rs-600-cr-relief-package/139217.html,"60% cotton crop lost, punjab offers rs 600-cr relief package",agri,4,61,21,8,94,"bathinda, mansa"
9/29/15,https://www.tribuneindia.com/news/community/60-cotton-crop-lost-punjab-offers-rs-600-cr-relief-package/139217.html,"ruchika m khanna tribune news service chandigarh, september 28  faced with 60 per cent loss to cotton crop in the malwa region, the punjab government has okayed a rs 600-crore compensation package for the affected farmers",agri,4,61,21,8,94,"bathinda, mansa"
9/29/15,https://www.tribuneindia.com/news/community/60-cotton-crop-lost-punjab-offers-rs-600-cr-relief-package/139217.html, the report of a special girdawri ordered by the punjab government shows that 6.75 lakh acres under cotton crop have been affected in a whitefly attack,agri,4,61,21,8,94,"bathinda, mansa"
9/29/15,https://www.tribuneindia.com/news/community/60-cotton-crop-lost-punjab-offers-rs-600-cr-relief-package/139217.html,cotton was sown on 11.25 lakh acres in the malwa region this year,agri,4,61,21,8,94,"bathinda, mansa"
9/29/15,https://www.tribuneindia.com/news/community/60-cotton-crop-lost-punjab-offers-rs-600-cr-relief-package/139217.html,"farmers have ploughed back crop on 11,800 acres because of the pest attack",agri,4,61,21,8,94,"bathinda, mansa"
9/29/15,https://www.tribuneindia.com/news/community/60-cotton-crop-lost-punjab-offers-rs-600-cr-relief-package/139217.html,"with over 15 farmers in the malwa region having committed suicide following crop failure, the ongoing agitation by cotton growers and the opposition parties taking potshots at the government on the issue, the government is fire fighting on all fronts",agri,4,61,21,8,94,"bathinda, mansa"
9/29/15,https://www.tribuneindia.com/news/community/60-cotton-crop-lost-punjab-offers-rs-600-cr-relief-package/139217.html,"ush({ });  though girdawri reports for two tehsils‚Äîgidderbaha and bathinda‚Äîare yet to come, the government has started releasing compensation to farmers to quell the disquiet among those affected",agri,4,61,21,8,94,"bathinda, mansa"
9/29/15,https://www.tribuneindia.com/news/community/60-cotton-crop-lost-punjab-offers-rs-600-cr-relief-package/139217.html," till today, rs 520 crore (rs 8,000 per acre) had been sanctioned for disbursal among affected farmers",agri,4,61,21,8,94,"bathinda, mansa"
9/29/15,https://www.tribuneindia.com/news/community/60-cotton-crop-lost-punjab-offers-rs-600-cr-relief-package/139217.html," ‚Äúwe are also giving relief to farmers whose crop loss is between 26 and 33% (rs 2,000 per acre) from the state government‚Äôs own funds",agri,4,61,21,8,94,"bathinda, mansa"
9/29/15,https://www.tribuneindia.com/news/community/60-cotton-crop-lost-punjab-offers-rs-600-cr-relief-package/139217.html,"though the centre gives a compensation of rs 5,400 per acre under the disaster relief fund (for damage between 33-75%), punjab is giving additional rs 2,600 per acre as aid from its own kitty, in case the crop loss is between 76 and 100%",agri,4,61,21,8,94,"bathinda, mansa"
9/29/15,https://www.tribuneindia.com/news/community/60-cotton-crop-lost-punjab-offers-rs-600-cr-relief-package/139217.html,"this aims at ensuring that farmers who have suffered over 75% loss get rs 8,000 an acre as compensation,‚Äù said a senior officer",agri,4,61,21,8,94,"bathinda, mansa"
9/10/15,https://www.tribuneindia.com/news/community/canal-breach-150-acres-flooded/131108.html,canal breach: 150 acres flooded,agri,2,8,6,0,16,"bathinda, mansa"
9/10/15,https://www.tribuneindia.com/news/community/canal-breach-150-acres-flooded/131108.html,"bathinda, september 9 over 150 acres were submerged at chukerian village  of mansa district after musa canal breached its banks today",agri,2,8,6,0,16,"bathinda, mansa"
9/10/15,https://www.tribuneindia.com/news/community/canal-breach-150-acres-flooded/131108.html,"varinder goyal, executive engineer, irrigation, mansa, said, ‚Äúaround 40 acres have been submerged",agri,2,8,6,0,16,"bathinda, mansa"
9/3/15,https://www.tribuneindia.com/news/community/whitefly-eats-up-40-cotton-crop-in-fazilka/128052.html,whitefly eats up 40% cotton crop in fazilka,agri,4,61,33,3,101,"fazilka, sri muktsar sahib"
9/3/15,https://www.tribuneindia.com/news/community/whitefly-eats-up-40-cotton-crop-in-fazilka/128052.html,"praful chander nagpalfazilka, september 2  about 40 per cent of the standing cotton crop has been affected by the whitefly attack in fazilka making it one of the worst-hit districts of the state",agri,4,61,33,3,101,"fazilka, sri muktsar sahib"
9/3/15,https://www.tribuneindia.com/news/community/whitefly-eats-up-40-cotton-crop-in-fazilka/128052.html,"official sources said out of the total 2.5 lakh acres under cotton cultivation, about 99,000 acres have been damaged partially or substantially due to the attack",agri,4,61,33,3,101,"fazilka, sri muktsar sahib"
9/3/15,https://www.tribuneindia.com/news/community/whitefly-eats-up-40-cotton-crop-in-fazilka/128052.html,  farmers ploughed out the completely damaged standing cotton crop in over 700 acres of land in different villages,agri,4,61,33,3,101,"fazilka, sri muktsar sahib"
9/3/15,https://www.tribuneindia.com/news/community/whitefly-eats-up-40-cotton-crop-in-fazilka/128052.html,"  deputy commissioner, fazilka, ravinder singh, said revenue officials had conducted a special girdawri of 700 acres of ploughed fields for providing compensation to the affected farmers",agri,4,61,33,3,101,"fazilka, sri muktsar sahib"
9/3/15,https://www.tribuneindia.com/news/community/whitefly-eats-up-40-cotton-crop-in-fazilka/128052.html,"‚Äúin the first phase, the temporary girdawri to assess damage on the standing crop will be conducted from september 7 to 25, followed by the final assessment of loss,‚Äù he said",agri,4,61,33,3,101,"fazilka, sri muktsar sahib"
9/3/15,https://www.tribuneindia.com/news/community/whitefly-eats-up-40-cotton-crop-in-fazilka/128052.html,"  rahuvir singh of mahuana bodla village said, ‚Äúthe standing cotton crop in my entire 3 acres of land has been completely damaged due to the whitefly attack",agri,4,61,33,3,101,"fazilka, sri muktsar sahib"
9/3/15,https://www.tribuneindia.com/news/community/whitefly-eats-up-40-cotton-crop-in-fazilka/128052.html,"i spent rs 8,000 per acre on seed and pesticides and labour but it could not be saved",agri,4,61,33,3,101,"fazilka, sri muktsar sahib"
9/3/15,https://www.tribuneindia.com/news/community/whitefly-eats-up-40-cotton-crop-in-fazilka/128052.html,  the cotton crop in the district has suffered 30 to 35 per cent damage due to the whitefly attack,agri,4,61,33,3,101,"fazilka, sri muktsar sahib"
8/12/15,https://www.tribuneindia.com/news/community/house-gets-flooded-ex-dig-sits-on-dharna/118756.html,he further alleged crops on 5 acres got damaged,agri,3,14,11,0,28,punjab
8/12/15,https://www.tribuneindia.com/news/community/bbmb-releases-more-water-villages-flooded/118751.html,"agriculture department block officer avtar singh said crops on 5,000 acres were submerged",agri,0,6,9,0,15,punjab
8/11/15,https://www.tribuneindia.com/news/community/fields-in-20-villages-flooded/118314.html,"crops on around 11,000 acres were damaged",agri,2,14,16,1,33,tarn taran
8/5/15,https://www.tribuneindia.com/news/community/rain-fury-12-buildings-collapse/115687.html," sutlej in spate, 200 acres submerged  (adsbygoogle = window",agri,1,12,14,0,27,"fazilka, sas nagar"
8/5/15,https://www.tribuneindia.com/news/community/rain-fury-12-buildings-collapse/115687.html,ush({ });fazilka:standing crop on 200 acres was submerged in villages along the sutlej that was in spate in the district,agri,1,12,14,0,27,"fazilka, sas nagar"
8/5/15,https://www.tribuneindia.com/news/community/rain-fury-12-buildings-collapse/115687.html,the standing crops of paddy and moong on 160 acres in mohar jamsher village and 60 to 70 acres in border village sadda singh have been flooded,agri,1,12,14,0,27,"fazilka, sas nagar"
8/3/15,https://www.tribuneindia.com/news/community/beas-overflows-fields-in-tarn-taran-flooded/114861.html,"tarn taran, august 2  farmers of 10 villages in the mand area near the beas are worried as crops on 10,000 acres have been flooded due to the rising water level in the beas",agri,2,20,9,0,31,tarn taran
7/19/15,https://www.tribuneindia.com/news/punjab/400-houses-flooded-crop-submerged/108481.html,"400 houses flooded, crop submerged",agri,6,11,17,0,34,"amritsar, tarn taran"
7/19/15,https://www.tribuneindia.com/news/punjab/400-houses-flooded-crop-submerged/108481.html,"our correspondent tarn taran, july 18  due to faulty drainage system, over 400 houses have been flooded while crops on more than 2,000 acres have been submerged in chabal township, 16 km from here, due to last night‚Äôs heavy rain",agri,6,11,17,0,34,"amritsar, tarn taran"
7/15/15,https://www.tribuneindia.com/news/community/irrigation-minister-blames-dept-poor-forecast/106823.html," on the jhambo drain that flooded over 2,000 acres of paddy and vegetable fields in patran and nearby areas, the minister said that he would sanction funds for urgent repair work",agri,2,19,5,0,26,"fatehgarh sahib, patiala"
7/15/15,https://www.tribuneindia.com/news/community/irrigation-minister-blames-dept-poor-forecast/106823.html," however, when asked why no work was done earlier and affected farmers had alleged that corruption had led to poor cleaning work, the minister replied, ‚Äúi would look into it and seek a report,‚Äù he said",agri,2,19,5,0,26,"fatehgarh sahib, patiala"
7/14/15,https://www.tribuneindia.com/news/community/sirhind-choe-overflows-fields-in-100-villages-flooded/106407.html,"tribune news service fatehgarh sahib, july 13  thousands of acres of agricultural land in around 100 villages in the district were submerged as the sirhind choe overflowed in view of the heavy rain in the region",agri,7,46,30,0,83,"fatehgarh sahib, pathankot, patiala, sas nagar"
7/14/15,https://www.tribuneindia.com/news/community/sirhind-choe-overflows-fields-in-100-villages-flooded/106407.html," crops on 2,000 acres damaged  patiala: crops, including paddy and vegetables, on nearly 2,000 acres in various parts of the district were damaged in heavy rain in the last two days",agri,7,46,30,0,83,"fatehgarh sahib, pathankot, patiala, sas nagar"
7/14/15,https://www.tribuneindia.com/news/community/sirhind-choe-overflows-fields-in-100-villages-flooded/106407.html," in patran, hundreds of acres were submerged when the jhambo drain overflowed",agri,7,46,30,0,83,"fatehgarh sahib, pathankot, patiala, sas nagar"
7/14/15,https://www.tribuneindia.com/news/community/sirhind-choe-overflows-fields-in-100-villages-flooded/106407.html,farmers reported losses in nearly 12 villages in samana,agri,7,46,30,0,83,"fatehgarh sahib, pathankot, patiala, sas nagar"
7/6/15,https://www.tribuneindia.com/news/community/breach-in-canal-100-acres-flooded/102942.html,"breach in canal, 100 acres flooded",agri,5,11,10,0,26,punjab
7/6/15,https://www.tribuneindia.com/news/community/breach-in-canal-100-acres-flooded/102942.html,nearly 100 acres of agricultural land were inundated,agri,5,11,10,0,26,punjab
6/23/15,https://www.tribuneindia.com/news/community/breach-in-canal-100-acres-submerged/97302.html,"breach in canal, 100 acres submerged",agri,2,16,18,0,36,bathinda
6/23/15,https://www.tribuneindia.com/news/community/breach-in-canal-100-acres-submerged/97302.html,"tribune news service bathinda, june 22  over 100 acres were flooded in gobindpura village here following a breach in the sirhind canal today",agri,2,16,18,0,36,bathinda
6/23/15,https://www.tribuneindia.com/news/community/breach-in-canal-100-acres-submerged/97302.html,ush({ });  boota singh jathedar of gobindpura village said the crop on 65 acres had been completely damaged,agri,2,16,18,0,36,bathinda
6/23/15,https://www.tribuneindia.com/news/community/breach-in-canal-100-acres-submerged/97302.html,"on may 11, a breach near bir talab village caused damage to cotton crops",agri,2,16,18,0,36,bathinda
6/23/15,https://www.tribuneindia.com/news/community/breach-in-canal-100-acres-submerged/97302.html,"on march 9, a breach in the same canal at marhi minor flooded 250 acres in mehraj village of the district.",agri,2,16,18,0,36,bathinda
6/22/15,https://www.tribuneindia.com/news/punjab/breach-in-sirhind-canal-water-enters-fields-houses/97053.html,"tribune news service bathinda, june 22  over 100 acres of land was submerged at gobindpura village in bathinda following a breach in sirhind canal on monday ",agri,4,16,23,0,43,"bathinda, sas nagar"
6/22/15,https://www.tribuneindia.com/news/punjab/breach-in-sirhind-canal-water-enters-fields-houses/97053.html,"¬†  several major breaches had been registered in the past as on may 11, a breach near bir talab village caused damage to newly sown cotton crops and also destroyed the motors and tubewells installed in the fields near the canal",agri,4,16,23,0,43,"bathinda, sas nagar"
6/22/15,https://www.tribuneindia.com/news/punjab/breach-in-sirhind-canal-water-enters-fields-houses/97053.html,"on november 14, several hectares of agricultural land were flooded as the waters of the behman distributary canal breached the embankment.",agri,4,16,23,0,43,"bathinda, sas nagar"
6/17/15,https://www.tribuneindia.com/news/community/canal-breached-90-acres-flooded/94794.html,"canal breached, 90 acres flooded",agri,3,16,8,0,27,pathankot
6/17/15,https://www.tribuneindia.com/news/community/canal-breached-90-acres-flooded/94794.html,"tribune news service  pathankot, june 16 a 40-feet wide breach occurred today in the upper bari doab canal (ubdc) near gulpur simbly village, flooding nearly 90 acres of agricultural land in the area",agri,3,16,8,0,27,pathankot
6/14/15,https://www.tribuneindia.com/news/community/cotton-damaged-due-to-breach-in-canal/93587.html,"tribune news servicetalwandi sabo (bathinda), june 13a 50-feet-wide breach in a canal on the outskirts of talwandi sabo damaged cotton sown in over 10 acres of land this afternoon",agri,5,19,14,0,38,bathinda
6/9/15,https://www.tribuneindia.com/news/community/ruling-mps-on-job-oppn-sulks-over-fund-crunch/91378.html," following the only visit by harsimrat badal in november 2014, the village panchayat had initiated the project on over 2.50 acres of community land in the first phase",agri,5,7,10,0,22,sri muktsar sahib
4/28/15,https://www.tribuneindia.com/news/community/in-muktsar-big-farmers-get-doorstep-service/73119.html,"archit watts tribune news service muktsar, april 27 well-off farmers in the district have started selling their produce from their fields instead of bringing it to the mandis, which is violation of the rules",agri,0,42,1,1,44,sri muktsar sahib
4/28/15,https://www.tribuneindia.com/news/community/in-muktsar-big-farmers-get-doorstep-service/73119.html,"as per official records, 96,611 tonnes of wheat has been purchased in muktsar",agri,0,42,1,1,44,sri muktsar sahib
4/28/15,https://www.tribuneindia.com/news/community/in-muktsar-big-farmers-get-doorstep-service/73119.html,"it means that just 22,452 tonnes of wheat has been lifted so far",agri,0,42,1,1,44,sri muktsar sahib
4/28/15,https://www.tribuneindia.com/news/community/in-muktsar-big-farmers-get-doorstep-service/73119.html,"though it had announced that the farmers would be given money for their produce within 48 hours of its purchase, nothing has happened till date",agri,0,42,1,1,44,sri muktsar sahib
4/24/15,https://www.tribuneindia.com/news/community/mining-mafia-rules-the-roost-in-ropar-district/71502.html," satya devi and bhagwati devi, owners of more than four acres at surewal village, said a contractor from anandpur sahib got contract of quarrying sand from the mines near their village",agri,12,6,14,1,33,sas nagar
2/27/15,https://www.tribuneindia.com/news/community/farmers-threaten-to-launch-stir-over-canal-leakage/47312.html,the loss accessed at 250-300 cusecs has deprived hundreds of farmers in the neighbouring sriganganagar district of west rajasthan,agri,0,36,13,0,49,"fazilka, ferozepur, sas nagar"
2/27/15,https://www.tribuneindia.com/news/community/farmers-threaten-to-launch-stir-over-canal-leakage/47312.html," the memorandum, also signed by former punjab agriculture minister chaudhary radha krishan and kamla devi, sarpanch of khuikhera village, said at least 1,000 acres of agriculture land had been affected by waterlogging near the canal",agri,0,36,13,0,49,"fazilka, ferozepur, sas nagar"
2/27/15,https://www.tribuneindia.com/news/community/farmers-threaten-to-launch-stir-over-canal-leakage/47312.html,the land had produced bumper crop when the canal remained closed for a year to take up remodelling work in 2003,agri,0,36,13,0,49,"fazilka, ferozepur, sas nagar"
2/27/15,https://www.tribuneindia.com/news/community/farmers-threaten-to-launch-stir-over-canal-leakage/47312.html,the havoc wrecked by the menace had made hundreds of farmers debt- ridden,agri,0,36,13,0,49,"fazilka, ferozepur, sas nagar"
2/27/15,https://www.tribuneindia.com/news/community/farmers-threaten-to-launch-stir-over-canal-leakage/47312.html,"on the other side, hundreds of farmers in sriganganagar border district were getting 300 cusecs lesser water than the actual discharge from ferozepur headworks",agri,0,36,13,0,49,"fazilka, ferozepur, sas nagar"
11/4/14,https://www.tribuneindia.com/news/punjab/breach-in-canal-floods-250-acres-farmers-demand-compensation/5300.html,"breach in canal floods 250 acres, farmers demand compensation",agri,4,48,21,3,76,mansa
11/4/14,https://www.tribuneindia.com/news/punjab/breach-in-canal-floods-250-acres-farmers-demand-compensation/5300.html,"bharat khanna tribune news service mansa, november 4  two days after a breach in a canal flooded 200 acres of land in two villages here, another breach today inundated 250 acres in kishangarh farvanhin, phaphde bhaike and kera bhaika villages",agri,4,48,21,3,76,mansa
11/4/14,https://www.tribuneindia.com/news/punjab/breach-in-canal-floods-250-acres-farmers-demand-compensation/5300.html," those who had recently sown wheat in their fields have suffered a loss of rs 4,000 per acre",agri,4,48,21,3,76,mansa
11/4/14,https://www.tribuneindia.com/news/punjab/breach-in-canal-floods-250-acres-farmers-demand-compensation/5300.html,"some farmers in kera bhaika village have suffered a loss of rs 50,000 as their paddy crop was submerged",agri,4,48,21,3,76,mansa
11/4/14,https://www.tribuneindia.com/news/punjab/breach-in-canal-floods-250-acres-farmers-demand-compensation/5300.html," on sunday, 200 acres of land in kheeva dyalu and bappiana villages was submerged following a breach in musa and uddat branch near bhikhi",agri,4,48,21,3,76,mansa
11/4/14,https://www.tribuneindia.com/news/punjab/breach-in-canal-floods-250-acres-farmers-demand-compensation/5300.html,"they have lost more than rs 4,000 per acre",agri,4,48,21,3,76,mansa
11/4/14,https://www.tribuneindia.com/news/punjab/breach-in-canal-floods-250-acres-farmers-demand-compensation/5300.html," the government should provide a compensation of rs 5,000 per acre to the affected farmers while those who lost their paddy crop should be given rs 50,000",agri,4,48,21,3,76,mansa
8/23/19,https://www.tribuneindia.com/news/punjab/stuck-between-border-fence-sutlej-farmers-losing-hope/821300.html,"anirudh gupta  ferozepur, august 22  with hostile neighbour (pakistan) on one side and the ravaging sutlej on the other, farmers residing in villages along the india-pakistan border here are seemingly caught between the proverbial ‚Äúdevil and the deep sea‚Äù",agri,5,22,19,2,48,ferozepur
8/23/19,https://www.tribuneindia.com/news/punjab/stuck-between-border-fence-sutlej-farmers-losing-hope/821300.html," ‚Äúalmost every second year, the river water inundates our dwellings,‚Äù mangal singh of chinniwala village said, adding that his fields had been wrecked by the sutlej thrice in the past five years",agri,5,22,19,2,48,ferozepur
6/11/19,https://www.tribuneindia.com/news/punjab/release-of-water-into-pakistan-riles-farmers/786099.html,"anirudh gupta ferozepur, june 10  the discharge of thousands of cusecs of water into pakistan from the hussainiwala headworks has ruffled the farming community ahead of the paddy-sowing season",agri,0,13,4,0,17,"ferozepur, sangrur"
6/11/19,https://www.tribuneindia.com/news/punjab/release-of-water-into-pakistan-riles-farmers/786099.html," as per information, almost 14,000 cusecs water is being released into pakistan from hussainiwala, which the farmers term as total wastage of the natural resource",agri,0,13,4,0,17,"ferozepur, sangrur"
2/25/19,https://www.tribuneindia.com/news/punjab/start-relining-of-canals-before-ls-polls-ngo/734246.html,"if diversion of 7,000 cusecs of water is prevented, it can bring in prosperity to farmers in fazilka, ferozepur in the state and hanumangarh and sriganganagar in rajasthan",agri,1,3,1,0,5,"faridkot, fazilka, ferozepur, sas nagar, sri muktsar sahib"
9/25/18,https://www.tribuneindia.com/news/punjab/sukhna-gates-shut-after-water-recedes-in-himachal-rivers/658592.html,the paddy crop in both states was ready for harvest and procurement is to officially begin on october 1,agri,2,9,6,0,17,sas nagar
7/5/18,https://www.tribuneindia.com/news/punjab/rain-pours-misery-in-malwa-5-dead/615378.html,the state government‚Äôs decision to sow paddy after june 20 has caused losses to farmers in the area,agri,20,27,30,0,77,"patiala, sas nagar, sri muktsar sahib"
5/21/18,https://www.tribuneindia.com/news/punjab/shahkot-public-issues-take-a-backseat-amid-mud-slinging/592362.html,"farmers rue that despite huge damage, no one bothered to assess their loss or given any assurance to them for providing relief",agri,3,19,23,0,45,"jalandhar, ludhiana"
2/20/18,https://www.tribuneindia.com/news/punjab/e-auction-16-of-51-mines-get-bidders/546787.html,the total reserve price for these quarries was rs 9.62 crore,agri,0,4,1,1,6,"amritsar, fazilka, ferozepur, gurdaspur, hoshiarpur, jalandhar, ludhiana, moga, pathankot, sas nagar, sbs nagar, tarn taran"
2/20/18,https://www.tribuneindia.com/news/punjab/e-auction-16-of-51-mines-get-bidders/546787.html,"ush({ });‚Äúhe did not want any other bidder to take the quarry, and thus flooding the market with sand and gravel, which would further reduce the prices of these minor minerals,‚Äù a source in the mining trade told the tribune, adding that the annual extractable quantity of gajju jagir was just 11,000 tonnes",agri,0,4,1,1,6,"amritsar, fazilka, ferozepur, gurdaspur, hoshiarpur, jalandhar, ludhiana, moga, pathankot, sas nagar, sbs nagar, tarn taran"
1/15/18,https://www.tribuneindia.com/news/punjab/encroachments-over-ponds-despite-hc-order/528594.html,information reveals that 125 acres of pond land in abohar sub-division was allegedly encroached upon mostly by political activists having allegiance to sad and bjp during the past decade,agri,3,8,14,0,25,punjab
3/21/17,https://www.tribuneindia.com/news/community/raze-encroachments-on-pond-land-villagers-to-officials/379920.html, information reveals that 125 acres of pond land in abohar sub- division was encroached mostly by political activists during the past decade.,agri,11,10,13,0,34,punjab
3/8/17,https://www.tribuneindia.com/news/community/80-encroachments-on-pond-land-razed/374265.html,"information reveals that 125 acres of pond land in abohar sub division had been encroached, mostly by political activists during the past decade.",agri,3,11,7,0,21,punjab
11/3/16,https://www.tribuneindia.com/news/community/civil-military-meet-security-of-airfields-ammo-depots-taken-up/318078.html, the army has sought allocation of about 23 acres of land in nangal from the state government to meet its administrative requirements,agri,0,16,4,0,20,"amritsar, bathinda, kapurthala, ludhiana, pathankot, sas nagar"
10/3/16,https://www.tribuneindia.com/news/community/ferozepur-villagers-battle-it-out-against-odds/304051.html,"anirudh gupta  along zero line (ferozepur), october 2 having borne the brunt of the 1965 and 1971 wars, besides frequent flooding of their fields by the swollen sutlej, farmers of villages along the border are at the receiving end again",agri,10,16,18,1,45,ferozepur
8/17/16,https://www.tribuneindia.com/news/community/villagers-put-up-anti-govt-posters/281296.html,"ush({ });during an interaction with the mla, villagers said the sad-bjp government had not been able to ensure supply of canal water for irrigation in abohar sub-division, children in government schools have to sweat it out due to 4-5 hour power cut almost every day, potable water was not available and farmers had been in distress due to the unfriendly attitude of the agriculture department etc",agri,6,5,9,0,20,sas nagar
3/26/16,https://www.tribuneindia.com/news/community/punjabi-restaurateur-going-great-guns-in-ghana/213441.html,cheema arrived in the african country in 1974 to join her award-winning farmer-exporter husband harcharan cheema,agri,5,3,4,1,13,punjab
11/26/15,https://www.tribuneindia.com/news/punjab/govt-puts-83-quarries-on-the-block/162979.html," industry minister madan mohan mittal, while conforming that the online auction of the quarries was to be done now said the bidders would compete to obtain business from the state and prices would typically decrease as the sellers undercut each other",agri,0,7,1,0,8,punjab
11/26/15,https://www.tribuneindia.com/news/punjab/govt-puts-83-quarries-on-the-block/162979.html,ush({ });  ‚Äúwe are committed to bring down the price of sand and gravel to rs600-rs650 per hundred cubic feet so as to facilitate the common man,agri,0,7,1,0,8,punjab
11/26/15,https://www.tribuneindia.com/news/punjab/govt-puts-83-quarries-on-the-block/162979.html," as of now, the retail price of sand to a consumer in the state is rs2,000-rs2,700 per 100 cubic feet and that of aggregate (sand and gravel mix) is rs2,200-rs3,100 per 100 cubic feet",agri,0,7,1,0,8,punjab
11/26/15,https://www.tribuneindia.com/news/punjab/govt-puts-83-quarries-on-the-block/162979.html," mittal said the term of auction for another 50 quarries would end in january and they were hopeful of bringing down the bid prices, which in turn would bring down the sand and gravel prices.",agri,0,7,1,0,8,punjab
8/28/15,https://www.tribuneindia.com/news/community/breach-in-ropar-thermal-plant-channel/125408.html,"while the power generation was stopped at one of the units, farmers in the affected villages of ranjitpura, avankot and aaspur said their crops worth lakhs of rupees had been hit due to the leakage of hot water from the channel",agri,0,7,6,2,15,punjab
7/16/15,https://www.tribuneindia.com/news/punjab/haryana-not-letting-us-tame-ghaggar-govt/107290.html,this resulted in crops on over 500 acres in 10 villages from makraurh sahib to karhail getting inundated as ghaggar breached its banks,agri,1,9,5,1,16,"patiala, sangrur, sas nagar"
7/16/15,https://www.tribuneindia.com/news/punjab/haryana-not-letting-us-tame-ghaggar-govt/107290.html, haryana claims it is unable to get its legitimate share of 3.5 million-acre-foot (maf) of ravi-beas water since the sutlej-yamuna link (syl) canal has not been built,agri,1,9,5,1,16,"patiala, sangrur, sas nagar"
7/16/15,https://www.tribuneindia.com/news/punjab/haryana-not-letting-us-tame-ghaggar-govt/107290.html,"  ‚Äúthe government needs to take concrete measures to resolve the matter as more and more water has been flowing into our fields for the past two days,‚Äù said moonak farmer harmandeep singh",agri,1,9,5,1,16,"patiala, sangrur, sas nagar"
5/28/15,https://www.tribuneindia.com/news/community/mps-allocate-funds-but-fail-to-lobby-for-state-s-interests/86280.html,"  anandpur sahib ps chandumajra (sad)  questions asked: 113  mplad funds utilised: rs 4.5 crore attendance: 91% initiatives taken  anandpur sahib-amritsar train service started nfl expansion defence clearance for mohali international airport mohali drain construction started banga-anandpur sahib via garhshankar declared¬†national highway¬†  unkept promises  no protection to crops from wild animals¬† drinking water, irrigation facilities lacking in kandi areas bbmb workshop promising jobs to local youth yet to come up modern timber, cattle markets not materialised four-laning of kharar-kurali road pending   prem singh chandumajra is a seasoned politician",agri,15,16,13,2,46,"amritsar, bathinda, faridkot, ferozepur, hoshiarpur, jalandhar, ludhiana, moga, patiala, sas nagar"
5/22/15,https://www.tribuneindia.com/news/punjab/entry-tax-fallout-sugar-prices-up-by-rs-2-per-kg/83797.html,entry tax fallout: sugar prices up by rs 2 per kg,agri,0,17,2,3,22,punjab
5/22/15,https://www.tribuneindia.com/news/punjab/entry-tax-fallout-sugar-prices-up-by-rs-2-per-kg/83797.html,"khanna tribune news service chandigarh, may 21  the price of sugar in the state has gone up by rs 200 per quintal, or rs 2 per kg, following the decision of the cabinet to impose 11 per cent tax on sugar coming into punjab from other states",agri,0,17,2,3,22,punjab
5/22/15,https://www.tribuneindia.com/news/punjab/entry-tax-fallout-sugar-prices-up-by-rs-2-per-kg/83797.html,"the price of sugar (price at factories) in various parts of the state increased from rs 2,710-rs 2,740 per quintal till yesterday, to rs 2,910-rs 2,940 per quintal",agri,0,17,2,3,22,punjab
5/22/15,https://www.tribuneindia.com/news/punjab/entry-tax-fallout-sugar-prices-up-by-rs-2-per-kg/83797.html,"in the retail market, the prices of sugar too saw a jump of rs 2 per kg, with prices going up to rs 30-rs 34 per kg, in various cities across the state",agri,0,17,2,3,22,punjab
5/22/15,https://www.tribuneindia.com/news/punjab/entry-tax-fallout-sugar-prices-up-by-rs-2-per-kg/83797.html,"these sugar mills are running in huge losses and have unpaid dues amounting to almost rs 700 crore, after punjab increased its state advised price (sap) on cane to rs 295 per quintal for the recently concluded cane crushing season",agri,0,17,2,3,22,punjab
5/22/15,https://www.tribuneindia.com/news/punjab/entry-tax-fallout-sugar-prices-up-by-rs-2-per-kg/83797.html,"against this, the price of sugar in the open market was just rs 2,800 per quintal",agri,0,17,2,3,22,punjab
5/22/15,https://www.tribuneindia.com/news/punjab/entry-tax-fallout-sugar-prices-up-by-rs-2-per-kg/83797.html,"as a result, the cost of production of sugar in up is around rs 2,800 per quintal, as they were paying farmers just rs 240 per quintal for sugarcane",agri,0,17,2,3,22,punjab
11/1/19,https://www.tribuneindia.com/news/punjab/delay-in-sowing-fuelled-farm-fires-harvard-study/854596.html,it indicates that the burning of rice residue has shifted later by over two weeks from 2003-2016,agri,0,28,1,0,29,punjab
11/1/19,https://www.tribuneindia.com/news/punjab/delay-in-sowing-fuelled-farm-fires-harvard-study/854596.html," besides, the timing of peak crop residue burning may increasingly coincide with winter meteorology that favours severe smog events downwind across the indo-gangetic plains, where the study diagnoses a 50 per cent increase in aerosol optical depth (a measure of the extinction of the solar beam by dust and haze) exceedances between 2003 and 2016",agri,0,28,1,0,29,punjab
10/1/19,https://www.tribuneindia.com/news/punjab/heavy-sept-rains-set-to-delay-paddy-harvest/840629.html,"with north eastern and southern part of the state receiving higher than normal rainfall in the past week and an overcast sky being predicted for another two-three days, farmers are at their wits‚Äô end",agri,0,33,1,0,34,punjab
10/1/19,https://www.tribuneindia.com/news/punjab/heavy-sept-rains-set-to-delay-paddy-harvest/840629.html," dr js mahal, director, extension, punjab agricultural university (pau), said they had issued advisories to farmers to delay harvesting in the wake of high rainfall on september 27 and 28",agri,0,33,1,0,34,punjab
9/21/19,https://www.tribuneindia.com/news/punjab/storage-in-dams-better-than-10-yr-average/835580.html,"vijay mohan tribune news service chandigarh, september 20  the available storage in crucial reservoirs in the northern region towards the fag end of the monsoon season this year is noticeably above normal, which augurs well not only for the agricultural sector, but also for provision of drinking water",agri,0,1,1,0,2,punjab
9/2/19,https://www.tribuneindia.com/news/punjab/1-lakh-cattle-on-the-loose-claim-100-lives-a-year-in-punjab/826294.html,"1 lakh cattle on the loose, claim 100 lives a year in punjab",agri,18,26,4,2,50,"patiala, sangrur"
9/2/19,https://www.tribuneindia.com/news/punjab/1-lakh-cattle-on-the-loose-claim-100-lives-a-year-in-punjab/826294.html,"rajmeet singh tribune news service chandigarh, september 1  the state is paying a heavy price as the successive governments have failed to rein in the stray cattle menace",agri,18,26,4,2,50,"patiala, sangrur"
9/2/19,https://www.tribuneindia.com/news/punjab/1-lakh-cattle-on-the-loose-claim-100-lives-a-year-in-punjab/826294.html,"as per an estimate, nearly 1.1 lakh stray cattle are roaming freely on the roads in the state",agri,18,26,4,2,50,"patiala, sangrur"
9/2/19,https://www.tribuneindia.com/news/punjab/1-lakh-cattle-on-the-loose-claim-100-lives-a-year-in-punjab/826294.html,but the population of stray cattle on roads has touched nearly 1.1 lakh,agri,18,26,4,2,50,"patiala, sangrur"
9/2/19,https://www.tribuneindia.com/news/punjab/1-lakh-cattle-on-the-loose-claim-100-lives-a-year-in-punjab/826294.html,"of this, only rs 25 crore had been distributed for feeding cattle till july",agri,18,26,4,2,50,"patiala, sangrur"
9/2/19,https://www.tribuneindia.com/news/punjab/1-lakh-cattle-on-the-loose-claim-100-lives-a-year-in-punjab/826294.html,"4 killed in patiala, 8 in sangrur last month  in patiala, four people have died in the past one month in stray cattle-related incidents",agri,18,26,4,2,50,"patiala, sangrur"
8/28/19,https://www.tribuneindia.com/news/punjab/illegal-mining-on-panchayat-land-in-moga-admn-denies/823773.html, the top soil from the 5-acre panchayat land was allegedly being sold by the sarpanch and some panchayat members,agri,6,13,9,0,28,moga
8/27/19,https://www.tribuneindia.com/news/punjab/project-to-shift-patiala-dairies-hangs-fire/823240.html," the dairy shifting project, under which the mc was supposed to shift all the existing dairies from the city limits to a 22.44 acre site in ablowal village was passed this year",agri,2,3,7,0,12,patiala
8/13/19,https://www.tribuneindia.com/news/punjab/concern-over-deficit-rainfall-in-fazilka/817062.html,"our correspondent  fazilka, august 12 deficit rainfall has added to the woes of farmers who have already been facing crisis of clean irrigation water and are striving to protect their paddy crop due to scanty rainfall in the district",agri,0,13,3,0,16,"fazilka, kapurthala"
8/13/19,https://www.tribuneindia.com/news/punjab/concern-over-deficit-rainfall-in-fazilka/817062.html, agriculture department sources said basmati and parmal varieties of paddy had been sown in about one lakh hectares in the district,agri,0,13,3,0,16,"fazilka, kapurthala"
8/13/19,https://www.tribuneindia.com/news/punjab/cotton-growers-rent-boom-sprayers-for-pest-control/817060.html,"kulwinder sandhu tribune news service moga, august 12  with the advancement of technology, some progressive farmers in the malwa belt of punjab are using automatic boom sprayer machines to spray pesticides on cotton crop, which is more vulnerable to pest/insect attacks during the monsoon season",agri,1,44,1,6,52,"ludhiana, moga"
8/13/19,https://www.tribuneindia.com/news/punjab/cotton-growers-rent-boom-sprayers-for-pest-control/817060.html,the field capacity of the sprayer is approximately 10 acres per hour,agri,1,44,1,6,52,"ludhiana, moga"
8/13/19,https://www.tribuneindia.com/news/punjab/cotton-growers-rent-boom-sprayers-for-pest-control/817060.html,"the punjab agricultural university, ludhiana, has also launched three boom sprayers on trial basis during the current cotton season",agri,1,44,1,6,52,"ludhiana, moga"
8/13/19,https://www.tribuneindia.com/news/punjab/cotton-growers-rent-boom-sprayers-for-pest-control/817060.html," he said the farmers are using different types of sprayers ‚Äî both manual and power-operated ‚Äî but, power-operated having nozzles that discharge at least 600 ml of pesticide per minute is best for pest control",agri,1,44,1,6,52,"ludhiana, moga"
8/13/19,https://www.tribuneindia.com/news/punjab/cotton-growers-rent-boom-sprayers-for-pest-control/817060.html,it costs rs 90 per acre as spraying expenses against rs 150 being spent by the farmers with the help of outsourced manual labour,agri,1,44,1,6,52,"ludhiana, moga"
8/13/19,https://www.tribuneindia.com/news/punjab/cotton-growers-rent-boom-sprayers-for-pest-control/817060.html,"save time, labour¬†  boom sprayers save time, labour and cost of operation as well as reduces drudgery of the spraying operation¬† the field capacity of the sprayer is approximately 10 acres per hour it costs  rs 90 per acre as spraying expenses against  rs 150 being spent by farmers with the help of outsourced manual labour  ",agri,1,44,1,6,52,"ludhiana, moga"
8/5/19,https://www.tribuneindia.com/news/punjab/two-bills-to-be-tabled-as-session-resumes-today/812963.html," listed on the scheduled are call attention notices by aap mlas kultar singh sandwan, kulwant singh pandori and aman arora on underweight and substandard supply of wheat under atta-dal scheme and delay in completion of works by the local government department",agri,0,4,1,0,5,punjab
8/2/19,https://www.tribuneindia.com/news/punjab/punjab-assembly-adjourned-within-minutes-on-day-1/811894.html,  kultar singh of aap demanded the names of the 90 farmers‚Äî who had committed suicide between the budget session held in february and the ongoing monsoon session‚Äîto be included while giving obituaries on the first day of the session,agri,2,3,2,0,7,sangrur
8/1/19,https://www.tribuneindia.com/news/punjab/monsoon-session-of-punjab-assembly-set-to-start-on-stormy-note/811338.html,"chandigarh, august 1 the monsoon session of punjab assembly beginning from friday is likely to witness fireworks with opposition parties gearing up to launch an offensive against the ruling congress over a host of issues, including cbi's closure report on sacrilege incidents, unemployment, hike in power tariff and farmers' plight",agri,2,8,4,0,14,"amritsar, ferozepur"
7/24/19,https://www.tribuneindia.com/news/punjab/monsoon-session-likely-from-aug-2/806759.html," the cabinet is also taking up the issue of reducing the minimum land requirement for private universities from existing 35 acres to 25 acres, by bringing an amendment to the punjab private university policy",agri,0,10,3,0,13,punjab
7/24/19,https://www.tribuneindia.com/news/punjab/monsoon-session-likely-from-aug-2/806759.html,"ush({ }); cabinet meet today¬†  to enable uninterrupted water supply to nearly 20 lakh rural households, the cabinet will take up an agenda item of the water supply and sanitation department to allow the government to pay dues of rural water supply schemes¬† the cabinet will also take up the issue of reducing minimum land requir-ement for private univer-sities from the existing¬†35 acres to 25 acres ",agri,0,10,3,0,13,punjab
7/19/19,https://www.tribuneindia.com/news/punjab/post-rain-vegetable-prices-go-north-in-punjab-haryana/804608.html,"chandigarh, july 19 prices of vegetables such as tomato, peas and beans have surged sharply over the last one week in haryana, punjab and chandigarh owing to supply crunch caused by heavy rain in the region",agri,0,16,2,0,18,punjab
7/19/19,https://www.tribuneindia.com/news/punjab/post-rain-vegetable-prices-go-north-in-punjab-haryana/804608.html,"retail price of tomato has almost doubled from rs 30-40 per kg to rs 60-70 per kg, while that of peas have risen sharply to rs 100 per kg from nearly rs 70 per kg earlier, traders said on friday",agri,0,16,2,0,18,punjab
7/19/19,https://www.tribuneindia.com/news/punjab/post-rain-vegetable-prices-go-north-in-punjab-haryana/804608.html,"cauliflower was selling at around rs 60-80 per kg from rs 50 per kg earlier, price of beans has jumped to rs 70-80 per kg from rs 50 per kg",agri,0,16,2,0,18,punjab
7/19/19,https://www.tribuneindia.com/news/punjab/post-rain-vegetable-prices-go-north-in-punjab-haryana/804608.html,potato prices of 'pahari' variety have risen to rs 30 per kg from rs 20 per kg,agri,0,16,2,0,18,punjab
7/19/19,https://www.tribuneindia.com/news/punjab/post-rain-vegetable-prices-go-north-in-punjab-haryana/804608.html,"ush({ }); bitter gourd was selling in the range of rs 50-60 per kg as against rs 40 per kg earlier, carrot prices have gone up from rs 40 per kg to rs 60 per kg, while cucumber prices have risen from rs 20-30 per kg to rs 40-50 per kg",agri,0,16,2,0,18,punjab
7/19/19,https://www.tribuneindia.com/news/punjab/post-rain-vegetable-prices-go-north-in-punjab-haryana/804608.html,lemon prices have also increased to rs 30-40 for 250 grams from rs 20-25 for the same weight earlier,agri,0,16,2,0,18,punjab
7/19/19,https://www.tribuneindia.com/news/punjab/post-rain-vegetable-prices-go-north-in-punjab-haryana/804608.html,"  ¬†bottle gourd prices have jumped from rs 30 per kg to rs 60 per kg, while okra was selling at rs 60 per kg as against rs 40 per kg earlier",agri,0,16,2,0,18,punjab
7/19/19,https://www.tribuneindia.com/news/punjab/post-rain-vegetable-prices-go-north-in-punjab-haryana/804608.html,"coriander prices have also doubled from rs 20 per 100 gram earlier to rs 40 for the same weight, while prices of chillies too have gone up, traders said",agri,0,16,2,0,18,punjab
7/19/19,https://www.tribuneindia.com/news/punjab/post-rain-vegetable-prices-go-north-in-punjab-haryana/804608.html,"however, prices of onion have remained stable at around rs 25 per kg, they said",agri,0,16,2,0,18,punjab
7/17/19,https://www.tribuneindia.com/news/punjab/gushing-ghaggar-floods-patiala-villages/803050.html,it inundated freshly sown paddy on hundreds of acres in many villages,agri,12,10,36,0,58,patiala
7/17/19,https://www.tribuneindia.com/news/punjab/gushing-ghaggar-floods-patiala-villages/803050.html,"now public as well as private property and paddy on hundreds of acres is getting affected,‚Äù said mukhtiar singh of maru village",agri,12,10,36,0,58,patiala
7/15/19,https://www.tribuneindia.com/news/punjab/in-ropar-illegal-mining-takes-toll-on-groundwater/802078.html,"though water was found at 5 to 8 feet in villages on the river banks, now farmers are digging up new borewells up to a depth of more than 40 feet",agri,2,18,10,0,30,punjab
7/15/19,https://www.tribuneindia.com/news/punjab/in-ropar-illegal-mining-takes-toll-on-groundwater/802078.html,"he said things moved smoothly till a decade ago, when the mining activity increased in the adjoining sutlej and the water table started depleting gradually and it touched to 30 feet a few years ago, forcing a majority of farmers to dig up new borewells",agri,2,18,10,0,30,punjab
7/15/19,https://www.tribuneindia.com/news/punjab/in-ropar-illegal-mining-takes-toll-on-groundwater/802078.html," gurbachan singh of bhanua village near the khera kalmot mining area said almost every farmer in their village had to dug up a new borewell as the water level went down to more than 25 feet, which used to be 15 feet, and just 7 to 8 feet during monsoon",agri,2,18,10,0,30,punjab
7/15/19,https://www.tribuneindia.com/news/punjab/in-ropar-illegal-mining-takes-toll-on-groundwater/802078.html,"geologist jaswant singh said though no survey was conducted in this regard, farmers could be believed as earlier the riverbed was dug up to 10 feet and groundwater recharged through it used to maintain high levels in adjoining villages",agri,2,18,10,0,30,punjab
6/27/19,https://www.tribuneindia.com/news/punjab/farmers-in-doaba-unsure-of-sowing-water-guzzling-paddy/793506.html,"kanksha n bhardwaj tribune news service jalandhar, june 26  the depleting groundwater is making farmers wary of sowing water-guzzling paddy",agri,1,68,7,1,77,"jalandhar, kapurthala, sbs nagar"
6/27/19,https://www.tribuneindia.com/news/punjab/farmers-in-doaba-unsure-of-sowing-water-guzzling-paddy/793506.html, farmers say a 12-hp motor pumps out water just sufficient for four to five acres,agri,1,68,7,1,77,"jalandhar, kapurthala, sbs nagar"
6/27/19,https://www.tribuneindia.com/news/punjab/farmers-in-doaba-unsure-of-sowing-water-guzzling-paddy/793506.html,"ush({ });  satnam singh sahni, a farmer from kapurthala district, said he had sown paddy over 10 acres, out of which 4 acres were damaged because of excessive heat",agri,1,68,7,1,77,"jalandhar, kapurthala, sbs nagar"
6/27/19,https://www.tribuneindia.com/news/punjab/farmers-in-doaba-unsure-of-sowing-water-guzzling-paddy/793506.html," bharatiya kisan union (kadian) president jasbir singh, who has sown paddy over 25 acres, said the process of sowing of paddy had slowed down because of depleting groundwater",agri,1,68,7,1,77,"jalandhar, kapurthala, sbs nagar"
6/27/19,https://www.tribuneindia.com/news/punjab/farmers-in-doaba-unsure-of-sowing-water-guzzling-paddy/793506.html, ‚Äúfarmers get electricity for five to six hours out of promised eight hours,agri,1,68,7,1,77,"jalandhar, kapurthala, sbs nagar"
6/13/19,https://www.tribuneindia.com/news/punjab/tanda-villagers-to-get-road-after-rains/787098.html,"the process for acquisition of 1.3 acres of land required for the road will also be started immediately, added the deputy commissioner.",agri,11,4,11,0,26,punjab
6/11/19,https://www.tribuneindia.com/news/punjab/sluggish-monsoon-may-spell-trouble-for-farm-sector/786365.html,"new delhi, june 11  southwest monsoon this year has become a thing of concern for policymakers as it has not just been delayed by a week, but it is also likely to be sluggish and erratic, which may spell trouble for the farm sector",agri,1,24,2,0,27,punjab
6/11/19,https://www.tribuneindia.com/news/punjab/sluggish-monsoon-may-spell-trouble-for-farm-sector/786365.html, farmers have been advised by private weather forecaster skymet to postpone sowing by almost a week of the conventional dates as it said there are less chances of rains if the onset of the monsoon is delayed,agri,1,24,2,0,27,punjab
6/8/19,https://www.tribuneindia.com/news/punjab/villagers-claim-crop-damage-by-swelling-sutlej-admn-denies/784817.html,"tribune news service  sanghera (moga), june 7 though the district administration has claimed that there is no loss to crops and properties in villages, people of sanghera and its adjoining villages have alleged that their fields and houses located inside the dhusi bundh has been inundated",agri,13,19,30,0,62,moga
6/8/19,https://www.tribuneindia.com/news/punjab/villagers-claim-crop-damage-by-swelling-sutlej-admn-denies/784817.html,"sanghera village sarpanch balkar singh along with other residents claimed that paddy nurseries, fodder and mint crops on more than 750 acres had been damaged in six villages",agri,13,19,30,0,62,moga
2/16/19,https://www.tribuneindia.com/news/punjab/work-on-bridge-for-island-villages-to-begin-today/729611.html,"in the monsoon season, when the bridge is removed for three months for safety reasons, a single boat remains the lifeline of the residents of 16 villages spread in an area of 25,000 acre",agri,5,8,13,1,27,jalandhar
11/13/18,https://www.tribuneindia.com/news/punjab/no-system-to-regulate-quality-of-cattle-feed/682181.html,"tribune news service chandigarh, november 12  even as it has been scientifically proved that milk is getting contaminated due to pesticide-laden feed given to cattle, the state does not have any mechanism to regulate the quality of animal feed",agri,1,12,2,0,15,ludhiana
11/13/18,https://www.tribuneindia.com/news/punjab/no-system-to-regulate-quality-of-cattle-feed/682181.html," in august, the state cabinet had passed the punjab regulation of compounded cattle feed, concentrates & mineral mixtures act, 2018, but it was not introduced in the vidhan sabha‚Äôs monsoon session",agri,1,12,2,0,15,ludhiana
11/13/18,https://www.tribuneindia.com/news/punjab/no-system-to-regulate-quality-of-cattle-feed/682181.html," besides small village-level cattle feed mixing units, there are around 700 industrial units in the state",agri,1,12,2,0,15,ludhiana
11/13/18,https://www.tribuneindia.com/news/punjab/no-system-to-regulate-quality-of-cattle-feed/682181.html," earlier, the government had been taking action under the punjab regulation of compounded cattle feed, concentrates & mineral mixtures order, 1988, which was issued under the essential commodities act, 1955",agri,1,12,2,0,15,ludhiana
11/13/18,https://www.tribuneindia.com/news/punjab/no-system-to-regulate-quality-of-cattle-feed/682181.html,"but the union government removed cattle fodder, including oil cakes and other concentrates, from the jurisdiction of the essential commodities act, 1955, by introducing essential commodities (amendment) act, 2006",agri,1,12,2,0,15,ludhiana
11/12/18,https://www.tribuneindia.com/news/punjab/each-year-paddy-farce-only-grows-worse/681459.html,many well-intentioned interventions by the government ended up making it perhaps one of the most difficult kharif seasons for farmers,agri,4,54,3,4,65,punjab
9/26/18,https://www.tribuneindia.com/news/punjab/govt-tells-farmers-to-drain-out-excess-water-from-fields/658871.html,"kulwinder sandhu tribune news service moga, september 25  the state agriculture department has advised farmers to drain out excess water from low-lying areas which got stagnated due to heavy rains in the past few days to prevent damage to cotton, paddy, maize and horticultural crops",agri,2,51,5,0,58,"barnala, bathinda, mansa, moga"
9/26/18,https://www.tribuneindia.com/news/punjab/govt-tells-farmers-to-drain-out-excess-water-from-fields/658871.html,"the farmers who had gone for early planting of paddy may suffer losses but overall, it will be beneficial for those who opted for late planting as per the government‚Äôs schedule",agri,2,51,5,0,58,"barnala, bathinda, mansa, moga"
9/23/18,https://www.tribuneindia.com/news/punjab/monsoon-normal-in-punjab-after-7-years/657428.html,"  the cotton had started arriving in the market in areas such as fazilka and the farmers were upbeat, as their produce was already fetching a price of above rs 5,800 per quintal",agri,4,40,9,0,53,"amritsar, bathinda, fazilka, ferozepur, jalandhar, kapurthala, mansa, moga, patiala, sri muktsar sahib"
9/23/18,https://www.tribuneindia.com/news/punjab/monsoon-normal-in-punjab-after-7-years/657428.html," kamal deep singh, a farmer from jalandhar district, said most of the paddy sown on nearly 1,500 acres had got submerged",agri,4,40,9,0,53,"amritsar, bathinda, fazilka, ferozepur, jalandhar, kapurthala, mansa, moga, patiala, sri muktsar sahib"
9/14/18,https://www.tribuneindia.com/news/punjab/outlet-blocked-village-turns-pond/652677.html,"  the village, surrounded by lush agriculture fields - labelled as highly fertile by pau ‚Äî is at stone‚Äôs throw way from two modern entities ‚Äî the institute of hotel management and beant college of engineering and technology",agri,11,6,20,0,37,"gurdaspur, sas nagar"
9/11/18,https://www.tribuneindia.com/news/punjab/air-you-breathe-in-rarely-satisfactory/650962.html,"aman sood tribune news service patiala, september 10  for poor air quality in the state, farmers usually take the blame for causing it by resorting to stubble-burning",agri,0,8,2,0,10,"amritsar, jalandhar, ludhiana, patiala"
9/11/18,https://www.tribuneindia.com/news/punjab/air-you-breathe-in-rarely-satisfactory/650962.html," charanjit singh, a senior ppcb official, said: ‚Äúusually the reading is above 100 rspm on most days, but goes on to alarming levels when farmers resort to stubble-burning or when we have dust storms",agri,0,8,2,0,10,"amritsar, jalandhar, ludhiana, patiala"
9/11/18,https://www.tribuneindia.com/news/punjab/air-you-breathe-in-rarely-satisfactory/650962.html," in october and november last year, the air quality had turned ‚Äúvery poor‚Äù following farm fires and bursting of crackers, with the rspm reaching around 340 ¬µg/m¬≥, causing smoggy conditions",agri,0,8,2,0,10,"amritsar, jalandhar, ludhiana, patiala"
8/28/18,https://www.tribuneindia.com/news/punjab/cabinet-approves-draft-bill-on-cattle-feed-quality/643708.html,"chandigarh, august 27 the cabinet has approved a new draft bill for enactment in the ongoing vidhan sabha session to ensure quality control of cattle feed, with the aim to boosting milk production",agri,1,7,1,0,9,punjab
8/28/18,https://www.tribuneindia.com/news/punjab/cabinet-approves-draft-bill-on-cattle-feed-quality/643708.html,"the punjab regulation of compounded cattle-feed, concentrates and mineral mixtures act, 2018 seeks to exercise quality control on compounded cattle feed, concentrates and mineral mixtures used in the dairy sector",agri,1,7,1,0,9,punjab
8/28/18,https://www.tribuneindia.com/news/punjab/cabinet-approves-draft-bill-on-cattle-feed-quality/643708.html,"the state government had promulgated the punjab regulation of compounded cattle-feed, concentrates and mineral mixtures order, 1988, which was issued under the essential commodities act, 1955",agri,1,7,1,0,9,punjab
8/25/18,https://www.tribuneindia.com/news/punjab/aap-all-the-way-on-day-1-but-for-wrong-reasons/642394.html," during the short session, both groups tried to raise farmers‚Äô issues and demanded a session lasting at least 10 days",agri,3,6,1,0,10,bathinda
8/25/18,https://www.tribuneindia.com/news/punjab/aap-all-the-way-on-day-1-but-for-wrong-reasons/642394.html,"cheema asked the speaker to include the names of 126 farmers, who had committed suicide in the state since the previous session, in the obituary references.",agri,3,6,1,0,10,bathinda
8/24/18,https://www.tribuneindia.com/news/punjab/licence-must-for-arhtiyas-in-punjab/642048.html," the arhtiyas are often accused of charging interest as high as 24 per cent per annum while banks charge only 4 per cent on crop loans up to rs 3 lakh, if repayment is on time",agri,0,24,3,11,38,punjab
8/24/18,https://www.tribuneindia.com/news/punjab/licence-must-for-arhtiyas-in-punjab/642048.html,"punjab is plagued with rural indebtedness with farm loans from ¬†institutional sources pegged at rs 82,000 crore and from arhtiyas at rs 20,000 crore",agri,0,24,3,11,38,punjab
8/24/18,https://www.tribuneindia.com/news/punjab/licence-must-for-arhtiyas-in-punjab/642048.html,"ush({ });  the new provisions have been included as amendments in the punjab settlement of agricultural indebtedness act, 2016, which will be tabled in the monsoon session of the vidhan sabha that begins on friday",agri,0,24,3,11,38,punjab
8/24/18,https://www.tribuneindia.com/news/punjab/licence-must-for-arhtiyas-in-punjab/642048.html,"  ‚Äúwe have amended section 5 of the punjab settlement of agricultural indebtedness act, 2016, which paves the way for establishing debt settlement tribunals at the divisional level rather than the district level (as originally proposed in the 2016 act),‚Äù he said",agri,0,24,3,11,38,punjab
8/11/18,https://www.tribuneindia.com/news/punjab/akalis-bat-for-law-to-bail-out-farmers/635567.html,"tribune news service  new delhi, august 10 the shiromani akali dal (sad) has sought a law to bail out farmers facing loan crisis and wants the government to expand the ambit of the crop insurance scheme launched by prime minister narendra modi",agri,0,24,4,0,28,"gurdaspur, hoshiarpur"
8/2/18,https://www.tribuneindia.com/news/punjab/hyacinth-chokes-water-flow-in-canals-worries-farmers/630591.html,"archit watts tribune news service muktsar, august 1 water hyacinth at the harike headworks, situated at the barrage of sutlej and beas rivers, has created a major trouble for farmers as well as irrigation department officials",agri,2,24,2,0,28,"bathinda, fazilka, sri muktsar sahib"
8/1/18,https://www.tribuneindia.com/news/punjab/lambi-residents-feel-neglected-as-projects-far-from-complete/629988.html," tirlok chand, a resident of pakki tibbi village in the lambi assembly segment, said, ‚Äúabout 200-acre agricultural land has been inundated in our village after rain on july 3",agri,7,15,13,2,37,sri muktsar sahib
7/21/18,https://www.tribuneindia.com/news/punjab/fields-inundated-dept-awaits-funds-for-water-lifting-pumps/624105.html,"archit watts tribune news service pakki tibbi (muktsar), july 20 more than two weeks have passed since a huge chunk of agricultural land at pakki tibbi village in the lambi assembly segment was inundated with rainwater, the drainage department is awaiting funds under the state disaster relief fund (sdrf) to expedite the work to drain out water",agri,5,13,20,1,39,sri muktsar sahib
7/21/18,https://www.tribuneindia.com/news/punjab/fields-inundated-dept-awaits-funds-for-water-lifting-pumps/624105.html,"though two-three water lifting pumps have been installed, these are insufficient,‚Äù said swaranjit singh, a farmer from the village",agri,5,13,20,1,39,sri muktsar sahib
7/19/18,https://www.tribuneindia.com/news/punjab/notice-to-state-on-msp-pil/622773.html,"tribune news service chandigarh, july 18  the punjab and haryana high court on wednesday put the state of punjab on notice on a petition filed in public interest for fixing minimum support price for ‚Äúalternative crops‚Äù higher than msp for paddy",agri,0,45,2,0,47,punjab
7/19/18,https://www.tribuneindia.com/news/punjab/notice-to-state-on-msp-pil/622773.html, he added that about 85 per cent of the state‚Äôs geographical area was under agriculture,agri,0,45,2,0,47,punjab
7/19/18,https://www.tribuneindia.com/news/punjab/notice-to-state-on-msp-pil/622773.html,but during the last four decades they shifted to wheat-rice cropping pattern leading to increased demand for irrigation water,agri,0,45,2,0,47,punjab
7/19/18,https://www.tribuneindia.com/news/punjab/notice-to-state-on-msp-pil/622773.html,farmers to protest in delhi on july 20 chandigarh: the bku (dakonda) as part of all kisan sangarsh committee has announced to organise a protest march in delhi on july 20 during the upcoming monsoon session of parliament,agri,0,45,2,0,47,punjab
7/19/18,https://www.tribuneindia.com/news/punjab/notice-to-state-on-msp-pil/622773.html,"it is expected that two bills related to farmers, one on debt relief and another on hike in msp to  rs 2,250, will be tabled in parliament",agri,0,45,2,0,47,punjab
7/19/18,https://www.tribuneindia.com/news/punjab/notice-to-state-on-msp-pil/622773.html,"farmer organisations are demanding a complete debt waiver and hike in paddy msp to  rs 2,250",agri,0,45,2,0,47,punjab
7/16/18,https://www.tribuneindia.com/news/punjab/nda-govt-has-done-nothing-says-cong/621230.html," he said, ‚Äúthe centre has done nothing on crucial issues such as area-specific crops and vegetable farming scheme, the agricultural rail link and the price stability fund",agri,1,5,1,1,8,gurdaspur
6/13/18,https://www.tribuneindia.com/news/punjab/post-dry-spell-surplus-rain-brings-cheer/604519.html,"vijay mohan tribune news service chandigarh, june 12 after having remained parched during the pre-monsoon season this year, punjab has witnessed significantly good rains in the run-up to the arrival of monsoon in this part of the country, bringing some cheer for the farming community",agri,0,1,1,0,2,punjab
6/6/18,https://www.tribuneindia.com/news/punjab/beas-on-revival-mode-gets-fish-seeds/600824.html," deputy director, fisheries, raj kumar said 10,000 seeds of small indian carp fish varieties like rohu (labeo rohita), other carps like catla (labeo catla) and mrigal carp (cirrhinus cirrhosus) have been arranged from the government-run feed seed farm located at rajasansi",agri,3,10,3,0,16,punjab
5/10/18,https://www.tribuneindia.com/news/punjab/area-under-cotton-crop-likely-to-decrease/586951.html,"archit watts tribune news service muktsar, may 9  though cotton sowing is best for crop diversification in this region, the area under this cash crop is set to decrease this season",agri,0,33,2,1,36,"fazilka, sri muktsar sahib"
5/10/18,https://www.tribuneindia.com/news/punjab/area-under-cotton-crop-likely-to-decrease/586951.html," agriculture department officials said the area under cotton crop was nearly 70,000 hectares last year in the district",agri,0,33,2,1,36,"fazilka, sri muktsar sahib"
5/10/18,https://www.tribuneindia.com/news/punjab/area-under-cotton-crop-likely-to-decrease/586951.html,but late sowing of cotton causes loss to farmers as the crop is prone to pest attack in monsoon,agri,0,33,2,1,36,"fazilka, sri muktsar sahib"
4/4/18,https://www.tribuneindia.com/news/punjab/state-s-stubble-fires-worsen-delhi-pollution-says-study/568395.html,"boston, april 3  agricultural fires are to blame for about half of the pollution experienced in delhi in october and november, a peak stubble-burning season in punjab, a harvard study has found using satellite data from nasa",agri,0,3,1,0,4,punjab
3/9/18,https://www.tribuneindia.com/news/punjab/stanford-graduate-to-set-up-social-impact-incubators/555070.html,"vijay c roy tribune news service mohali, march 8  after training 14,000 youths and farmers spread across five states, a 36-year-old stanford graduate in social entrepreneurship from batala (gurdaspur) has plans to tackle social issues confronting punjab and the country as a whole",agri,1,13,2,0,16,"amritsar, gurdaspur, ludhiana, sas nagar, tarn taran"
3/9/18,https://www.tribuneindia.com/news/punjab/stanford-graduate-to-set-up-social-impact-incubators/555070.html," he added, ‚Äúthe social entrepreneurs will tackle social issues such as raising farmers‚Äô income, agriculture (ensuring zero farmer suicide in punjab before 2022), food processing, livelihood, child education, health and nutrition, women empowerment, clean energy, water and soil health and sustainable development goals",agri,1,13,2,0,16,"amritsar, gurdaspur, ludhiana, sas nagar, tarn taran"
3/9/18,https://www.tribuneindia.com/news/punjab/stanford-graduate-to-set-up-social-impact-incubators/555070.html," his social enterprise, uday, has trained around 14,000 youths, including farmers from punjab, haryana, madhya pradesh, chhattisgarh and uttar pradesh",agri,1,13,2,0,16,"amritsar, gurdaspur, ludhiana, sas nagar, tarn taran"
2/14/18,https://www.tribuneindia.com/news/punjab/cotton-production-falls-short-of-initial-estimate/543720.html,"he hoped that the state‚Äôs farmers would continue cotton farming in the next season as well, as they got remunerative prices for their produce, which touched rs 5,500 per quintal mark this season",agri,2,21,2,0,25,"bathinda, mansa, sas nagar, sri muktsar sahib"
2/14/18,https://www.tribuneindia.com/news/punjab/cotton-production-falls-short-of-initial-estimate/543720.html,"‚Äúwe were expecting that the cotton prices will at least cross rs 6,000 per quintal mark, but it barely managed to touch rs 5,500",agri,2,21,2,0,25,"bathinda, mansa, sas nagar, sri muktsar sahib"
2/14/18,https://www.tribuneindia.com/news/punjab/cotton-production-falls-short-of-initial-estimate/543720.html,"at present, the cotton prices are hovering between rs 5,200 and rs 5,300 per quintal.",agri,2,21,2,0,25,"bathinda, mansa, sas nagar, sri muktsar sahib"
11/28/17,https://www.tribuneindia.com/news/punjab/illegal-mining-free-as-sand-through-fingers/504761.html," a farmer in mallu machhi village of sultanpur lodhi, where jalandhar, kapurthala and ferozepur districts meet, said sand operators had purchased land close to auctioned quarries, and were carrying on illegal mining in over 200 acres there",agri,12,23,31,1,67,"amritsar, faridkot, ferozepur, jalandhar, kapurthala, ludhiana, patiala, sri muktsar sahib"
11/28/17,https://www.tribuneindia.com/news/punjab/illegal-mining-free-as-sand-through-fingers/504761.html," farmers are permitted to excavate their fields not more than 10-ft deep, but they are also involved in mining the ‚Äòminor mineral‚Äô beyond permitted levels",agri,12,23,31,1,67,"amritsar, faridkot, ferozepur, jalandhar, kapurthala, ludhiana, patiala, sri muktsar sahib"
8/30/17,https://www.tribuneindia.com/news/punjab/ppcb-steps-in-to-control-stench-at-poultry-farms/459310.html,"sanjeev singh bariana tribune news service chandigarh, august 29  the punjab pollution control board (ppcb) has launched an exercise on mapping the causes and remedy for the problems of stench, flies and germs in poultry farms across the state",agri,8,21,13,0,42,"barnala, hoshiarpur, ludhiana, patiala, sangrur, sas nagar"
8/30/17,https://www.tribuneindia.com/news/punjab/ppcb-steps-in-to-control-stench-at-poultry-farms/459310.html," the state has 594 layer poultry farms (for eggs) and 2,655 small broiler farms (for meat)",agri,8,21,13,0,42,"barnala, hoshiarpur, ludhiana, patiala, sangrur, sas nagar"
8/30/17,https://www.tribuneindia.com/news/punjab/ppcb-steps-in-to-control-stench-at-poultry-farms/459310.html,"the layer poultry farms have bird strength between 50,000 and 3 lakh",agri,8,21,13,0,42,"barnala, hoshiarpur, ludhiana, patiala, sangrur, sas nagar"
8/30/17,https://www.tribuneindia.com/news/punjab/ppcb-steps-in-to-control-stench-at-poultry-farms/459310.html,about 20 farms in this category have more than 5 lakh birds,agri,8,21,13,0,42,"barnala, hoshiarpur, ludhiana, patiala, sangrur, sas nagar"
8/30/17,https://www.tribuneindia.com/news/punjab/ppcb-steps-in-to-control-stench-at-poultry-farms/459310.html,"and broiler farms accommodate between 2,000 and 10,000 birds",agri,8,21,13,0,42,"barnala, hoshiarpur, ludhiana, patiala, sangrur, sas nagar"
8/30/17,https://www.tribuneindia.com/news/punjab/ppcb-steps-in-to-control-stench-at-poultry-farms/459310.html, reports have indicated deficiencies in the two farms,agri,8,21,13,0,42,"barnala, hoshiarpur, ludhiana, patiala, sangrur, sas nagar"
8/30/17,https://www.tribuneindia.com/news/punjab/ppcb-steps-in-to-control-stench-at-poultry-farms/459310.html," balwant singh, sarpanch of mohali‚Äôs salempur kalan village, said: ‚Äúpoultry farms in akalgarh and tajpura villages have made life hell in nearby eight to nine villages",agri,8,21,13,0,42,"barnala, hoshiarpur, ludhiana, patiala, sangrur, sas nagar"
8/30/17,https://www.tribuneindia.com/news/punjab/ppcb-steps-in-to-control-stench-at-poultry-farms/459310.html," punjab broiler farmers‚Äô association treasurer rajkumar sharma said, ‚Äúwe dispose of birds after every 30 days",agri,8,21,13,0,42,"barnala, hoshiarpur, ludhiana, patiala, sangrur, sas nagar"
7/17/17,https://www.tribuneindia.com/news/punjab/rs-210-cr-for-channelising-swan-river/437771.html,"tribune news service  nangal, july 16  farmers and residents of nangal are likely to get a respite from floods during the monsoon season as the state government is set to start work on channelising the swan river",agri,6,12,1,0,19,punjab
7/17/17,https://www.tribuneindia.com/news/punjab/rs-210-cr-for-channelising-swan-river/437771.html,"‚Äúto ameliorate the sufferings of farmers, the government is going to spend a sum of rs 210 crore to channelise the swan river,‚Äù he said, adding that the project would start in september and the swan river from agampur to santokhgarh would be channelised in two years",agri,6,12,1,0,19,punjab
7/15/17,https://www.tribuneindia.com/news/punjab/fire-breaks-out-at-biomass-plant-belonging-to-sukhbir-s-cousin/437048.html,"luckily, there is no other loss except to the paddy stubble stored on nearly three acres",agri,3,4,5,0,12,"bathinda, sri muktsar sahib"
7/7/17,https://www.tribuneindia.com/news/punjab/sand-gravel-prices-set-to-rise-further/432868.html,"tribune news service chandigarh, july 6  with 43 mines in the state being auctioned for rs 206 crore yesterday, sand and gravel prices will continue to rise for the next couple of months",agri,2,7,1,5,15,"amritsar, pathankot"
7/7/17,https://www.tribuneindia.com/news/punjab/sand-gravel-prices-set-to-rise-further/432868.html," aap leader and rti activist advocate dinesh chadha said to recover their cost and make profit, contractors would mine thousands of acres beyond the contract area, cutting mountains in the process",agri,2,7,1,5,15,"amritsar, pathankot"
7/7/17,https://www.tribuneindia.com/news/punjab/sand-gravel-prices-set-to-rise-further/432868.html,"at this price, it will cost the contractor more than¬†rs¬†70,000 per¬†tipper after including transportation charges ",agri,2,7,1,5,15,"amritsar, pathankot"
7/5/17,https://www.tribuneindia.com/news/punjab/govt-to-bear-liability-in-farm-suicide-cases/431825.html,"sanjeev singh bariana tribune news service chandigarh, july 4  chief minister captain amarinder singh today said the punjab government would bear the liability of the outstanding loans of over 7,000 state farmers who had committed suicide",agri,4,21,1,0,26,bathinda
7/5/17,https://www.tribuneindia.com/news/punjab/govt-to-bear-liability-in-farm-suicide-cases/431825.html," addressing the first formal press conference after assuming office on march 13, he said the government waived loans of all small and marginal farmers (owning up to 5 acres) having loans up to rs 2 lakh",agri,4,21,1,0,26,bathinda
7/5/17,https://www.tribuneindia.com/news/punjab/govt-to-bear-liability-in-farm-suicide-cases/431825.html,"there are about 18.5 lakh farm families and about 65 per cent of them are of small and marginal farmers, out of which about 70 per cent has access to institutional finance",agri,4,21,1,0,26,bathinda
7/5/17,https://www.tribuneindia.com/news/punjab/govt-to-bear-liability-in-farm-suicide-cases/431825.html,he said only rich farmers took crop loans which were given for a six-month period and had a recovery rating of around 90 to 95 per cent,agri,4,21,1,0,26,bathinda
6/27/17,https://www.tribuneindia.com/news/punjab/hyacinth-clogs-abohar-village-ponds/428099.html,"raj sadosh  abohar, june 26 hyacinth accumulated in village ponds has become a hazard for cattle",agri,6,3,5,0,14,punjab
6/21/17,https://www.tribuneindia.com/news/punjab/week-after-repair-canal-breached-again/425200.html,the fresh breach has left hundreds of acres submerged,agri,2,13,9,1,25,moga
6/12/17,https://www.tribuneindia.com/news/punjab/mining-mess-soaring-sand-prices-ground-claims/421039.html,"jupinderjit singh tribune news service chandigarh, june 11  even as the government is struggling to ensure a clean and transparent mining business, people await sand at affordable prices",agri,4,20,4,4,32,"ludhiana, moga, pathankot, patiala, sri muktsar sahib"
6/12/17,https://www.tribuneindia.com/news/punjab/mining-mess-soaring-sand-prices-ground-claims/421039.html,a reality check by the tribune reporters found that prices have instead gone up substantially,agri,4,20,4,4,32,"ludhiana, moga, pathankot, patiala, sri muktsar sahib"
6/12/17,https://www.tribuneindia.com/news/punjab/mining-mess-soaring-sand-prices-ground-claims/421039.html,"with only about 90 mines operational so far, the prices are expected to soar further in the ongoing construction season",agri,4,20,4,4,32,"ludhiana, moga, pathankot, patiala, sri muktsar sahib"
6/12/17,https://www.tribuneindia.com/news/punjab/mining-mess-soaring-sand-prices-ground-claims/421039.html,"the price of sand has increased from rs 14,000 per 800 cubic ft to rs 19,000 per 800 cubic ft in just two months",agri,4,20,4,4,32,"ludhiana, moga, pathankot, patiala, sri muktsar sahib"
6/12/17,https://www.tribuneindia.com/news/punjab/mining-mess-soaring-sand-prices-ground-claims/421039.html,"‚Äúwhen we took on illegal mining in mid-2016, the prices were up to rs 35,000 per tipper",agri,4,20,4,4,32,"ludhiana, moga, pathankot, patiala, sri muktsar sahib"
6/12/17,https://www.tribuneindia.com/news/punjab/mining-mess-soaring-sand-prices-ground-claims/421039.html,the prices have gone up by more than 20-30 per cent and even doubled at various places,agri,4,20,4,4,32,"ludhiana, moga, pathankot, patiala, sri muktsar sahib"
6/12/17,https://www.tribuneindia.com/news/punjab/mining-mess-soaring-sand-prices-ground-claims/421039.html,"in ludhiana, the prices are rs 3,000-rs 4,000 depending on the quality and size of the vehicle",agri,4,20,4,4,32,"ludhiana, moga, pathankot, patiala, sri muktsar sahib"
6/12/17,https://www.tribuneindia.com/news/punjab/mining-mess-soaring-sand-prices-ground-claims/421039.html,"in moga, the prices have increased by 15-20 per cent in two months",agri,4,20,4,4,32,"ludhiana, moga, pathankot, patiala, sri muktsar sahib"
6/12/17,https://www.tribuneindia.com/news/punjab/mining-mess-soaring-sand-prices-ground-claims/421039.html,"its price was rs 5,500 a few months ago",agri,4,20,4,4,32,"ludhiana, moga, pathankot, patiala, sri muktsar sahib"
6/12/17,https://www.tribuneindia.com/news/punjab/mining-mess-soaring-sand-prices-ground-claims/421039.html,"amit kumar, a muktsar resident, said: ‚Äúthe prices were stable at around rs 1,500-rs 2,000 for a year or so, but now these have almost doubled",agri,4,20,4,4,32,"ludhiana, moga, pathankot, patiala, sri muktsar sahib"
6/2/17,https://www.tribuneindia.com/news/punjab/farmers-told-to-grow-maize-avoid-late-sowing-of-cotton/416216.html,"kulwinder sandhu tribune news service moga, june 1 after achieving the target of sowing cotton in four lakh hectares in punjab, the state agriculture department is now suggesting to the farmers to go for maize cultivation to beat the pest attack on late-sown cotton crop",agri,1,25,2,0,28,"mansa, moga"
6/2/17,https://www.tribuneindia.com/news/punjab/farmers-told-to-grow-maize-avoid-late-sowing-of-cotton/416216.html,"the latest studies conducted by agriculture universities and the state agriculture department indicate that optimum row spacing should be 60 cm with a plant population of 80,000 per hectare to get maximum yield of maize crop",agri,1,25,2,0,28,"mansa, moga"
4/20/17,https://www.tribuneindia.com/news/governance/punjab-puts-up-its-defence-on-syl-issue-to-centre/394913.html," pointing to the alarming decline in ground water table in the state, the delegation noted that the state was losing 12 maf (million acre feet) of ground water every year, leading to a huge stress on the ground water system",agri,2,6,1,0,9,punjab
4/20/17,https://www.tribuneindia.com/news/governance/punjab-puts-up-its-defence-on-syl-issue-to-centre/394913.html," ""in fact, 100 of a total of 138 blocks had been rendered ‚Äòdark blocks‚Äô as a result of over-exploitation of underground water to sustain agriculture",agri,2,6,1,0,9,punjab
4/20/17,https://www.tribuneindia.com/news/governance/punjab-puts-up-its-defence-on-syl-issue-to-centre/394913.html,"construction of the syl canal would lead to an estimated 10 lakh acres of land in the region going dry, they further told the central government",agri,2,6,1,0,9,punjab
2/23/17,https://www.tribuneindia.com/news/community/syl-camaraderie-disturbed-say-villagers/368171.html, a group of five elderly farmers sitting on the outskirts of kapoori said that the inld and for that matter any other party could not dig the canal,agri,12,13,9,0,34,patiala
2/23/17,https://www.tribuneindia.com/news/community/syl-camaraderie-disturbed-say-villagers/368171.html,"communities cannot be divided over a matter that does not suit one political party,‚Äù a farmer said",agri,12,13,9,0,34,patiala
2/23/17,https://www.tribuneindia.com/news/community/syl-camaraderie-disturbed-say-villagers/368171.html,"‚Äúit is like playing a political football for vested interests,‚Äù said gurjant singh, who got back 3 acres acquired for the canal",agri,12,13,9,0,34,patiala
12/7/16,https://www.tribuneindia.com/news/community/roads-fine-what-else-asks-ropar/333424.html,"malkit singh, a postgraduate, works as a tipper driver with a stone crusher, while daljit singh, who has a degree in civil engineering, is looking after the cattle at home",agri,23,7,13,0,43,punjab
11/23/16,https://www.tribuneindia.com/news/community/rough-ride-for-industry-in-jalandhar-north/327058.html,"‚Äúin the early 1990s, the punjab small industries and export corporation provided land to the industrialists after acquiring it from farmers at the rate of rs 150 per sq yard",agri,7,13,5,3,28,"jalandhar, ludhiana, sas nagar"
10/19/16,https://www.tribuneindia.com/news/community/moga-farmers-protest-against-mining-mafia/311631.html,"moga, october 18 farmers today blocked traffic on the moga-jalandhar national highway no",agri,1,15,1,0,17,"jalandhar, moga"
9/8/16,https://www.tribuneindia.com/news/community/cong-mla-to-propose-farm-debt-waiver-bill/291894.html,"rajmeet singh tribune news service chandigarh, september 7 congress mla from dera baba nanak sukhjinder singh randhawa has submitted a private member‚Äôs bill demanding debt waiver for farmers for consideration during the monsoon session of the vidhan sabha that begins tomorrow",agri,0,20,2,0,22,punjab
9/8/16,https://www.tribuneindia.com/news/community/cong-mla-to-propose-farm-debt-waiver-bill/291894.html,"the bill submitted with the speaker has been titled ‚Äúpunjab agricultural debt waiver and debt relief bill, 2016‚Äù",agri,0,20,2,0,22,punjab
9/2/16,https://www.tribuneindia.com/news/politics/capt-wants-full-house-in-house/289042.html," being the last session before the 2017 assembly elections, the party legislators during a meeting of the congress legislative party (clp) were today told to ensure their presence and corner the treasury benches on core issues such as farmers‚Äô suicides, drug scourge, denial of blue cards to bpl families affiliated to the congress and the law and order situation",agri,1,5,7,0,13,punjab
8/6/16,https://www.tribuneindia.com/news/community/scanty-rain-spurs-uprooting-of-paddy-in-muktsar/276623.html,"archit watts tribune news service muktsar, august 5 facing acute shortage of water due to weak monsoon so far, farmers in muktsar district have started uprooting paddy crop",agri,1,42,3,2,48,sri muktsar sahib
8/6/16,https://www.tribuneindia.com/news/community/scanty-rain-spurs-uprooting-of-paddy-in-muktsar/276623.html,"if there are two good rains over the next 10 days, it will prove much beneficial for the farmers or it will show adverse effect on the yield",agri,1,42,3,2,48,sri muktsar sahib
7/4/16,https://www.tribuneindia.com/news/community/paddy-on-450-acres-submerged/260794.html,paddy on 450 acres submerged,agri,14,19,26,2,61,"jalandhar, sri muktsar sahib"
7/4/16,https://www.tribuneindia.com/news/community/paddy-on-450-acres-submerged/260794.html,"gagandeep singh tribune news service jalandhar, july 3  paddy transplanted on around 450 acres in four villages along the sultanpur lodhi-dhalla road has been submerged following recent showers",agri,14,19,26,2,61,"jalandhar, sri muktsar sahib"
7/4/16,https://www.tribuneindia.com/news/community/paddy-on-450-acres-submerged/260794.html," speaking to the tribune, sukhchain singh, sarpanch of ugrupur village, said, ‚Äúpaddy on about 150 acres in my village has been submerged",agri,14,19,26,2,61,"jalandhar, sri muktsar sahib"
7/4/16,https://www.tribuneindia.com/news/community/post-rains-power-supply-improves/260792.html,more than 8-hour power supply has been provided to farmers during the paddy season,agri,0,17,2,0,19,patiala
7/4/16,https://www.tribuneindia.com/news/community/post-rains-power-supply-improves/260792.html,"pspcl has adequate arrangements in place to provide 8-hour power supply to farmers even if the rains are delayed,‚Äù they said",agri,0,17,2,0,19,patiala
6/16/16,https://www.tribuneindia.com/news/community/paddy-growers-cheer-as-rain-deficit-narrows/252325.html,"amaninder pal tribune news service chandigarh, june 15  much to the relief of farmers and agriculture officials, showers that hit 13 districts of the state early this morning has reduced rainfall deficit in punjab by 67 percentage points",agri,0,14,3,0,17,"ferozepur, moga, sri muktsar sahib, tarn taran"
6/16/16,https://www.tribuneindia.com/news/community/paddy-growers-cheer-as-rain-deficit-narrows/252325.html," according to the figures available with the state department of agriculture, there was a huge gap of 71 per cent between expected (normal) and actual rainfall across the state in first week of the june",agri,0,14,3,0,17,"ferozepur, moga, sri muktsar sahib, tarn taran"
6/16/16,https://www.tribuneindia.com/news/community/paddy-growers-cheer-as-rain-deficit-narrows/252325.html,"not only is this rainfall healthy for all crops, important aspect is that it has significantly bridged the rainfall deficit the state was witnessing for the past 15 days,‚Äù said director, agriculture, dr js bains",agri,0,14,3,0,17,"ferozepur, moga, sri muktsar sahib, tarn taran"
6/16/16,https://www.tribuneindia.com/news/community/paddy-growers-cheer-as-rain-deficit-narrows/252325.html," meanwhile, agriculture minister tota singh‚Äôs district moga received highest rainfall measuring 72 mm today morning, whereas muktsar district, which is home district of chief minister parkash singh badal, hardly recorded any rainfall",agri,0,14,3,0,17,"ferozepur, moga, sri muktsar sahib, tarn taran"
6/15/16,https://www.tribuneindia.com/news/community/paddy-season-begins-today-farmers-feel-labour-pangs/251807.html,"aman sood tribune news service patiala, june 14  even as the paddy sowing season begins tomorrow, farmers are facing a shortage of migrant labourers",agri,0,34,2,0,36,patiala
6/15/16,https://www.tribuneindia.com/news/community/paddy-season-begins-today-farmers-feel-labour-pangs/251807.html,ush({ });  farmers in the state are still waiting for migrants from bihar and uttar pradesh to sow and harvest nearly 25 lakh hectares of paddy in punjab,agri,0,34,2,0,36,patiala
6/15/16,https://www.tribuneindia.com/news/community/paddy-season-begins-today-farmers-feel-labour-pangs/251807.html," the prevalent rate for migrant labour at present is rs 2,200 to rs 2,300 per acre in addition to tea, 50 kg firewood and liquor in the evening",agri,0,34,2,0,36,patiala
6/14/16,https://www.tribuneindia.com/news/governance/50-ft-canal-breach-plugged-in-abohar/251452.html,"our correspondent  abohar, june 13  the 50-feet-wide breach in a canal that had yesterday inundated hundreds of acres of land in three villages here has now been plugged with the help of jcb machines and farmers",agri,2,9,5,0,16,punjab
6/14/16,https://www.tribuneindia.com/news/governance/50-ft-canal-breach-plugged-in-abohar/251452.html," the state government had constructed the new bahadurkhera minor (sub-canal) to feed about 7,000 acres of land in bahadurkhera, dhaba kokrian and sardarpura village but the same could not be cleaned and also was not strengthened due to the shortage of funds, villagers alleged",agri,2,9,5,0,16,punjab
6/9/16,https://www.tribuneindia.com/news/community/paddy-sowing-power-dept-gears-up-to-meet-11-000-mw-demand/248918.html,"tribune news service patiala, june 8  expecting the peak paddy season power demand to touch the 11,000 (mw) mark, the punjab state power corporation limited (pspcl) has fully geared up to ensure eight hours of supply to farmers from june 15",agri,0,11,1,0,12,patiala
6/9/16,https://www.tribuneindia.com/news/community/paddy-sowing-power-dept-gears-up-to-meet-11-000-mw-demand/248918.html,"with one shower per fortnight, we should not face any problem during the season and farmers will get more than 8-hour supply everyday‚Äù, they stated",agri,0,11,1,0,12,patiala
6/1/16,https://www.tribuneindia.com/news/community/growing-paddy-takes-heavy-toll-on-groundwater-table/245071.html,"aman sood tribune news service patiala, may 31  the failure of the state government to promote crop diversification is taking a toll on the depleting water table",agri,3,13,3,0,19,"barnala, faridkot, ferozepur, hoshiarpur, patiala, sangrur, sri muktsar sahib"
6/1/16,https://www.tribuneindia.com/news/community/growing-paddy-takes-heavy-toll-on-groundwater-table/245071.html," a comprehensive data compiled by the agriculture department, available with the tribune, from 22 districts of the state shows that the water level is falling every year",agri,3,13,3,0,19,"barnala, faridkot, ferozepur, hoshiarpur, patiala, sangrur, sri muktsar sahib"
6/1/16,https://www.tribuneindia.com/news/community/growing-paddy-takes-heavy-toll-on-groundwater-table/245071.html,alarming readings¬†  data compiled by the agriculture department from 22 districts of the state shows that the water level is falling every year,agri,3,13,3,0,19,"barnala, faridkot, ferozepur, hoshiarpur, patiala, sangrur, sri muktsar sahib"
5/6/16,https://www.tribuneindia.com/news/community/farmers-told-to-transplant-paddy-after-june-15-to-save-water/232648.html,farmers told to transplant paddy after june 15 to save water,agri,0,27,1,0,28,moga
5/6/16,https://www.tribuneindia.com/news/community/farmers-told-to-transplant-paddy-after-june-15-to-save-water/232648.html,"tribune news service moga, may 5  chief agriculture officer of moga district dr sukhdev singh brar has appealed to the farmers to use latest techniques and transplant paddy after june 15 to save underground water",agri,0,27,1,0,28,moga
3/19/16,https://www.tribuneindia.com/news/community/state-keen-to-implement-crop-insurance-scheme/210777.html,"new delhi, march 18 with crops being hit by the recent unseasonal rain, the punjab government is considering adopting the pradhan mantri fasal bima yojana (pmfby)",agri,0,38,8,0,46,ludhiana
3/19/16,https://www.tribuneindia.com/news/community/state-keen-to-implement-crop-insurance-scheme/210777.html,"the state government will meet on march 23 at punjab agricultural university, ludhiana, to explore the possibilities of implementing pmfby and wbcis",agri,0,38,8,0,46,ludhiana
3/19/16,https://www.tribuneindia.com/news/community/state-keen-to-implement-crop-insurance-scheme/210777.html,it is estimated that 5-7 per cent of the wheat crop has been affected and the government is still assessing the extent of loss,agri,0,38,8,0,46,ludhiana
3/19/16,https://www.tribuneindia.com/news/community/state-keen-to-implement-crop-insurance-scheme/210777.html,"to protect farmers from the vagaries of monsoon, the central government came out with the new crop insurance scheme, which will come into force from april 1 for kharif crops",agri,0,38,8,0,46,ludhiana
3/19/16,https://www.tribuneindia.com/news/community/state-keen-to-implement-crop-insurance-scheme/210777.html,"ush({ });under the scheme, farmers' premium has been kept between 1.5 and 2 per cent for foodgrains and oilseed crops, and up to 5 per cent for horticultural and cotton crops",agri,0,38,8,0,46,ludhiana
3/19/16,https://www.tribuneindia.com/news/community/state-keen-to-implement-crop-insurance-scheme/210777.html,the government is targeting to increase the insurance coverage to 50 per cent of the total crop area of 194.40 million hectares from the existing level of about 25-27 per cent,agri,0,38,8,0,46,ludhiana
3/19/16,https://www.tribuneindia.com/news/community/state-keen-to-implement-crop-insurance-scheme/210777.html,there will be one insurance company for the entire state as well as farm-level assessment of loss for localised risks and post-harvest loss,agri,0,38,8,0,46,ludhiana
3/19/16,https://www.tribuneindia.com/news/community/dhindsa-announces-more-sops/210768.html,"tribune news service  chandigarh march 18 concluding the debate on his budget proposals for 2016-17, punjab finance minister parminder singh dhindsa today announced three more incentives in the house: 50 per cent subsidy for fencing of fields in kandi areas to prevent damage of crops by wild animals; making turmeric vat-free and reducing vat (value-added tax) on other spices from 6.5 to 4 per cent; and setting aside rs 50-crore corpus for self-sustainable sewa kendras that the government proposes to set up this year",agri,0,12,10,2,24,punjab
3/19/16,https://www.tribuneindia.com/news/community/dhindsa-announces-more-sops/210768.html,"dhindsa added that to compensate the peasantry, the state government had already released rs 800 crore as damages towards crops hit by heavy rain, including rs 112 crore for february, march and april 2015; rs 670 crore for the damaged cotton crop; and rs 54 crore for crops affected by heavy monsoon rain and hailstorms",agri,0,12,10,2,24,punjab
2/18/16,https://www.tribuneindia.com/news/community/water-level-in-reservoirs-satisfactory/197823.html,"patiala, february 17  despite a deficit monsoon in 2015, the farming community in punjab and the neighbouring states of haryana and rajasthan can heave a sigh of relief as various reservoirs, including bhakra and pong dams, continue to have a high level of water this year",agri,0,2,2,0,4,patiala
2/16/16,https://www.tribuneindia.com/news/community/despite-odds-grain-produce-to-be-higher/196926.html,"vibha sharma tribune news service new delhi, february 15 india‚Äôs foodgrain production during the 2015-16 crop year (july to june) will be higher than the overall production during the preceding crop year 2014-15 in spite of adversities suffered by the sector throughout the year",agri,2,16,2,0,20,punjab
2/16/16,https://www.tribuneindia.com/news/community/despite-odds-grain-produce-to-be-higher/196926.html,"the second advance estimates of the country‚Äôs foodgrain production released by the agriculture ministry today pegged the overall foodgrain production at 253.16 million tonnes (mt), higher than the overall production registered in 2014-15 ‚Äî a bad monsoon year",agri,2,16,2,0,20,punjab
2/16/16,https://www.tribuneindia.com/news/community/despite-odds-grain-produce-to-be-higher/196926.html,"however, wheat production is expected to rise by 8.4 per cent this year, going up to 93.8 mt in 2015-16 from 86.5 mt a year earlier ‚Äî the lowest since 2009-10",agri,2,16,2,0,20,punjab
2/16/16,https://www.tribuneindia.com/news/community/despite-odds-grain-produce-to-be-higher/196926.html,"for wheat, the procurement target is 30 million tonnes (mt) as against 28.08 mt in the current year",agri,2,16,2,0,20,punjab
2/16/16,https://www.tribuneindia.com/news/community/moga-villagers-oppose-dhusi-bundh-realignment/196913.html,"at least 5,000 acres are under cultivation within the embankment areas in the district",agri,9,3,14,0,26,moga
1/21/16,https://www.tribuneindia.com/news/community/two-days-before-protest-farmer-leaders-detained/186146.html,"tribune news service bathinda, january 20  two days ahead of the farmers‚Äô scheduled agitation in the chief minister‚Äôs village, the state police today cordoned off rai ke kalan village of bathinda district where thousands of farmers had gathered to plan and prepare for the agitation",agri,1,37,14,2,54,"bathinda, mansa"
1/21/16,https://www.tribuneindia.com/news/community/two-days-before-protest-farmer-leaders-detained/186146.html," earlier, the farmers had planned to launch the agitation in badal village on january 10, but cancelled it due to poor-monsoon predictions",agri,1,37,14,2,54,"bathinda, mansa"
1/21/16,https://www.tribuneindia.com/news/community/two-days-before-protest-farmer-leaders-detained/186146.html, mansa ssp raghubir singh sandhu confirmed that some farmer leaders have been arrested under sections 107/151 of the crpc (preventive custody),agri,1,37,14,2,54,"bathinda, mansa"
1/21/16,https://www.tribuneindia.com/news/community/two-days-before-protest-farmer-leaders-detained/186146.html," sukhdev singh kokri kalan, state general secretary, bku ekta ugraha, said, ‚Äúour demands, including compensation of rs 40,000 per acre to farmers and rs 20,000 per family to farm labourers,  could curb farmer suicides",agri,1,37,14,2,54,"bathinda, mansa"
1/21/16,https://www.tribuneindia.com/news/community/two-days-before-protest-farmer-leaders-detained/186146.html," village turns into fortress  badal: as a large number of farmers and farm labourers today reached rai ke kalan village in bathinda district to gherao badal village, situated 7 km away, from january 22 to 24, the district police have beefed up security in this vvip village, converting it into a fortress",agri,1,37,14,2,54,"bathinda, mansa"
1/17/16,https://www.tribuneindia.com/news/punjab/husband-2-sons-gave-up-66-yr-old-can-t-afford-to/184577.html," pakkan village is home to nearly 4,000 people, majority of them marginal farmers and labourers",agri,9,27,22,1,59,"fazilka, sri muktsar sahib"
1/17/16,https://www.tribuneindia.com/news/punjab/husband-2-sons-gave-up-66-yr-old-can-t-afford-to/184577.html," of the total of 3,200 acres of land in the village, over 1,000 acres have been rendered barren",agri,9,27,22,1,59,"fazilka, sri muktsar sahib"
1/17/16,https://www.tribuneindia.com/news/punjab/husband-2-sons-gave-up-66-yr-old-can-t-afford-to/184577.html, ‚Äúnone of the debt-ridden families of farmers who committed suicide has ever been paid any compensation by the government,agri,9,27,22,1,59,"fazilka, sri muktsar sahib"
10/29/15,https://www.tribuneindia.com/news/community/youth-congress-protests-rising-price-of-pulses/151868.html,"now, certain varieties of pulses are priced at rs 150 per kg,‚Äù said former gurdaspur district youth congress president kartik wadhera",agri,3,7,1,0,11,"gurdaspur, pathankot"
10/29/15,https://www.tribuneindia.com/news/community/youth-congress-protests-rising-price-of-pulses/151868.html," the workers distributed nearly 2,000 pamphlets in which rates of various pulses were compared to the last year‚Äôs prices",agri,3,7,1,0,11,"gurdaspur, pathankot"
10/29/15,https://www.tribuneindia.com/news/community/youth-congress-protests-rising-price-of-pulses/151868.html,"prices have gone up ‚Äî urad and arhar dal are now retailing at rs 150-160 per kg levels ‚Äî largely because of a second consecutive monsoon failure, impacting production in major producing states",agri,3,7,1,0,11,"gurdaspur, pathankot"
9/28/15,https://www.tribuneindia.com/news/punjab/revise-basmati-price-or-face-stir-farmer-unions-warn-govt/138834.html,"anirudh gupta ferozepur, september 27  having moved away from traditional crop cycle, the farmers who had switched over to basmati are feeling trapped between the devil and the deep sea",agri,2,62,7,3,74,ferozepur
9/28/15,https://www.tribuneindia.com/news/punjab/revise-basmati-price-or-face-stir-farmer-unions-warn-govt/138834.html," the crumbling price of basmati 1509 variety ‚Äî which has already arrived in the market this season ‚Äî has crushed the farmers‚Äô hopes, putting their very survival at stake",agri,2,62,7,3,74,ferozepur
9/28/15,https://www.tribuneindia.com/news/punjab/revise-basmati-price-or-face-stir-farmer-unions-warn-govt/138834.html,"but many farmers have already sold off their produce at prices ranging from rs 900-1,200 which is much less than their actual input cost",agri,2,62,7,3,74,ferozepur
9/28/15,https://www.tribuneindia.com/news/punjab/revise-basmati-price-or-face-stir-farmer-unions-warn-govt/138834.html," ""in order to break away from sowing traditional crops, i had sown 1509 basmati, anticipating good remuneration",agri,2,62,7,3,74,ferozepur
9/28/15,https://www.tribuneindia.com/news/punjab/revise-basmati-price-or-face-stir-farmer-unions-warn-govt/138834.html,"""the farmers who had sown 1509 are feeling dejected as they will not be able to recover even their input costs",agri,2,62,7,3,74,ferozepur
9/28/15,https://www.tribuneindia.com/news/punjab/revise-basmati-price-or-face-stir-farmer-unions-warn-govt/138834.html,"the yield of 1509 is around 18-20 quintal per acre which is less than the non-basmati variety (28-32 quintals),"" said gurpreet",agri,2,62,7,3,74,ferozepur
9/28/15,https://www.tribuneindia.com/news/punjab/revise-basmati-price-or-face-stir-farmer-unions-warn-govt/138834.html,"  another farmer nihal singh of machibugra village said that he had sown basmati 1509 on his five-acre land which cost him around rs 16,000 per acre",agri,2,62,7,3,74,ferozepur
9/28/15,https://www.tribuneindia.com/news/punjab/revise-basmati-price-or-face-stir-farmer-unions-warn-govt/138834.html," ""we farmers expect at least rs 2,000 profit to survive and sustain our family",agri,2,62,7,3,74,ferozepur
9/26/15,https://www.tribuneindia.com/news/politics/bjp-cong-battle-infighting-as-akalis-struggle-on-policies/137965.html," the strong case the leader of opposition sunil jakhar built against the government over rampant corruption in the agriculture department leading to the agrarian crisis in the state was washed away with congress mla ashwani sekhri accusing two of his own party mlas ‚Äî sangat singh gilzian and ramajit singh sikki ‚Äîthreatening him, thus inviting action against them by speaker charanjit singh atwal.",agri,2,2,4,0,8,punjab
9/23/15,https://www.tribuneindia.com/news/punjab/farmers-worried-as-heavy-rain-lashes-punjab-haryana/136794.html,"chandigarh, september 23    heavy rain has lashed vast swathes of punjab and some parts of haryana since yesterday, raising fears of damage to paddy crop, which is ready for harvesting",agri,1,24,9,0,34,"amritsar, gurdaspur, hoshiarpur, ludhiana, moga, patiala, sangrur, sas nagar, tarn taran"
9/23/15,https://www.tribuneindia.com/news/punjab/farmers-worried-as-heavy-rain-lashes-punjab-haryana/136794.html," after untimely rain and hailstorm in march-april this year caused heavy damage to crops in the two leading agrarian states, heavy showers at the fag end of the monsoon have again increased the woes of the farmers",agri,1,24,9,0,34,"amritsar, gurdaspur, hoshiarpur, ludhiana, moga, patiala, sangrur, sas nagar, tarn taran"
9/10/15,https://www.tribuneindia.com/news/punjab/punjab-govt-approves-bailout-package-for-sugar-mills/131383.html,"chandigarh, september 10  the punjab government today approved a loan of rs 200 crore and interest subvention scheme for ailing sugar mills to help them clear cane arrears of farmers in the state",agri,1,16,2,2,21,punjab
9/10/15,https://www.tribuneindia.com/news/punjab/punjab-govt-approves-bailout-package-for-sugar-mills/131383.html,"ush({ });  in view of the sugar mills where the cost of production was higher than the whole sale price of sugar, the government would be paying about rs 50 per quintal of sugarcane and the sugar mills would provide rs 245 per quintal to the cane growers, he said",agri,1,16,2,2,21,punjab
9/10/15,https://www.tribuneindia.com/news/punjab/punjab-govt-approves-bailout-package-for-sugar-mills/131383.html, the payment of rs 50 would reduce with the increase in wholesale sugar price in the country,agri,1,16,2,2,21,punjab
9/1/15,https://www.tribuneindia.com/news/community/relief-for-region-s-farmers-as-dams-full-despite-deficient-rain/127285.html,"arun sharma tribune news service ropar, august 31  the farming community in punjab can relax as despite deficient monsoon in the region, the reservoirs at the three dams that feed the state‚Äôs canals are almost full to capacity",agri,2,17,3,1,23,punjab
9/1/15,https://www.tribuneindia.com/news/community/relief-for-region-s-farmers-as-dams-full-despite-deficient-rain/127285.html,"ush({ });  more than 1.5 crore acres of land ‚Äî 77 lakh acres in punjab, 53 lakh acres in rajasthan and 22 lakh acres in haryana ‚Äî is irrigated with water from these reservoirs",agri,2,17,3,1,23,punjab
8/31/15,https://www.tribuneindia.com/news/community/whitefly-attacks-cotton-in-moga-too/126674.html,"kulwinder sandhu tribune news service moga, august 30  whitefly has also attacked the cotton crop in the district",agri,4,43,8,1,56,moga
8/31/15,https://www.tribuneindia.com/news/community/whitefly-attacks-cotton-in-moga-too/126674.html," the agriculture department said cotton had been sown on over 2,000 acres in the district",agri,4,43,8,1,56,moga
8/31/15,https://www.tribuneindia.com/news/community/whitefly-attacks-cotton-in-moga-too/126674.html,whitefly has attacked the crop on over 70 per cent of the area,agri,4,43,8,1,56,moga
8/25/15,https://www.tribuneindia.com/news/community/cong-sold-onions-at-rs-100-a-kg-it-s-just-rs-80-now-min/124226.html,"tribune news service ludhiana, august 24  minister of state in the human resource development ministry ram shankar katheria today tried to justify the rising prices of onion",agri,6,4,0,0,10,ludhiana
8/4/15,https://www.tribuneindia.com/news/community/natural-drains-in-moga-choked-with-weed-silt/115211.html,"it has been stated that groundwater withdrawal has exceeded natural recharge by more than 200 per cent in these blocks, severely affecting small and marginal farmers",agri,6,3,10,0,19,moga
8/3/15,https://www.tribuneindia.com/news/community/monsoon-at-peak-drains-yet-to-be-cleaned-in-muktsar/114868.html," tarsem singh sangrana, a farmer, said, ‚Äúrainfall has so far been normal, but if it rains continuously for 2-3 days, this drain will overflow and inundate about 10 villages",agri,9,7,15,1,32,sri muktsar sahib
7/18/15,https://www.tribuneindia.com/news/community/muktsar-farmers-warned-against-creating-bundhs/108178.html,"muktsar, july 17 with the forecast of heavy rains in the coming days, the district administration is taking measures to prevent waterlogging and has warned farmers against creating any obstacle in the free flow of rain water in fields",agri,4,21,3,0,28,sri muktsar sahib
7/18/15,https://www.tribuneindia.com/news/community/muktsar-farmers-warned-against-creating-bundhs/108178.html,"in the last two years, bundhs created by farmers to avert rainwater entering their fields have resulted in losses to other farmers",agri,4,21,3,0,28,sri muktsar sahib
7/15/15,https://www.tribuneindia.com/news/punjab/waterlogging-unfinished-work-worries-farmers/106825.html,"archit watts tribune news service muktsar, july 14  farmers are worried as monsoon has arrived and most of the works to tackle waterlogging in muktsar and fazilka districts are yet to be completed",agri,2,19,21,0,42,"fazilka, sri muktsar sahib"
7/15/15,https://www.tribuneindia.com/news/punjab/waterlogging-unfinished-work-worries-farmers/106825.html," farmers from bhundar, lundewala villages said, ‚Äúour crops get damaged if it rains for around three days",agri,2,19,21,0,42,"fazilka, sri muktsar sahib"
7/6/15,https://www.tribuneindia.com/news/community/waterlogging-monsoon-nears-but-projects-unfinished/102939.html,recently some farmers got cheques of below rs 100 as compensation.,agri,5,22,12,3,42,sri muktsar sahib
6/24/15,https://www.tribuneindia.com/news/punjab/monsoon-arrives-early-brings-cheers/97808.html,"sarbjit dhaliwal tribune news service chandigarh, june 23  the arrival of monsoon about a week ahead of the expected schedule has brought relief to residents from the scorching heat and cheers to farmers who are busy transplanting paddy",agri,2,10,4,0,16,punjab
6/24/15,https://www.tribuneindia.com/news/punjab/monsoon-arrives-early-brings-cheers/97808.html,"‚Äúone may call it a pre-monsoon or monsoon, but rains have begun in the region,‚Äù said a senior official of punjab agricultural university that keeps a close watch on weather-related developments in this part of the country",agri,2,10,4,0,16,punjab
6/21/15,https://www.tribuneindia.com/news/punjab/power-cuts-back-as-paddy-season-peaks/96466.html," farmers, meanwhile, have expressed satisfaction that they are getting the promised eight-hour power for running tube wells for irrigating their paddy fields",agri,1,9,2,0,12,patiala
6/5/15,https://www.tribuneindia.com/news/punjab/rs-2-000-crore-set-aside-for-power-supply-as-met-dept-predicts-deficient-monsoon/89612.html,"  with almost negligible rain-fed farming, 27 per cent of the total cultivable land in the state is river-fed and the rest is dependent on tube wells",agri,0,19,2,1,22,punjab
6/5/15,https://www.tribuneindia.com/news/punjab/rs-2-000-crore-set-aside-for-power-supply-as-met-dept-predicts-deficient-monsoon/89612.html,"‚Äúfarmers can save rs 5,000-rs 6,000 per acre if they adopt the direct sowing method",agri,0,19,2,1,22,punjab
6/5/15,https://www.tribuneindia.com/news/punjab/rs-2-000-crore-set-aside-for-power-supply-as-met-dept-predicts-deficient-monsoon/89612.html,"the department is giving 50 per cent subsidy on machinery used for the purpose,‚Äù said dr mangal sandhu, director, agriculture department",agri,0,19,2,1,22,punjab
6/5/15,https://www.tribuneindia.com/news/punjab/rs-2-000-crore-set-aside-for-power-supply-as-met-dept-predicts-deficient-monsoon/89612.html,he said their aim was to bring four lakh acres under direct paddy sowing this year as compared to 2.87 lakh acres last year.,agri,0,19,2,1,22,punjab
5/27/15,https://www.tribuneindia.com/news/community/pond-not-cleaned-villagers-blame-govt/85856.html,"at least 20 cattle had been rescued as they slipped into¬†  the pond, gaushala workers claimed",agri,10,2,14,1,27,punjab
5/9/15,https://www.tribuneindia.com/news/community/bhakra-dam-level-10-ft-higher-than-last-year/78212.html,"vijay mohan tribune news service chandigarh, may 8  though the meteorological department has forecast a deficient monsoon this year, higher water levels in the reservoirs of two major dams of the region could give some solace to farmers",agri,0,3,1,0,4,punjab
5/9/15,https://www.tribuneindia.com/news/community/low-rain-forecast-fuels-inflation/78210.html,"sarbjit dhaliwal tribune news service chandigarh, may 8  the indian meteorological department‚Äôs prediction of a below normal rainfall this monsoon season has fuelled inflation, causing a steep rise in the price of various goods, especially pulses",agri,2,13,5,0,20,punjab
5/9/15,https://www.tribuneindia.com/news/community/low-rain-forecast-fuels-inflation/78210.html,"earlier, due to a fall in the price of fuel, the inflation rate had almost touched the zero level",agri,2,13,5,0,20,punjab
5/9/15,https://www.tribuneindia.com/news/community/low-rain-forecast-fuels-inflation/78210.html, the price of ‚Äòdhuli moong‚Äô has gone up from rs 100 per kg to rs 120 per kg and that of sugar has jumped from rs 30 per kg to rs 34 per kg in the last few days,agri,2,13,5,0,20,punjab
5/9/15,https://www.tribuneindia.com/news/community/low-rain-forecast-fuels-inflation/78210.html,"likewise, there has been about 20 per cent of increase in the price of ‚Äòdhooli mah‚Äô",agri,2,13,5,0,20,punjab
5/9/15,https://www.tribuneindia.com/news/community/low-rain-forecast-fuels-inflation/78210.html,the price of rajmah has also shot up to rs 85 per kg,agri,2,13,5,0,20,punjab
4/28/15,https://www.tribuneindia.com/news/community/farm-income-dips-so-do-lease-rates/73117.html,"balwant garg tribune news service faridkot, april 27 the lease rates of agriculture land have started sliding in the area in line with a fall in the prices of crops, mainly basmati and cotton",agri,1,59,8,3,71,faridkot
4/28/15,https://www.tribuneindia.com/news/community/farm-income-dips-so-do-lease-rates/73117.html,"the owners had leased out their land at the rate of rs 45,000 to rs 53,000 per acre per annum last year in malwa region",agri,1,59,8,3,71,faridkot
4/28/15,https://www.tribuneindia.com/news/community/farm-income-dips-so-do-lease-rates/73117.html,"resultantly, there was an impressive increase in the annual lease rates, which rose from rs 35,000 per acre to rs 48,000 per acre per annum",agri,1,59,8,3,71,faridkot
3/17/15,https://www.tribuneindia.com/news/community/waterlogging-hit-farmers-in-for-more-trouble/54625.html,"archit wattstribune news servicemuktsar, march 16the untimely rain is all set to take a heavy toll on farmers in the district who are already facing huge monetary losses due to waterlogging in their fields",agri,3,45,11,2,61,sri muktsar sahib
3/17/15,https://www.tribuneindia.com/news/community/waterlogging-hit-farmers-in-for-more-trouble/54625.html,"the state and the central governments must come up with some permanent solution to save the farmers of this area or we will lose our source of livelihood in the next two-three years,‚Äù they said, adding that the work to reline these twin canals had also not started",agri,3,45,11,2,61,sri muktsar sahib
3/17/15,https://www.tribuneindia.com/news/community/waterlogging-hit-farmers-in-for-more-trouble/54625.html,it is to mention that seepage from these twin canals is one of the biggest reasons of waterlogging in agricultural fields,agri,3,45,11,2,61,sri muktsar sahib
3/3/15,https://www.tribuneindia.com/news/community/wheat-crop-in-moga-flattened/48955.html,"kulwinder sandhu and archit watts  tribune news service moga, march 2  wheat crop on at least 25,000 acres has been damaged in moga district because of high-speed winds and rain",agri,5,56,26,2,89,"bathinda, fatehgarh sahib, moga, sri muktsar sahib"
3/3/15,https://www.tribuneindia.com/news/community/wheat-crop-in-moga-flattened/48955.html," if the rain continues for another day or two, there were chances of the yellow rust and karnal bust diseases striking the wheat plants, he said",agri,5,56,26,2,89,"bathinda, fatehgarh sahib, moga, sri muktsar sahib"
3/3/15,https://www.tribuneindia.com/news/community/wheat-crop-in-moga-flattened/48955.html,"the chairman of the market committee of fatehgarh panchtoor, joginder singh, has demanded 90 per cent subsidy on maize and moong seed so that the affected farmers can sow these short-duration crops and save themselves from heavy losses",agri,5,56,26,2,89,"bathinda, fatehgarh sahib, moga, sri muktsar sahib"
3/3/15,https://www.tribuneindia.com/news/community/wheat-crop-in-moga-flattened/48955.html," muktsar: six months ago, monsoon rains flattened cotton and paddy crops in muktsar district and damaged houses",agri,5,56,26,2,89,"bathinda, fatehgarh sahib, moga, sri muktsar sahib"
3/3/15,https://www.tribuneindia.com/news/community/wheat-crop-in-moga-flattened/48955.html,"  shingara singh mann, bathinda district president, bhartiya kisan union, said: ‚Äúin the district, more than 50 per cent farmers who had sown early variety of wheat have been affected",agri,5,56,26,2,89,"bathinda, fatehgarh sahib, moga, sri muktsar sahib"
2/23/15,https://www.tribuneindia.com/news/politics/gurdaspur-focus-on-local-bodies-where-cong-mlas-rule-the-roost/45712.html,"till 1990, there were five ponds of the size between 5 and 10 acres, which used to act as reservoir for rain water",agri,4,4,2,0,10,"fatehgarh sahib, gurdaspur, pathankot, sas nagar"
1/24/15,https://www.tribuneindia.com/news/community/water-table-dips-as-state-continues-to-struggle-on-diversification/33776.html,"sarbjit dhaliwal tribune news service chandigarh, january 23 with the centre setting the alarm bells ringing on declining water table in the state, the government here is in a dilemma on breaking free from the traditional paddy-wheat cycle",agri,2,27,1,0,30,sri muktsar sahib
1/24/15,https://www.tribuneindia.com/news/community/water-table-dips-as-state-continues-to-struggle-on-diversification/33776.html,"the state was treading cautiously on the diversification front as it concerned the livelihood of 1.5 million farmer families, besides several lakh other people, he said",agri,2,27,1,0,30,sri muktsar sahib
1/24/15,https://www.tribuneindia.com/news/community/water-table-dips-as-state-continues-to-struggle-on-diversification/33776.html,ush({ });punjab grows paddy and basmati in about 27.5 lakh hectares and wheat in about 35 lakh hectares,agri,2,27,1,0,30,sri muktsar sahib
1/24/15,https://www.tribuneindia.com/news/community/water-table-dips-as-state-continues-to-struggle-on-diversification/33776.html,"to break free from the paddy-wheat cycle, the state government had submitted a diversification plan involving an expenditure of rs 8,000 crore to the centre",agri,2,27,1,0,30,sri muktsar sahib
1/24/15,https://www.tribuneindia.com/news/community/water-table-dips-as-state-continues-to-struggle-on-diversification/33776.html,"common varieties of paddy take 25 doses of water during the full crop season, while basmati needs only half of that",agri,2,27,1,0,30,sri muktsar sahib
1/21/15,https://www.tribuneindia.com/news/governance/low-waterlogging-relief-upsets-cotton-farmers/32510.html,"bharat khanna tribune news service mansa, january 20  a ""meagre"" compensation of rs5,000 for the loss of cotton crop hit by waterlogging has come as a dampener for the farmers in mansa, who have vowed not to sow the crop next time",agri,4,73,38,4,119,mansa
1/21/15,https://www.tribuneindia.com/news/governance/low-waterlogging-relief-upsets-cotton-farmers/32510.html," the district administration has sought rs5,000 per acre compensation for complete crop loss, rs3,000 for 75 per cent damage and rs2,000 for 50 per cent loss",agri,4,73,38,4,119,mansa
1/21/15,https://www.tribuneindia.com/news/governance/low-waterlogging-relief-upsets-cotton-farmers/32510.html,"the farmers, on the contrary, have been demanding rs50,000 per acre",agri,4,73,38,4,119,mansa
1/21/15,https://www.tribuneindia.com/news/governance/low-waterlogging-relief-upsets-cotton-farmers/32510.html,"ush({ });  jagtar singh brar, mansa chief agriculture officer, confirmed that dry weather conditions had checked the growth of cotton plants by 2-3 per cent",agri,4,73,38,4,119,mansa
1/21/15,https://www.tribuneindia.com/news/governance/low-waterlogging-relief-upsets-cotton-farmers/32510.html," in their survey, agriculture officials recorded crop loss on 6,587 acres in 14 villages of mansa sub-division and 18 villages in jhunir, which were hit by waterlogging in september last",agri,4,73,38,4,119,mansa
1/21/15,https://www.tribuneindia.com/news/governance/low-waterlogging-relief-upsets-cotton-farmers/32510.html,"the figures show 3,554 acres of land with 75 to 100 per cent damage, 2,274 acres in 50-75 per cent category, 502 acres with 25-50 per cent and 257 acres with less than 25 per cent losses",agri,4,73,38,4,119,mansa
1/21/15,https://www.tribuneindia.com/news/governance/low-waterlogging-relief-upsets-cotton-farmers/32510.html," but the villagers contended that crop on more than 15,000 acres was damaged",agri,4,73,38,4,119,mansa
1/21/15,https://www.tribuneindia.com/news/governance/low-waterlogging-relief-upsets-cotton-farmers/32510.html," the department has shown below-75 per cent damage on 54 acres of land, belonging to 15 farmers, in musa village even though sarpanch avtar singh claimed the affected area was over 200 acres",agri,4,73,38,4,119,mansa
1/21/15,https://www.tribuneindia.com/news/governance/low-waterlogging-relief-upsets-cotton-farmers/32510.html," in chehlanwala village, the government record showed losses below-50 per cent losses on 70 acres and 50-75 per cent damage on 85 acres",agri,4,73,38,4,119,mansa
1/21/15,https://www.tribuneindia.com/news/governance/low-waterlogging-relief-upsets-cotton-farmers/32510.html,"sarpanch balla singh contended that the loss area was around 1,300 acres.",agri,4,73,38,4,119,mansa
1/8/15,https://www.tribuneindia.com/news/community/govt-fails-to-double-prize-money-for-livestock-championship/27492.html,"archit watts tribune news service muktsar, january 7  the state government has failed to double the prize money to rs 2.5 crore for the national livestock championship even though chief minister parkash singh badal promised to do so last year",agri,3,9,3,4,19,sri muktsar sahib
10/5/19,https://www.tribuneindia.com/news/punjab/rain-damages-crops/842702.html,"our correspondent fazilka, october 4  untimely heavy rain in the fazilka area today played a havoc with the paddy crop",agri,1,31,15,1,48,fazilka
10/5/19,https://www.tribuneindia.com/news/punjab/rain-damages-crops/842702.html," a strong wind followed by incessant rain and hailstorm flattened paddy crop in hundreds of acres in border villages, said farmers",agri,1,31,15,1,48,fazilka
10/5/19,https://www.tribuneindia.com/news/punjab/rain-damages-crops/842702.html,prem chand said they were expecting a bumper paddy crop this season but the hailstorm had damaged 30-40 per cent of the crops,agri,1,31,15,1,48,fazilka
7/25/19,https://www.tribuneindia.com/news/punjab/drain-line-still-clogged-in-muktsar/807330.html,"archit watts  tribune news service  muktsar, july 24  the recent rains have caused widespread damage to crops and buildings in muktsar district",agri,2,8,13,0,23,sri muktsar sahib
4/21/19,https://www.tribuneindia.com/news/punjab/arrivals-pick-up-pace-govt-expects-highest-ever-yield/761311.html,"tribune news service  chandigarh, april 20 post widespread rainfall in different parts of the state earlier this week, which damaged crop in certain areas, wheat arrivals have picked up in mandis over the last two days",agri,0,17,6,0,23,punjab
4/21/19,https://www.tribuneindia.com/news/punjab/arrivals-pick-up-pace-govt-expects-highest-ever-yield/761311.html,"latest figures available from the food and supplies department reveal that as of date, 2,79,088 metric tonnes (mt) of wheat has arrived in various mandis across the state",agri,0,17,6,0,23,punjab
4/21/19,https://www.tribuneindia.com/news/punjab/arrivals-pick-up-pace-govt-expects-highest-ever-yield/761311.html,"despite the rain, the government was hopeful of highest ever wheat yield in the state, expected to be 52 quintals per hectare, up from the previous high of 50.09 quintals last year",agri,0,17,6,0,23,punjab
4/21/19,https://www.tribuneindia.com/news/punjab/arrivals-pick-up-pace-govt-expects-highest-ever-yield/761311.html,"the previous high of wheat production was in 2011-12, when the state produced 179.7 lakh mt mainly because of increase in area under cultivation as well as favourable weather",agri,0,17,6,0,23,punjab
4/21/19,https://www.tribuneindia.com/news/punjab/arrivals-pick-up-pace-govt-expects-highest-ever-yield/761311.html,"last year, wheat production was 178 lakh mt",agri,0,17,6,0,23,punjab
4/21/19,https://www.tribuneindia.com/news/punjab/arrivals-pick-up-pace-govt-expects-highest-ever-yield/761311.html,farmers and officers are hoping that increase in temperature will help in the recovery of the grain and the loss may not be more than 2 per cent,agri,0,17,6,0,23,punjab
4/18/19,https://www.tribuneindia.com/news/punjab/wheat-crop-flattened-capt-orders-girdawari/759813.html,"tribune reporters chandigarh, april 17  following reports of damage to wheat crop in various parts of the state due to rain and dust storm, chief minister capt amarinder singh today ordered a special girdawari for the assessment of crop loss",agri,8,60,26,3,97,"patiala, sangrur, sas nagar, sri muktsar sahib"
4/18/19,https://www.tribuneindia.com/news/punjab/wheat-crop-flattened-capt-orders-girdawari/759813.html," in abohar, farmers‚Äô efforts to plug breaches that developed yesterday in six sub-canals emanating from gang (bikaner) canal suffered a jolt as hailstorm and heavy rain lashed the border district for the third consecutive day on wednesday",agri,8,60,26,3,97,"patiala, sangrur, sas nagar, sri muktsar sahib"
4/18/19,https://www.tribuneindia.com/news/punjab/wheat-crop-flattened-capt-orders-girdawari/759813.html,"breaches in gg minor, lnp minor, ps minor, ridmalsar minor, karniji minor and sameja minor submerged wheat and mustard crops spread over hundreds of acres",agri,8,60,26,3,97,"patiala, sangrur, sas nagar, sri muktsar sahib"
10/27/18,https://www.tribuneindia.com/news/punjab/dip-in-temperature-heavy-rain-reduce-paddy-yield/674472.html,"archit watts tribune news service muktsar, october 26 the sudden change in temperature and heavy rain after mid-september has decreased the per acre yield of paddy by 10 to 15 per cent in the district",agri,0,20,1,0,21,"ludhiana, sri muktsar sahib"
10/27/18,https://www.tribuneindia.com/news/punjab/dip-in-temperature-heavy-rain-reduce-paddy-yield/674472.html,"last year, the per acre yield was more than 30 quintals",agri,0,20,1,0,21,"ludhiana, sri muktsar sahib"
10/27/18,https://www.tribuneindia.com/news/punjab/dip-in-temperature-heavy-rain-reduce-paddy-yield/674472.html,"ush({ });those who had sown the pusa 44 variety (recommended by punjab agricultural university, ludhiana) and the cr 212 variety (not recommended by the pau) were complaining about the drop in yield, he said",agri,0,20,1,0,21,"ludhiana, sri muktsar sahib"
10/27/18,https://www.tribuneindia.com/news/punjab/dip-in-temperature-heavy-rain-reduce-paddy-yield/674472.html,"baljinder singh, chief agricultural officer, said: ‚Äúin muktsar district, paddy is sown on 1.35 lakh hectares",agri,0,20,1,0,21,"ludhiana, sri muktsar sahib"
10/12/18,https://www.tribuneindia.com/news/punjab/rain-hailstorm-ravage-paddy/666935.html,"kulwinder sandhu tribune news service moga, october 11  unseasonal rain, coupled with hailstorm, during the past 24 hours in the state has caused widespread damage to paddy crop, which is almost ready to harvest in amritsar, gurdaspur, patiala, ropar, fatehgarh sahib, mohali, hoshiarpur, kapurthala, tarn taran and some parts of moga district",agri,0,31,18,1,50,"amritsar, fatehgarh sahib, gurdaspur, hoshiarpur, kapurthala, moga, patiala, sas nagar, tarn taran"
10/12/18,https://www.tribuneindia.com/news/punjab/rain-hailstorm-ravage-paddy/666935.html," while confirming this to the tribune, dr jasbir singh bains, director, agriculture department, said about 2,500 acres of standing paddy crop had been affected in the anandpur sahib block of ropar district, 1,500 acres in khera and 500 acres in the khamano blocks of fatehgarh sahib district",agri,0,31,18,1,50,"amritsar, fatehgarh sahib, gurdaspur, hoshiarpur, kapurthala, moga, patiala, sas nagar, tarn taran"
9/26/18,https://www.tribuneindia.com/news/punjab/punjab-farmer-swept-away-to-pak-body-found/659121.html,"gs paul tribune news service amritsar, september 26  a 53-year-old farmer from a border village in this district died after he accidentally fell into the ravi on tuesday and swept away towards  pakistan",agri,2,8,3,0,13,amritsar
9/22/18,https://www.tribuneindia.com/news/punjab/widespread-rain-in-punjab-haryana-may-damage-paddy-crop/657125.html,"chandigarh, september 22   widespread rain across punjab, haryana and chandigarh on saturday brought misery to farmers as the untimely showers have affected the standing paddy crop in the agrarian states",agri,1,28,11,0,40,"fatehgarh sahib, sas nagar"
9/11/18,https://www.tribuneindia.com/news/punjab/punjab-cotton-growers-foresee-higher-price-bumper-harvest/650737.html,"archit watts tribune news service muktsar, september 10  punjab cotton farmers are all set for bumper yield this season with a significant jump in price realisation, which is expected to be much higher than the government-fixed minimum support price (msp) of rs 5,150 per quintal",agri,0,41,4,2,47,"barnala, bathinda, faridkot, fazilka, mansa, sangrur, sri muktsar sahib"
9/11/18,https://www.tribuneindia.com/news/punjab/punjab-cotton-growers-foresee-higher-price-bumper-harvest/650737.html," they have already started getting a price of rs 5,830 per quintal as was seen in the abohar subdivision of fazilka district last week",agri,0,41,4,2,47,"barnala, bathinda, faridkot, fazilka, mansa, sangrur, sri muktsar sahib"
9/11/18,https://www.tribuneindia.com/news/punjab/punjab-cotton-growers-foresee-higher-price-bumper-harvest/650737.html,"the gain is almost 30 per cent more than the rs 4,510 per quintal price they fetched for the same crop last year, said sources in the market committee",agri,0,41,4,2,47,"barnala, bathinda, faridkot, fazilka, mansa, sangrur, sri muktsar sahib"
9/11/18,https://www.tribuneindia.com/news/punjab/punjab-cotton-growers-foresee-higher-price-bumper-harvest/650737.html,"an expert, satish dhingra, predicts that the price would touch more than rs 6,000 per quintal in next few days",agri,0,41,4,2,47,"barnala, bathinda, faridkot, fazilka, mansa, sangrur, sri muktsar sahib"
9/11/18,https://www.tribuneindia.com/news/punjab/punjab-cotton-growers-foresee-higher-price-bumper-harvest/650737.html, agriculture department officials are expecting the average yield to remain 780 kg lint per hectare,agri,0,41,4,2,47,"barnala, bathinda, faridkot, fazilka, mansa, sangrur, sri muktsar sahib"
9/11/18,https://www.tribuneindia.com/news/punjab/punjab-cotton-growers-foresee-higher-price-bumper-harvest/650737.html,"however, in 2015, the whitefly attack on the growing crop had decreased the yield to 197 kg lint per hectare",agri,0,41,4,2,47,"barnala, bathinda, faridkot, fazilka, mansa, sangrur, sri muktsar sahib"
9/11/18,https://www.tribuneindia.com/news/punjab/punjab-cotton-growers-foresee-higher-price-bumper-harvest/650737.html,"some farmers recently sold raw cotton with seeds at rs 5,400 per quintal",agri,0,41,4,2,47,"barnala, bathinda, faridkot, fazilka, mansa, sangrur, sri muktsar sahib"
9/11/18,https://www.tribuneindia.com/news/punjab/punjab-cotton-growers-foresee-higher-price-bumper-harvest/650737.html,"notably, the msp of the cotton crop (medium staple) has also increased this year from rs 4,020 to rs 5,150 per quintal",agri,0,41,4,2,47,"barnala, bathinda, faridkot, fazilka, mansa, sangrur, sri muktsar sahib"
4/20/18,https://www.tribuneindia.com/news/punjab/farmers-seek-relief-for-crop-damage/576802.html,"tribune news servicemoga, april 19 farmers have urged the state government to grant adequate compensation to them against losses to their wheat crop at the time of harvesting because of intermittent rain followed by hailstorms that lashed the region for the last few days",agri,4,36,15,2,57,"amritsar, faridkot, gurdaspur, moga, patiala, sangrur"
4/20/18,https://www.tribuneindia.com/news/punjab/farmers-seek-relief-for-crop-damage/576802.html,"sukhdev singh kokri, general secretary, bku (ekta), claimed that thousands of farmers in the state had suffered losses due to rain and fires",agri,4,36,15,2,57,"amritsar, faridkot, gurdaspur, moga, patiala, sangrur"
4/20/18,https://www.tribuneindia.com/news/punjab/farmers-seek-relief-for-crop-damage/576802.html,"ush({ });the farm union has claimed that more than 1,000 acres of wheat had already been damaged in fire incidents across the state and reports of such incidents were still coming daily",agri,4,36,15,2,57,"amritsar, faridkot, gurdaspur, moga, patiala, sangrur"
4/20/18,https://www.tribuneindia.com/news/punjab/farmers-seek-relief-for-crop-damage/576802.html,"however, officials of the agriculture department said the overall damage to wheat due to rain and hailstorm was limited in moga, faridkot and patiala districts with on the whole not more than 2 per cent losses",agri,4,36,15,2,57,"amritsar, faridkot, gurdaspur, moga, patiala, sangrur"
9/14/17,https://www.tribuneindia.com/news/punjab/dera-episode-casts-shadow-on-cotton-belt/466747.html," in a double whammy for farmers of punjab‚Äôs sprawling cotton belt spread over eight districts ‚Äî bathinda, mansa, muktsar, ferozepur, sangrur, barnala, faridkot and moga, the region has been lashed by heavy rain, causing huge losses",agri,2,21,8,1,32,"barnala, bathinda, faridkot, ferozepur, mansa, moga, sangrur, sri muktsar sahib"
9/14/17,https://www.tribuneindia.com/news/punjab/dera-episode-casts-shadow-on-cotton-belt/466747.html,"ush({ });  crop loss in the entire cotton belt has been pegged at over 7,000 acres even as the punjab agriculture department is still assessing the damage",agri,2,21,8,1,32,"barnala, bathinda, faridkot, ferozepur, mansa, moga, sangrur, sri muktsar sahib"
9/14/17,https://www.tribuneindia.com/news/punjab/dera-episode-casts-shadow-on-cotton-belt/466747.html,"in the past, they have been getting rs 500-600 per acre apart from add-ons like wheat flour, tea, milk, ‚Äòfaraata‚Äô fans and accommodation",agri,2,21,8,1,32,"barnala, bathinda, faridkot, ferozepur, mansa, moga, sangrur, sri muktsar sahib"
7/19/17,https://www.tribuneindia.com/news/punjab/rain-ruins-cotton-crop-on-8-000-acres-in-mansa/438801.html,"rain ruins cotton crop on 8,000 acres in mansa",agri,0,46,18,1,65,"barnala, bathinda, mansa"
7/19/17,https://www.tribuneindia.com/news/punjab/rain-ruins-cotton-crop-on-8-000-acres-in-mansa/438801.html,"varinder singh tribune news service bathinda/mansa, july 18 crop on over 9,000 acres has been devastated due to excessive rainfall in the cotton belt of the state over the last fortnight",agri,0,46,18,1,65,"barnala, bathinda, mansa"
7/19/17,https://www.tribuneindia.com/news/punjab/rain-ruins-cotton-crop-on-8-000-acres-in-mansa/438801.html,"the maximum damage has been reported from mansa district where cotton crop on over 8,000 acres has been ruined",agri,0,46,18,1,65,"barnala, bathinda, mansa"
7/19/17,https://www.tribuneindia.com/news/punjab/rain-ruins-cotton-crop-on-8-000-acres-in-mansa/438801.html,"experts said the maximum damage was caused by heavy rainfall in jhunir and mansa blocks of mansa district where more than 8,000 acres of standing cotton crop was submerged and had to be ploughed by farmers",agri,0,46,18,1,65,"barnala, bathinda, mansa"
7/19/17,https://www.tribuneindia.com/news/punjab/rain-ruins-cotton-crop-on-8-000-acres-in-mansa/438801.html,"in sehna, mahalkalan and barnala blocks of barnala district, 670 acres have been affected while about 200 acres of cotton crop was damaged in bathinda district",agri,0,46,18,1,65,"barnala, bathinda, mansa"
6/30/17,https://www.tribuneindia.com/news/punjab/showers-bring-cheer-to-farmers-orchardists/429521.html,"varinder singh tribune news service bathinda, june 29 moderate to heavy rainfall across the state has brought cheer to paddy farmers, orchardists and vegetable growers",agri,1,34,3,0,38,"amritsar, barnala, bathinda, fatehgarh sahib, gurdaspur, hoshiarpur, jalandhar, ludhiana, mansa, moga, pathankot, patiala, sangrur, sas nagar, sbs nagar"
6/30/17,https://www.tribuneindia.com/news/punjab/showers-bring-cheer-to-farmers-orchardists/429521.html,"the rain at this juncture ‚Äî when the day temperature hovered between 42 and 45 degree celsius coupled with high humidity ‚Äì besides bringing respite from scorching heat for people in the region, will prove beneficial for paddy and basmati and fruit crops like mango, litchi, pear etc",agri,1,34,3,0,38,"amritsar, barnala, bathinda, fatehgarh sahib, gurdaspur, hoshiarpur, jalandhar, ludhiana, mansa, moga, pathankot, patiala, sangrur, sas nagar, sbs nagar"
6/30/17,https://www.tribuneindia.com/news/punjab/showers-bring-cheer-to-farmers-orchardists/429521.html,"‚Äúrainfall in the range of 40-60 mm is likely to occur at isolated places in parts of patiala, sangrur, mansa, fatehgarh sahib, sas nagar, nawanshahr, barnala, ludhiana, ropar and parts of jalandhar, moga and bathinda districts in the next 48 hours,‚Äù said dr lakhbir kaur dhaliwal, director, school of climate change and agrometeorology of punjab agriculture university, ludhiana",agri,1,34,3,0,38,"amritsar, barnala, bathinda, fatehgarh sahib, gurdaspur, hoshiarpur, jalandhar, ludhiana, mansa, moga, pathankot, patiala, sangrur, sas nagar, sbs nagar"
6/13/17,https://www.tribuneindia.com/news/punjab/rain-fury-3-farmers-die-canal-breaches-submerge-cotton/421481.html,"rain fury: 3 farmers die, canal breaches submerge cotton",agri,5,30,13,0,48,"fazilka, sas nagar"
6/13/17,https://www.tribuneindia.com/news/punjab/rain-fury-3-farmers-die-canal-breaches-submerge-cotton/421481.html," three farmers ‚Äî sardara ram (40) of pallu, hans raj jat (55) of lakha hakam and atma singh (51) of sagarwala ‚Äî died as walls collapsed in respective areas after incessant rain yesterday",agri,5,30,13,0,48,"fazilka, sas nagar"
6/13/17,https://www.tribuneindia.com/news/punjab/rain-fury-3-farmers-die-canal-breaches-submerge-cotton/421481.html, at least 95 sheep were killed as 30-ft wall in a cattle shed owned by liaquat ali collapsed in the srikesarisinghpur segment of sriganganagar,agri,5,30,13,0,48,"fazilka, sas nagar"
6/13/17,https://www.tribuneindia.com/news/punjab/rain-fury-3-farmers-die-canal-breaches-submerge-cotton/421481.html,ush({ });  a 30-ft-wide breach in the panjawa minor (sub canal) near choohariwala dhanna village on the abohar-fazilka road submerged cotton crop spread over 60 acres,agri,5,30,13,0,48,"fazilka, sas nagar"
6/13/17,https://www.tribuneindia.com/news/punjab/rain-fury-3-farmers-die-canal-breaches-submerge-cotton/421481.html," in neighbouring sriganganagar, breaches in at least eight canals, including sangeeta distributary, karniji distributary, sameja canal and nd minor, submerged cotton and other seasonal crops on 2,000 bighas, an official survey indicated",agri,5,30,13,0,48,"fazilka, sas nagar"
6/13/17,https://www.tribuneindia.com/news/punjab/rain-fury-3-farmers-die-canal-breaches-submerge-cotton/421481.html," 130 acres inundated in fazilka  fazilka: saplings of paddy, maize, moong and vegetables on over 130 acres in mauzam village have been damaged due to canal breach that has remained unplugged for two consecutive days",agri,5,30,13,0,48,"fazilka, sas nagar"
4/6/17,https://www.tribuneindia.com/news/community/heavy-rain-flattens-wheat-crop-in-sangrur/387732.html," as per its preliminary report, standing crop has suffered damage between 20 and 25 per cent at balial and retgarh villages and 10 per cent at bhattiwal village",agri,2,16,13,0,31,sangrur
4/5/17,https://www.tribuneindia.com/news/community/rain-forecast-worries-farmers/387240.html,"sanjeev singh bariana tribune news service chandigarh, april 4  inclement weather with drizzling in different parts of the region today and prediction of showers for tomorrow has left farmers worried",agri,2,16,3,0,21,"amritsar, bathinda, hoshiarpur, patiala"
3/16/17,https://www.tribuneindia.com/news/community/rain-hail-hit-crops-over-11-500-acres-in-barnala/377668.html,"rain, hail hit crops over 11,500 acres in barnala",agri,5,49,22,3,79,"barnala, sangrur"
3/16/17,https://www.tribuneindia.com/news/community/rain-hail-hit-crops-over-11-500-acres-in-barnala/377668.html,"parvesh sharma tribune news service sangrur, march 15  intermittent rain and hailstorm three days ago have damaged standing crops over 11,500 acres in barnala district",agri,5,49,22,3,79,"barnala, sangrur"
3/16/17,https://www.tribuneindia.com/news/community/rain-hail-hit-crops-over-11-500-acres-in-barnala/377668.html," as per the figures compiled by various teams of the agriculture department from the district, hailstorm and heavy rain have damaged standing crops over 11,500 acres out of which 10,879 acres are of wheat",agri,5,49,22,3,79,"barnala, sangrur"
3/16/17,https://www.tribuneindia.com/news/community/rain-hail-hit-crops-over-11-500-acres-in-barnala/377668.html, standing fodder over 530 acres have suffered damages between 75 to 90 per cent while the remaining acres are of various vegetables,agri,5,49,22,3,79,"barnala, sangrur"
3/16/17,https://www.tribuneindia.com/news/community/rain-hail-hit-crops-over-11-500-acres-in-barnala/377668.html," karnail singh, chief agriculture officer, barnala, said they had detected damage to standing crops over 11,500 acres during their assessment and sent the report to the senior authorities",agri,5,49,22,3,79,"barnala, sangrur"
3/10/17,https://www.tribuneindia.com/news/community/farmers-hit-as-rain-flattens-wheat-crop/375260.html,"archit watts tribune news service muktsar, march 9 the recent rain and strong winds in the district are giving anxious moments to farmers as the standing wheat crop has flattened at several places",agri,0,68,21,1,90,"bathinda, faridkot, moga, sri muktsar sahib"
3/10/17,https://www.tribuneindia.com/news/community/farmers-hit-as-rain-flattens-wheat-crop/375260.html,‚Äúthe rain and winds will reduce the yield by 2-3 quintal per acre,agri,0,68,21,1,90,"bathinda, faridkot, moga, sri muktsar sahib"
3/10/17,https://www.tribuneindia.com/news/community/farmers-hit-as-rain-flattens-wheat-crop/375260.html," the meteorological department has forecast high possibility of rain and thundershowers accompanied by high-velocity winds in the next two days in this area, raising fears of damage to wheat and mustard crops",agri,0,68,21,1,90,"bathinda, faridkot, moga, sri muktsar sahib"
7/10/16,https://www.tribuneindia.com/news/community/paddy-on-2-600-acres-submerged/263730.html,"paddy on 2,600 acres submerged",agri,2,27,26,0,55,mansa
7/10/16,https://www.tribuneindia.com/news/community/paddy-on-2-600-acres-submerged/263730.html,"ush({ });paddy on about 2,600 acres in seven villages of the district was submerged after a heavy rain today",agri,2,27,26,0,55,mansa
7/10/16,https://www.tribuneindia.com/news/community/paddy-on-2-600-acres-submerged/263730.html,"kulrian village was the worst hit as the crop on 1,400 acres went under water, followed by beerewala dogra village (600 acres)",agri,2,27,26,0,55,mansa
7/10/16,https://www.tribuneindia.com/news/community/paddy-on-2-600-acres-submerged/263730.html,"sukhdev singh, husband of beerewala dogra sarpanch harjeet kaur, said, ‚Äúif the water is not drained out in 10 days, the farmers will not be able to sow even the next crop, wheat",agri,2,27,26,0,55,mansa
7/3/16,https://www.tribuneindia.com/news/community/heavy-rainfall-brings-cheer-to-farmers/260397.html,"ush({ });heavy rain lashed moga, ludhiana, barnala, patiala and parts of sangrur district in the malwa belt in the past 24 hours, bringing cheer to farmers",agri,0,28,5,0,33,"barnala, ludhiana, moga, patiala, sangrur"
7/3/16,https://www.tribuneindia.com/news/community/heavy-rainfall-brings-cheer-to-farmers/260397.html,a farmer of the nearby ghal kalan village alleged that the power board was not supplying continuous eight-hour supply for irrigation,agri,0,28,5,0,33,"barnala, ludhiana, moga, patiala, sangrur"
3/15/16,https://www.tribuneindia.com/news/community/bku-for-special-girdawari/209169.html,"moga, march 14  the bhartiya kisan union (ekta) has asked the state government to order a special girdawari for assessing crop loss caused by heavy rain and hailstorm in the state in the past few days",agri,2,23,9,1,35,moga
3/15/16,https://www.tribuneindia.com/news/community/bku-for-special-girdawari/209169.html," sukhdev singh kokri, general secretary of the farmers' union, said the government must also give minimum compensation of rs 40,000 per acre for heavy crop loss (75 to 100 per cent) to the affected farmers",agri,2,23,9,1,35,moga
3/15/16,https://www.tribuneindia.com/news/community/central-govt-seeks-report-from-hailstorm-hit-states/209168.html,"new delhi, march 14  the central government today sought reports from states on crops damaged due to heavy rain and hailstorm in parts of northern india, hours after congress vice-president rahul gandhi demanded compensation for the affected farmers",agri,1,24,15,2,42,punjab
9/23/15,https://www.tribuneindia.com/news/punjab/as-harvesting-time-nears-it-s-raining-trouble-for-farmers/136620.html,"perneet singh tribune news service amritsar, september 22  with a heavy spell of shower lashing the region throughout the day, the woes of the farming community are set to multiply as their standing basmati and paddy crop, which is ready for harvesting, may get severely damaged",agri,4,68,16,1,89,"amritsar, tarn taran"
9/23/15,https://www.tribuneindia.com/news/punjab/as-harvesting-time-nears-it-s-raining-trouble-for-farmers/136620.html," talking to the tribune, dilbagh singh, a farmer from lalu ghuman village in tarn taran, said heavy rain had led to waterlogging in his fields where he had grown basmati 1509",agri,4,68,16,1,89,"amritsar, tarn taran"
9/23/15,https://www.tribuneindia.com/news/punjab/as-harvesting-time-nears-it-s-raining-trouble-for-farmers/136620.html,"already basmati‚Äôs 1509 variety is fetching one-third of the price as compared to last year,‚Äù he rued",agri,4,68,16,1,89,"amritsar, tarn taran"
9/23/15,https://www.tribuneindia.com/news/punjab/as-harvesting-time-nears-it-s-raining-trouble-for-farmers/136620.html,"the farmers who had taken land on lease were bearing the brunt as they would find it difficult to clear their dues, leave alone pocketing some returns, he added",agri,4,68,16,1,89,"amritsar, tarn taran"
9/23/15,https://www.tribuneindia.com/news/punjab/as-harvesting-time-nears-it-s-raining-trouble-for-farmers/136620.html, jamhuri kisan sabha chief satnam singh ajnala said the crop in the low-lying area had been badly hit and there were reports of about 20 per cent loss till now,agri,4,68,16,1,89,"amritsar, tarn taran"
9/23/15,https://www.tribuneindia.com/news/punjab/rain-storm-leave-10-hurt-in-moga/136603.html,"kulwinder sandhu tribune news service moga, september 22  heavy rain and storms flattened paddy crop in the dharamkot sub-division of the district",agri,5,13,35,1,54,moga
9/23/15,https://www.tribuneindia.com/news/punjab/rain-storm-leave-10-hurt-in-moga/136603.html,major singh sarpanch of bhoenpur village said over 80 per cent of the paddy crop had been damaged in his village,agri,5,13,35,1,54,moga
9/2/15,https://www.tribuneindia.com/news/punjab/with-sutlej-swelling-sand-mafia-shifts-to-village-ponds/127647.html, so its members have set their eyes on common village ponds and have even convinced farmers to allow them to dig sand from their lands way beyond the permissible limit of 4 ft,agri,6,11,18,0,35,"jalandhar, kapurthala"
8/18/15,https://www.tribuneindia.com/news/community/crops-on-2-000-acres-damaged/120993.html,"crops on 2,000 acres damaged",agri,4,56,22,1,83,punjab
8/18/15,https://www.tribuneindia.com/news/community/crops-on-2-000-acres-damaged/120993.html,"arun sharma tribune news service ropar, august 17  an old breach in lodhipur bundh has cost the farmers in this area dear",agri,4,56,22,1,83,punjab
8/18/15,https://www.tribuneindia.com/news/community/crops-on-2-000-acres-damaged/120993.html,"the sutlej water which has been rising since july 17 has destroyed standing crops on more than 2,000 acres in the area",agri,4,56,22,1,83,punjab
8/18/15,https://www.tribuneindia.com/news/community/crops-on-2-000-acres-damaged/120993.html," a survey by the agriculture department revealed that paddy, maize, fodder and poplar plantation in 1,990 acres in villages of anandpur sahib block were completely destroyed after remaining inundated for more than a month",agri,4,56,22,1,83,punjab
8/18/15,https://www.tribuneindia.com/news/community/crops-on-2-000-acres-damaged/120993.html,ush({ });  paddy crop over 637 acres and maize over 917 acres was damaged completely,agri,4,56,22,1,83,punjab
8/18/15,https://www.tribuneindia.com/news/community/crops-on-2-000-acres-damaged/120993.html,fodder on 375 acres and poplar plantation on 61 acres also suffered 100 per cent loss in these villages,agri,4,56,22,1,83,punjab
8/18/15,https://www.tribuneindia.com/news/community/crops-on-2-000-acres-damaged/120993.html," the maximum loss was reported at lodhipur village where not even a single straw was left in paddy fields over 250 acres, maize 40 acres and fodder 20 acres",agri,4,56,22,1,83,punjab
8/18/15,https://www.tribuneindia.com/news/community/crops-on-2-000-acres-damaged/120993.html,anandpur sahib sdm amarjit bains claimed the sutlej water affected crops on 180 acres,agri,4,56,22,1,83,punjab
8/17/15,https://www.tribuneindia.com/news/punjab/bhakra-floodgates-to-be-re-opened/120192.html,"crops on 25,000 acres submerged  jalandhar: farm land spread across nearly 25,000 acres along the beas in sultanpur lodhi got submerged on friday after a breach in the advance bundh there",agri,1,15,10,0,26,"amritsar, jalandhar"
8/17/15,https://www.tribuneindia.com/news/punjab/bhakra-floodgates-to-be-re-opened/120192.html,"the breach took place around 11 am and within minutes, its size increased to about 250 ft, unleashing heavy damage spl girdawari sought  amritsar: punjab congress general secretary harminder singh gill has demanded that the state government should order special girdawari to assess the loss of crops on 10,000 acres downstream of the confluence of the beas and satluj in hathar area",agri,1,15,10,0,26,"amritsar, jalandhar"
5/25/15,https://www.tribuneindia.com/news/punjab/to-stem-rot-wheat-being-refilled-into-new-gunny-bags-in-bathinda/84960.html,"bharat khanna tribune news service bathinda, may 24  more than 20,000 bags of wheat are rotting in the grain markets of pungrain in some villages of bathinda district due to rain and the delay in lifting of wheat bags",agri,0,29,8,1,38,bathinda
5/25/15,https://www.tribuneindia.com/news/punjab/to-stem-rot-wheat-being-refilled-into-new-gunny-bags-in-bathinda/84960.html," similarly, around 1,400 bags of punsup in bhupali grain market of rampura had also met with the same condition a few days ago, but arhtiyas had reportedly got the bags refilled with wheat grains",agri,0,29,8,1,38,bathinda
5/25/15,https://www.tribuneindia.com/news/punjab/to-stem-rot-wheat-being-refilled-into-new-gunny-bags-in-bathinda/84960.html,"ush({ });  of the 45,000 wheat bags lying in the grain market at puhla village, the tribune team found that labourers were in the process of changing thousands of gunny bags",agri,0,29,8,1,38,bathinda
5/25/15,https://www.tribuneindia.com/news/punjab/to-stem-rot-wheat-being-refilled-into-new-gunny-bags-in-bathinda/84960.html,there is a loss of around 2 kg of wheat from each bag in which the rot has set in,agri,0,29,8,1,38,bathinda
5/25/15,https://www.tribuneindia.com/news/punjab/to-stem-rot-wheat-being-refilled-into-new-gunny-bags-in-bathinda/84960.html,not much wheat has gone bad,agri,0,29,8,1,38,bathinda
4/2/15,https://www.tribuneindia.com/news/community/will-relax-norms-for-wheat-procurement-paswan/61712.html,"tribune news servicechandigarh, april 1the state government today said union food and supply minister ram bilas paswan had assured that moisture and colour norms for procurement of wheat would be relaxed keeping in view the unseasonal rain over the past few days",agri,1,9,2,0,12,punjab
3/31/15,https://www.tribuneindia.com/news/community/farmers-seek-crop-loan-waiver/60801.html,"our correspondentabohar, march 30as hailstorm preceded by heavy rain lashed hanumangarh district last night for about 15 minutes, hundreds of farmers on monday organised protest and demanded that loans be waived off besides providing other relief measures",agri,0,30,8,3,41,punjab
3/31/15,https://www.tribuneindia.com/news/community/farmers-seek-crop-loan-waiver/60801.html,"the memorandum said different companies had collected rs 300 crore as premium under the state-supported crop insurance scheme, but not even a rupee was paid as claim money to the affected farmers",agri,0,30,8,3,41,punjab
3/31/15,https://www.tribuneindia.com/news/community/farmers-seek-crop-loan-waiver/60801.html,"the farmers resented that no efforts were made to tackle waterlogging menace and demanded rs 20,000 as compensation for each bigha of the affected land",agri,0,30,8,3,41,punjab
3/31/15,https://www.tribuneindia.com/news/community/farmers-seek-crop-loan-waiver/60801.html,they warned that protest would now be organised on april 10 in which farmers from all the segments will participate,agri,0,30,8,3,41,punjab
3/17/15,https://www.tribuneindia.com/news/community/6-killed-in-abohar-sriganganagar/54631.html," thick carpet of hail covered the sriganganagar-srikaranpur road near mirzewala where at least 70 per cent of the wheat and mustard crop has been damaged, lal chand, sarpanch, told kailash chander sharma, sub divisional magistrate, who conducted a survey in the area today",agri,9,12,11,0,32,sas nagar
3/4/15,https://www.tribuneindia.com/news/community/woman-dies-in-roof-collapse/49459.html,"our correspondent  abohar, march 3 rainwater submerged hundreds of acres of agricultural land in several villages and wards of the town and neighbouring areas of sriganganagar and hanumangarh",agri,5,23,16,0,44,sas nagar
3/4/15,https://www.tribuneindia.com/news/community/woman-dies-in-roof-collapse/49459.html,"none of the officials has visited the affected area where wheat, green fodder and vegetable crops were submerged",agri,5,23,16,0,44,sas nagar
3/4/15,https://www.tribuneindia.com/news/community/woman-dies-in-roof-collapse/49459.html,"a breach in ramsara sub-canal, 8 km from here, has inundated crops in about 100 acres",agri,5,23,16,0,44,sas nagar
3/4/15,https://www.tribuneindia.com/news/community/woman-dies-in-roof-collapse/49459.html,"this happened for the third time in less than four months, farmers alleged",agri,5,23,16,0,44,sas nagar
3/2/15,https://www.tribuneindia.com/news/punjab/rain-high-speed-winds-damage-crops-in-malwa/48704.html,"kulwinder sandhu tribune news service moga, march 1  it is feared that widespread rain accompanied by high-velocity winds may have caused damage to the wheat crop in parts of moga, ferozepur, fazilka, faridkot, muktsar and barnala districts in the malwa belt",agri,0,33,21,0,54,"barnala, faridkot, fazilka, ferozepur, moga, sri muktsar sahib"
3/2/15,https://www.tribuneindia.com/news/punjab/rain-high-speed-winds-damage-crops-in-malwa/48704.html," two weeks ago, a hailstorm had caused damage to the wheat crop",agri,0,33,21,0,54,"barnala, faridkot, fazilka, ferozepur, moga, sri muktsar sahib"
12/14/14,https://www.tribuneindia.com/news/community/heavy-rain-lashes-chandigarh-parts-of-punjab-haryana/18047.html,"chandigarh, december 14   ending the prolonged dry spell, many parts of punjab and haryana received moderate to heavy rainfall for the second day today, which is likely to bring relief to the farmers",agri,1,8,3,0,12,"amritsar, jalandhar, ludhiana, patiala, sas nagar"
8/23/10,https://www.dainiktribuneonline.com/2010/08/‡§ò‡§ó‡•ç‡§ó‡§∞-‡§Æ‡•á‡§Ç-‡§ú‡§≤-‡§∏‡•ç‡§§‡§∞-‡§¨‡§¢‡§©‡•á-‡§∏‡•á-‡§ï/,sangrur 22 august heavy rain in northern india warning from the meteorological department and the rise of tangri river in haryana has put the farmers in the villages near ghaggar river in danger of flooding again,agri,2,9,4,2,17,sangrur
8/23/10,https://www.dainiktribuneonline.com/2010/08/‡§ò‡§ó‡•ç‡§ó‡§∞-‡§Æ‡•á‡§Ç-‡§ú‡§≤-‡§∏‡•ç‡§§‡§∞-‡§¨‡§¢‡§©‡•á-‡§∏‡•á-‡§ï/,t has increased because once he has suffered the floods last month and his expenditure of thousands of rupees has come to restore the paddy crop,agri,2,9,4,2,17,sangrur
9/25/10,https://www.dainiktribuneonline.com/2010/09/%e0%a4%ac%e0%a4%be%e0%a4%a2%e0%a4%bc-%e0%a4%aa%e0%a5%8d%e0%a4%b0%e0%a4%ad%e0%a4%be%e0%a4%b5%e0%a4%bf%e0%a4%a4-%e0%a4%95%e0%a4%bf%e0%a4%b8%e0%a4%be%e0%a4%a8%e0%a5%8b%e0%a4%82-%e0%a4%95%e0%a5%8b-27/,he officials will visit the respective villages from 10 am to 5 pm on september 27 and the rest farmers can get compensation amount,agri,0,5,6,3,14,punjab
8/21/11,https://www.dainiktribuneonline.com/2011/08/40-%e0%a4%b9%e0%a4%9c%e0%a4%be%e0%a4%b0-%e0%a4%8f%e0%a4%95%e0%a4%a1%e0%a4%bc-%e0%a4%ad%e0%a5%82%e0%a4%ae%e0%a4%bf-%e0%a4%ac%e0%a4%be%e0%a4%a2%e0%a4%bc-%e0%a4%95%e0%a5%80-%e0%a4%9a%e0%a4%aa%e0%a5%87/,he farmers have been ignored for over four decades due to the floods they have been brought to the brink of ruin,agri,6,34,28,0,68,"kapurthala, tarn taran"
8/21/11,https://www.dainiktribuneonline.com/2011/08/40-%e0%a4%b9%e0%a4%9c%e0%a4%be%e0%a4%b0-%e0%a4%8f%e0%a4%95%e0%a4%a1%e0%a4%bc-%e0%a4%ad%e0%a5%82%e0%a4%ae%e0%a4%bf-%e0%a4%ac%e0%a4%be%e0%a4%a2%e0%a4%bc-%e0%a4%95%e0%a5%80-%e0%a4%9a%e0%a4%aa%e0%a5%87/,ue to the continuous rains flooding the darya beas the manger has disturbed the condition of the farmers and floods in the district have damaged 40 thousand acres of crops with water running up to 8 feet and fresh water level in darya beas from the fresh water level,agri,6,34,28,0,68,"kapurthala, tarn taran"
8/21/11,https://www.dainiktribuneonline.com/2011/08/40-%e0%a4%b9%e0%a4%9c%e0%a4%be%e0%a4%b0-%e0%a4%8f%e0%a4%95%e0%a4%a1%e0%a4%bc-%e0%a4%ad%e0%a5%82%e0%a4%ae%e0%a4%bf-%e0%a4%ac%e0%a4%be%e0%a4%a2%e0%a4%bc-%e0%a4%95%e0%a5%80-%e0%a4%9a%e0%a4%aa%e0%a5%87/,n order to know it was found that water is flowing above one lakh cusecs in darya beas about 25 thousand acres in dozens of villages including baupur sangra village of darya beas,agri,6,34,28,0,68,"kapurthala, tarn taran"
8/21/11,https://www.dainiktribuneonline.com/2011/08/40-%e0%a4%b9%e0%a4%9c%e0%a4%be%e0%a4%b0-%e0%a4%8f%e0%a4%95%e0%a4%a1%e0%a4%bc-%e0%a4%ad%e0%a5%82%e0%a4%ae%e0%a4%bf-%e0%a4%ac%e0%a4%be%e0%a4%a2%e0%a4%bc-%e0%a4%95%e0%a5%80-%e0%a4%9a%e0%a4%aa%e0%a5%87/,he land has been in the grip of beas boom; the same crop has been damaged in 15 thousand acres in dozens of villages of begowalanadaladhilwa hyderia beas rapid rise in water level is alarming and indicates continuous release of water from pong dam,agri,6,34,28,0,68,"kapurthala, tarn taran"
8/21/11,https://www.dainiktribuneonline.com/2011/08/40-%e0%a4%b9%e0%a4%9c%e0%a4%be%e0%a4%b0-%e0%a4%8f%e0%a4%95%e0%a4%a1%e0%a4%bc-%e0%a4%ad%e0%a5%82%e0%a4%ae%e0%a4%bf-%e0%a4%ac%e0%a4%be%e0%a4%a2%e0%a4%bc-%e0%a4%95%e0%a5%80-%e0%a4%9a%e0%a4%aa%e0%a5%87/,he main reason for the flooding of the dariya bayas is that 25 thousand acres of crop area has been destroyed within the sultanpur lodhi mand dhussi dam in flood water since four days,agri,6,34,28,0,68,"kapurthala, tarn taran"
8/21/11,https://www.dainiktribuneonline.com/2011/08/40-%e0%a4%b9%e0%a4%9c%e0%a4%be%e0%a4%b0-%e0%a4%8f%e0%a4%95%e0%a4%a1%e0%a4%bc-%e0%a4%ad%e0%a5%82%e0%a4%ae%e0%a4%bf-%e0%a4%ac%e0%a4%be%e0%a4%a2%e0%a4%bc-%e0%a4%95%e0%a5%80-%e0%a4%9a%e0%a4%aa%e0%a5%87/,the crop of submerged paddy has been destroyed village chuldha sarpanch buta singh sukhwinder singh chitrapur daljit singh sarpanch channa sher singh said that the crops within dam no 2 which was tied in the year 2000 have taken water tomb,agri,6,34,28,0,68,"kapurthala, tarn taran"
8/21/11,https://www.dainiktribuneonline.com/2011/08/40-%e0%a4%b9%e0%a4%9c%e0%a4%be%e0%a4%b0-%e0%a4%8f%e0%a4%95%e0%a4%a1%e0%a4%bc-%e0%a4%ad%e0%a5%82%e0%a4%ae%e0%a4%bf-%e0%a4%ac%e0%a4%be%e0%a4%a2%e0%a4%bc-%e0%a4%95%e0%a5%80-%e0%a4%9a%e0%a4%aa%e0%a5%87/,aali kalan sarpanch kashmir singh ahli khurd sarpanch harbans singh etc says that the flood has damaged the crop of 25 thousand acres of land in dozens of villages; sarpanch salwinder singhsarpanch of village mandpur baupur kuldeep simhanambardar surinder of sangra village singh etc told that the water level of darya beas is constantly increasing and the clouds of danger are hovering over his head.,agri,6,34,28,0,68,"kapurthala, tarn taran"
8/24/11,https://www.dainiktribuneonline.com/2011/08/%e0%a4%b8%e0%a4%a4%e0%a4%b2%e0%a5%81%e0%a4%9c-%e0%a4%a4%e0%a4%a5%e0%a4%be-%e0%a4%ac%e0%a5%8d%e0%a4%af%e0%a4%be%e0%a4%b8-%e0%a4%a8%e0%a5%87-%e0%a4%a4%e0%a4%ac%e0%a4%be%e0%a4%b9%e0%a5%80-%e0%a4%ae/,n the state of satjul and beas in hundreds of villages has penetrated and the paddy crop has been destroyed in thousands of acres due to cracks in dhusi bandh a chaud of chak patti balu bahadur village of sultanpur lodhi,agri,4,7,6,0,17,sas nagar
8/4/13,https://www.dainiktribuneonline.com/2013/08/%e0%a4%ac%e0%a4%be%e0%a4%a2%e0%a4%bc-%e0%a4%b8%e0%a5%87-%e0%a4%ae%e0%a4%82%e0%a4%a1-%e0%a4%95%e0%a5%8d%e0%a4%b7%e0%a5%87%e0%a4%a4%e0%a5%8d%e0%a4%b0-%e0%a4%95%e0%a5%87-19-%e0%a4%97%e0%a4%be%e0%a4%82/,he told that crops of about 19 villages in the tapunuma region have been destroyed by submergence village residence related to bhim kadim bandhu kadim mand bandhu kadim akalpur kishanpur ghadka mand karamuwal sille etc,agri,4,15,19,0,38,"ferozepur, jalandhar, kapurthala"
8/6/13,https://www.dainiktribuneonline.com/2013/08/%e0%a4%ac%e0%a4%be%e0%a4%8a%e0%a4%aa%e0%a5%81%e0%a4%b0-%e0%a4%ae%e0%a5%87%e0%a4%82-%e0%a4%ac%e0%a4%be%e0%a4%a2%e0%a4%bc-%e0%a4%b8%e0%a5%87-%e0%a4%aa%e0%a4%be%e0%a4%82%e0%a4%9a-%e0%a4%b9%e0%a4%9c/,after flooding of fields due to flooding of dariya beas in sultanpur lodhi kapurthala on 6th august despite the decrease in the water level of nis darya beas about 5000 acres of land in about one and a half dozen villages of baupur near the darya waterlogged,agri,4,28,13,0,45,kapurthala
8/6/13,https://www.dainiktribuneonline.com/2013/08/%e0%a4%ac%e0%a4%be%e0%a4%8a%e0%a4%aa%e0%a5%81%e0%a4%b0-%e0%a4%ae%e0%a5%87%e0%a4%82-%e0%a4%ac%e0%a4%be%e0%a4%a2%e0%a4%bc-%e0%a4%b8%e0%a5%87-%e0%a4%aa%e0%a4%be%e0%a4%82%e0%a4%9a-%e0%a4%b9%e0%a4%9c/,here is water mausoleum and various crops of land of about 19 villages whose strong chances of ruin can be expressed,agri,4,28,13,0,45,kapurthala
8/12/13,https://www.dainiktribuneonline.com/2013/08/%e0%a4%ac%e0%a4%be%e0%a4%a2%e0%a4%bc-%e0%a4%b8%e0%a5%87-22-%e0%a4%97%e0%a4%be%e0%a4%82%e0%a4%b5%e0%a5%8b%e0%a4%82-%e0%a4%ae%e0%a5%87%e0%a4%82-%e0%a4%ae%e0%a4%9a%e0%a5%80-%e0%a4%a4%e0%a4%ac%e0%a4%be/,kapurthala aug 12 the water being released from nis pong dam in darya beas has become a disaster for the farmers of the area,agri,9,30,20,1,60,kapurthala
8/12/13,https://www.dainiktribuneonline.com/2013/08/%e0%a4%ac%e0%a4%be%e0%a4%a2%e0%a4%bc-%e0%a4%b8%e0%a5%87-22-%e0%a4%97%e0%a4%be%e0%a4%82%e0%a4%b5%e0%a5%8b%e0%a4%82-%e0%a4%ae%e0%a5%87%e0%a4%82-%e0%a4%ae%e0%a4%9a%e0%a5%80-%e0%a4%a4%e0%a4%ac%e0%a4%be/,he crop of thousands of acres of land in 22 villages has been destroyed due to flooding and rising water level poses a huge threat to the advance,agri,9,30,20,1,60,kapurthala
8/12/13,https://www.dainiktribuneonline.com/2013/08/%e0%a4%ac%e0%a4%be%e0%a4%a2%e0%a4%bc-%e0%a4%b8%e0%a5%87-22-%e0%a4%97%e0%a4%be%e0%a4%82%e0%a4%b5%e0%a5%8b%e0%a4%82-%e0%a4%ae%e0%a5%87%e0%a4%82-%e0%a4%ae%e0%a4%9a%e0%a5%80-%e0%a4%a4%e0%a4%ac%e0%a4%be/,n order to deal with the situation of the state there has been a huge lapse in the past for a long time the result of which is in front of us crops of about 40 thousand acres of land in several villages of mand baupur and sangra areas from subdivision to baja amritpur to ahli kalan to khurd due to the flood water people are getting skin diseases and are receiving complaints of foot rubbing similar situation also for cattle,agri,9,30,20,1,60,kapurthala
8/12/13,https://www.dainiktribuneonline.com/2013/08/%e0%a4%ac%e0%a4%be%e0%a4%a2%e0%a4%bc-%e0%a4%b8%e0%a5%87-22-%e0%a4%97%e0%a4%be%e0%a4%82%e0%a4%b5%e0%a5%8b%e0%a4%82-%e0%a4%ae%e0%a5%87%e0%a4%82-%e0%a4%ae%e0%a4%9a%e0%a5%80-%e0%a4%a4%e0%a4%ac%e0%a4%be/,t is being demanded that the government should take appropriate steps to protect the dam and the affected areas should be provided with 30 boats tarpaul along with food and animal feed and the farmers should be given compensation,agri,9,30,20,1,60,kapurthala
8/26/10,https://www.dainiktribuneonline.com/2010/08/%e0%a4%aa%e0%a4%82%e0%a4%9c%e0%a4%be%e0%a4%ac-%e0%a4%b9%e0%a4%b0%e0%a4%bf%e0%a4%af%e0%a4%be%e0%a4%a3%e0%a4%be-%e0%a4%a6%e0%a4%bf%e0%a4%b2%e0%a5%8d%e0%a4%b2%e0%a5%80-%e0%a4%95%e0%a5%87-%e0%a4%95/,four thousand acres of crop submerged in kapurthala villagers begin to erode along the yamuna river in karnal district 63 thousand ky from bhakra.,agri,2,3,5,0,10,"kapurthala, ludhiana"
5/27/17,https://www.amarujala.com/photo-gallery/chandigarh/flood-in-bathinda-due-to-canal-breaking?pageId=2,as many as 200 houses in sai nagar were flooded by two to three feet due to a 50foot crack in the rajwawa passing behind ganpati colony in bathinda city and several acres of farmers' bg cotton crop was destroyed.,agri,0,7,3,0,10,"bathinda, sas nagar"
8/12/13,https://www.ndtv.com/video/news/news/video-story-286470,water level of sutlej river in fazilka punjab is continuously increasing due to which water has started filling in the villages along the river and about 1200 acres of crop was destroyed is.,agri,0,4,5,0,9,fazilka
9/6/10,https://www.ndtv.com/cities/satluj-floods-dozen-villages-in-punjabs-ropar-430230,but this led to the flooding and several acres of agriculture land was also inundated in ropar some 45 km from here,agri,4,4,11,0,19,punjab
8/22/13,https://timesofindia.indiatimes.com/city/chandigarh/Satluj-continues-to-flood-villages-in-Ferozepur-Fazilka/articleshow/21969055.cms,standing crop in thousands of acres of land has been destroyed we request the administration to offer whatever compensation they can to people whose houses have collapsed said shinder singh,agri,14,32,52,1,99,"fazilka, ferozepur"
8/22/13,https://timesofindia.indiatimes.com/city/chandigarh/Satluj-continues-to-flood-villages-in-Ferozepur-Fazilka/articleshow/21969055.cms,while hundreds of farmers have vacated their homes for safer places many others are reportedly trapped inside their houses surrounded by flood waters,agri,14,32,52,1,99,"fazilka, ferozepur"
8/22/13,https://timesofindia.indiatimes.com/city/chandigarh/Satluj-continues-to-flood-villages-in-Ferozepur-Fazilka/articleshow/21969055.cms,in ferozepur over 50000 acres of farm area has been submerged affecting around 50 villages affected villages like nihale lavera muthianwala jhuge nihangwali gatti rajjoke tindiwala bhakhra gatti kharunj sunder bhatti kaluwala palla megha bandala ruknewala kamalewala behak ratto ke and talli gulam have become cut off from rest of the district sources said,agri,14,32,52,1,99,"fazilka, ferozepur"
8/22/13,https://timesofindia.indiatimes.com/city/chandigarh/Satluj-continues-to-flood-villages-in-Ferozepur-Fazilka/articleshow/21969055.cms,in fazilka district over 15 villages and 20000 acres of land have been affected by floods the villages included maujam dona nanka ghurka and haskalan while mohar jamsher has been completely cut off from the main land several schools in these districts have also been closed due to the floods they said,agri,14,32,52,1,99,"fazilka, ferozepur"
8/22/13,https://timesofindia.indiatimes.com/city/chandigarh/Satluj-continues-to-flood-villages-in-Ferozepur-Fazilka/articleshow/21969055.cms,officials claimed to have arranged 20 boats to provide relief material including fodder for cattle medicines food and other articles to affected people,agri,14,32,52,1,99,"fazilka, ferozepur"
7/14/10,https://www.hindustantimes.com/chandigarh/rescue-work-on-in-flood-hit-mansa/story-m0YJTUQlvf57lbvPDH2hLP.html,Around 200 houses and standing crops on nearly 5000 acres have been damaged in the floods We have made all arrangements to provide packed food and water to the flood victims So far there has been no loss of life due to floods in Mansa he said,agri,5,20,21,0,46,mansa
7/14/10,https://www.hindustantimes.com/chandigarh/rescue-work-on-in-flood-hit-mansa/story-m0YJTUQlvf57lbvPDH2hLP.html,According to official figures crops on 271784 acres have been damaged in districts of Patiala Sangrur Mohali Ludhiana Fatehgarh Sahib Moga and Mansa,agri,5,20,21,0,46,mansa
7/14/10,https://www.hindustantimes.com/chandigarh/rescue-work-on-in-flood-hit-mansa/story-m0YJTUQlvf57lbvPDH2hLP.html,Army officials are working to plug the breaches in Ghaggar river that led to flooding in Sirsa Over 10000 acres of agricultural land submerged in three to four feet water and nearly one dozen villages are affected due to this We hope that situation will be under control by this evening said a senior official of the Sirsa administration here,agri,5,20,21,0,46,mansa
9/25/18, https://www.hindustantimes.com/punjab/flood-threat-looms-in-patiala-as-ghaggar-in-spate/story-YD1VnN3c8eKDBf6IET3zDM.html,he added he said that district epidemiologist dr gurmeet singh has been appointed as the nodal officer of the district control room farmers worried  the incessant showers in the past three days pose threat of excessive damage to the paddy crop which is largely in the last stage of maturation many reports of crop being submerged in kneedeep water and flattening of fields are pouring in from across district ,agri,17,25,25,0,67,"patiala, sangrur"
7/16/10,https://www.hindustantimes.com/india/central-team-to-visit-flood-hit-punjab-on-july-20/story-sLAIRBOObnLfrT0KEOJrgJ.html,egarding loss of crop he said over 325 lakh acres of land have been submerged in the floods in the three districts ,agri,3,9,9,0,21,"bathinda, patiala, sangrur"
7/16/10,https://www.hindustantimes.com/india/central-team-to-visit-flood-hit-punjab-on-july-20/story-sLAIRBOObnLfrT0KEOJrgJ.html,e issued instructions to provide relief to every affected farmer and family within 7 days and asked deputy commissioners to personally monitor relief disbursement ,agri,3,9,9,0,21,"bathinda, patiala, sangrur"
7/29/10,https://www.hindustantimes.com/india/punjab-to-allow-amendments-in-crop-damage-relief-norms/story-WKT3L4Nu2xsMXFnT33qzAJ.html,it was mandatory to amend these instructions in view of the loss caused to a farmer which varied from rs 13000 to rs 28000 per acre read a recent official release about the cabinet decision,agri,0,26,14,0,40,"mansa, patiala"
7/29/10,https://www.hindustantimes.com/india/punjab-to-allow-amendments-in-crop-damage-relief-norms/story-WKT3L4Nu2xsMXFnT33qzAJ.html,ccording to the amended instructions crop damage relief was rs 5000 per acre for losses exceeding 75 per cent rs 3000 per acre for losses between 5075 per cent and rs 2000 per acre for losses between 2550 per cent,agri,0,26,14,0,40,"mansa, patiala"
12/31/15,https://www.hindustantimes.com/punjab/at-last-hope-for-waterlogged-areas-of-southwest-punjab/story-wrmDIUnM6CSLhzRJs9D1GM.html,the state government has procured a rs 50 crore loan from national bank for agriculture research and development for the bistdoab canal and the work of relining has begun,agri,0,1,0,1,2,"amritsar, bathinda, faridkot, ferozepur, gurdaspur, pathankot, sri muktsar sahib, tarn taran"
8/29/19,https://reliefweb.int/node/3279863,the total value of the livestock loss has been pegged at rs 91 lakh,agri,10,11,25,1,47,"ferozepur, sas nagar"
8/29/19,https://reliefweb.int/node/3279863,"uttarakhand in uttarakhand, the number of dead rose to 12, cloudbursts have wreaked havoc in a dozen villages of uttarakhand's uttarkashi district, washing away houses and hectares of agricultural land",agri,10,11,25,1,47,"ferozepur, sas nagar"
8/29/19,https://reliefweb.int/node/3279863,so far evacuated 53 persons & 01 livestock and retrieved 04 dead bodies.,agri,10,11,25,1,47,"ferozepur, sas nagar"
8/20/19,https://reliefweb.int/node/3267743,thousand acres agricultural land and crops have been innundated,agri,18,17,17,5,57,punjab
7/26/18,https://reliefweb.int/node/2716534,"in muzaffarnagar, 3 persons died in rain-related incidents but the rain brought respite to farmers of the parched bundelkhand region",agri,8,3,8,0,19,sas nagar
6/15/18,https://reliefweb.int/node/2656989,"in tripura, the flood situation deteriorated with the rain-fed khowai river inundating fresh areas rendering thousands homeless and damaging roads and crops",agri,9,12,11,0,32,punjab
8/7/17,https://reliefweb.int/node/2159444,"gujarat:  so far teams have rescued 1355 persons, evacuated 7286 persons, 27 livestock and retrieved 11 dead bodies and distributed food- 71193 pkts, water pouches/ bottles-  81150 nos, dry ration ( rice, dal, suger, churaetc -1750 bags,biscuits / namkin- 2225 pkts,  cloth- 1750 nos and blanket- 75 nos",agri,51,6,13,0,70,mansa
8/7/17,https://reliefweb.int/node/2159444,"so far teams have rescued 253 persons, evacuated 1029 persons and retrieved 05 dead bodies and distributed food 1500 pkts, water pouches/ bottles-  25564 nos, dry ration ( rice, dal, suger, churaetc ‚Äì 236 bags, baby food - 244 ctns, milk- 1056 pkts, gur -2205  kgs, tarpoline-  58 nos,  vegetable- 540 kgs and medicines",agri,51,6,13,0,70,mansa
7/27/17,https://reliefweb.int/node/2143594,"as per the information of damage received from these states 508 persons have lost their lives, 24,811 cattle heads have perished, 63,215 houses/ huts have been damaged and about 2.8 lakh hectares of crop area have been reported affected due to heavy rains/ flood/ landslides etc",agri,11,22,44,1,78,punjab
7/27/17,https://reliefweb.int/node/2143594,"assam has faced two waves of floods till 19th july 2017 affecting 29 districts out of 33 districts, resulting in loss of human lives, livestock and large scale damage to the dwelling houses",agri,11,22,44,1,78,punjab
7/27/17,https://reliefweb.int/node/2143594,"as per information received from the state government of assam, about 59430.45 quintal rice, 11142.18 quintal dal, 3541.71 quintal salt, 37249.89 liters m",agri,11,22,44,1,78,punjab
3/22/17,https://reliefweb.int/node/1960219,"‚Äúoverall, the real and tangible benefits of the systems established under the two hydrology projects include people whose lives, homes, and crops are saved due to improved flood forecasting, farmers who benefit from improved irrigation supplies, and children who do not fall ill or worse from drinking contaminated water,‚Äù said halla maher qaddumi, senior water economist at the world bank in new delhi",agri,10,12,11,2,35,punjab
7/18/15,https://reliefweb.int/node/1087711,"in north west, rainfall recorded is 12 % above normal which is good news for farmers.",agri,4,14,17,0,35,sas nagar
9/12/14,https://reliefweb.int/node/691053,"tearfund‚Äôs local partner, the evangelical fellowship of india commission on relief (eficor), will this week distribute food, including rice, wheat and pulses, to 500 of the most vulnerable families who‚Äôve suffered as a result of flooding and landslides",agri,11,8,12,0,31,punjab
9/10/14,https://reliefweb.int/node/690316,flood water has ruined crops stretched across thousands of acres,agri,10,9,18,0,37,sas nagar
9/1/14,https://reliefweb.int/node/688081,"western rajasthan and vidarbha, two of the most water-stressed regions of india known for distress migration and farmer suicides respectively, are staring at a greater crisis if the current trend of deficient rainfall continues",agri,0,28,4,0,32,punjab
9/1/14,https://reliefweb.int/node/688081,"by august 29, kharif crops were sown in 966.25 lakh hectares",agri,0,28,4,0,32,punjab
9/1/14,https://reliefweb.int/node/688081,"at present, seed subsidy is given in the range of rs 1,500-5,000 per quintal under the national food security mission depending on the varieties of seeds to partially compensate farmers for re-sowing crops in drought-declared areas",agri,0,28,4,0,32,punjab
9/1/14,https://reliefweb.int/node/688081,"if a state government declares drought, it has to pay 50 per cent of the relief amount to the farmers before the centre releases its share",agri,0,28,4,0,32,punjab
7/23/12,https://reliefweb.int/node/512568,there has been reduction of around eight million hectares in the crop area sown compared to last year,agri,2,18,6,1,27,punjab
8/24/11,https://reliefweb.int/node/442809,"in view of the rains, several rivers, including yamuna, som, tangri, ghaggar, beas, sutlej and ravi are in spate with villages close to their banks facing a flood-like situation and affecting around 15,000 acres of farm land in punjab and haryana, official sources said here",agri,1,4,10,0,15,"amritsar, fazilka, ferozepur, ludhiana, patiala, sas nagar, tarn taran"
7/29/10,https://reliefweb.int/node/362397,- 67 cattle/livestock have perished,agri,10,6,16,0,32,"mansa, patiala, sangrur, sas nagar"
7/29/10,https://reliefweb.int/node/362397,- 66 cattle/livestock have perished,agri,10,6,16,0,32,"mansa, patiala, sangrur, sas nagar"
7/28/10,https://reliefweb.int/node/362384,- 67 cattle/livestock have perished,agri,10,6,16,0,32,"mansa, patiala, sangrur, sas nagar"
7/28/10,https://reliefweb.int/node/362384,- 58 cattle/livestock have perished,agri,10,6,16,0,32,"mansa, patiala, sangrur, sas nagar"
7/25/10,https://reliefweb.int/node/362192,- 67 cattle/livestock have perished,agri,10,8,16,0,34,"mansa, patiala, sangrur, sas nagar"
7/25/10,https://reliefweb.int/node/362192,- 32 cattle/livestock have perished,agri,10,8,16,0,34,"mansa, patiala, sangrur, sas nagar"
7/24/10,https://reliefweb.int/node/362106,- 32 cattle/livestock have perished,agri,10,5,17,0,32,"mansa, patiala, sangrur, sas nagar"
7/23/10,https://reliefweb.int/node/362190,- 32 cattle/livestock have perished,agri,10,5,16,0,31,"mansa, patiala, sangrur, sas nagar"
7/22/10,https://reliefweb.int/node/361876,- 32 cattle/livestock have perished,agri,8,5,15,0,28,"mansa, patiala, sangrur, sas nagar"
7/21/10,https://reliefweb.int/node/361685,- 32 cattle/livestock have perished,agri,8,5,15,0,28,"mansa, patiala, sangrur, sas nagar"
7/20/10,https://reliefweb.int/node/361647,"punjab has also demanded damages of rs 10,000 against the existing rs 1,600 per acre of crop loss.",agri,4,13,11,2,30,"mansa, patiala, sangrur"
7/20/10,https://reliefweb.int/node/361587,- 32 cattle/livestock have perished,agri,8,3,15,0,26,"mansa, patiala, sangrur, sas nagar"
7/19/10,https://reliefweb.int/node/361653,- 32 cattle/livestock have perished,agri,8,3,15,0,26,"mansa, patiala, sangrur, sas nagar"
7/18/10,https://reliefweb.int/node/361463,-25 cattle/livestock have perished,agri,10,5,16,0,31,"mansa, patiala, sangrur, sas nagar"
7/17/10,https://reliefweb.int/node/361549,-25 cattle/livestock have perished,agri,7,5,15,0,27,"mansa, patiala, sangrur, sas nagar"
7/16/10,https://reliefweb.int/node/361436,-25 cattle/livestock have perished,agri,9,3,16,0,28,"mansa, patiala, sangrur, sas nagar"
7/15/10,https://reliefweb.int/node/361268,- 15 cattle/livestock have perished,agri,7,3,15,0,25,"mansa, patiala, sangrur, sas nagar"
7/14/10,https://reliefweb.int/node/361147,- 15 cattle/livestock have perished,agri,3,5,14,0,22,"mansa, patiala, sangrur"
7/13/10,https://reliefweb.int/node/360982,"a total of six lakh acres of agricultural land in punjab and haryana have been submerged, sinking hopes of thousands of farmers who had planted paddy",agri,9,9,15,0,33,"amritsar, fatehgarh sahib, ferozepur, gurdaspur, hoshiarpur, ludhiana, patiala, sangrur, sas nagar"
7/13/10,https://reliefweb.int/node/360959,- 15 cattle/livestock have perished,agri,7,7,18,0,32,"mansa, patiala, sangrur"
7/13/10,https://reliefweb.int/node/360959,"- 2,71,784 acre cropped area are reported to have been affected",agri,7,7,18,0,32,"mansa, patiala, sangrur"
7/12/10,https://reliefweb.int/node/361003,- 15 cattle/livestock have perished,agri,7,7,13,0,27,"patiala, sangrur"
7/12/10,https://reliefweb.int/node/361003,"- 2,53,322 acre cropped area are reported to have been affected",agri,7,7,13,0,27,"patiala, sangrur"
7/11/10,https://reliefweb.int/node/360767,- 11 cattle/livestock have perished,agri,6,4,15,0,25,"patiala, sangrur"
7/11/10,https://reliefweb.int/node/360767,"- 1,41,500 ha cropped area are reported to have been affected",agri,6,4,15,0,25,"patiala, sangrur"
7/11/10,https://reliefweb.int/node/360755,initial estimates suggest damage to paddy crop in over 2 lakh acre each in the two states,agri,8,12,25,0,45,"amritsar, patiala, sangrur"
7/11/10,https://reliefweb.int/node/360755,"according to a preliminary assessment by punjab government, the flood-affected districts have suffered losses worth around rs 300 crore in crops and infrastructure",agri,8,12,25,0,45,"amritsar, patiala, sangrur"
7/10/10,https://reliefweb.int/node/360648,- 11 cattle/livestock have perished,agri,8,5,21,0,34,"ludhiana, patiala, roopnagar, sangrur, sas nagar"
7/10/10,https://reliefweb.int/node/360648,"- 1,41,500 ha cropped area are reported to have been affected",agri,8,5,21,0,34,"ludhiana, patiala, roopnagar, sangrur, sas nagar"
7/9/10,https://reliefweb.int/node/360584,"- according to air, 108 villages in the district of patiala, 115 villages in the district of ludhiana (including between 20-25,000 acres of standing crop) and 115 villages in the district of fatehgarh sahib have been affected by flooding",agri,5,3,14,0,22,"fatehgarh sahib, ludhiana, patiala, sangrur, sas nagar, sbs nagar"
7/9/10,https://reliefweb.int/node/360499,- 11 cattle/livestock have perished,agri,9,5,21,0,35,"ludhiana, patiala, roopnagar, sangrur, sas nagar"
7/9/10,https://reliefweb.int/node/360499,"- 1,41,500 ha cropped area are reported to have been affected",agri,9,5,21,0,35,"ludhiana, patiala, roopnagar, sangrur, sas nagar"
7/8/10,https://reliefweb.int/node/360551,"- a breach in samrala canal (ludhiana) that has inundated over 20,000 acres of land",agri,7,4,11,0,22,"fatehgarh sahib, ludhiana, patiala, sangrur, sas nagar, sbs nagar"
7/7/10,https://reliefweb.int/node/360202,"- a breach in samrala canal (ludhiana) that has inundated over 20,000 acres of land",agri,4,4,10,0,18,"fatehgarh sahib, ludhiana, patiala, sas nagar, sbs nagar"
7/6/10,https://reliefweb.int/node/360264,- ¬† ¬† ¬† ¬†32 livestock have perished so far,agri,7,4,14,0,25,punjab
7/5/10,https://reliefweb.int/node/360195,- ¬† ¬† ¬† ¬†32 livestock have perished so far,agri,7,4,14,0,25,punjab
7/4/10,https://reliefweb.int/node/360232,- ¬† ¬† ¬† ¬†14 livestock have perished so far,agri,7,4,14,0,25,punjab
7/3/10,https://reliefweb.int/node/360255,- ¬† ¬† ¬† ¬†3615 livestock have perished so far,agri,7,6,15,0,28,punjab
7/3/10,https://reliefweb.int/node/360255,"- ¬† ¬† ¬† ¬†56,384.59 ha cropped area are reported to have been affected",agri,7,6,15,0,28,punjab
7/3/10,https://reliefweb.int/node/360255,- ¬† ¬† ¬† ¬†14 livestock have perished so far,agri,7,6,15,0,28,punjab
7/2/10,https://reliefweb.int/node/360081,- 3615 livestock have perished so far,agri,7,6,15,0,28,punjab
7/2/10,https://reliefweb.int/node/360081,"- 56,384.59 ha cropped area are reported to have been affected",agri,7,6,15,0,28,punjab
7/2/10,https://reliefweb.int/node/360081,- 14 livestock have perished so far,agri,7,6,15,0,28,punjab
7/1/10,https://reliefweb.int/node/359848,- ¬† ¬† ¬† ¬†3615 livestock have perished so far,agri,7,5,14,0,26,punjab
7/1/10,https://reliefweb.int/node/359848,- ¬† ¬† ¬† ¬†14 livestock have perished so far,agri,7,5,14,0,26,punjab
6/30/10,https://reliefweb.int/node/359918,- ¬† ¬† ¬† ¬†3615 livestock have perished so far,agri,7,7,14,0,28,punjab
6/30/10,https://reliefweb.int/node/359918,- ¬† ¬† ¬† ¬†14 livestock have perished so far,agri,7,7,14,0,28,punjab
6/29/10,https://reliefweb.int/node/359891,- ¬† ¬† ¬† ¬†3615 livestock have perished so far,agri,5,7,14,0,26,punjab
6/29/10,https://reliefweb.int/node/359891,"- ¬† ¬† ¬† ¬†56,224.59 ha cropped area is reported to have been affected",agri,5,7,14,0,26,punjab
6/29/10,https://reliefweb.int/node/359891,- ¬† ¬† ¬† ¬†13 livestock have perished so far,agri,5,7,14,0,26,punjab
6/29/10,https://reliefweb.int/node/359891,- ¬† ¬† ¬† ¬†2820.67 ha cropped area is reported to have been affected,agri,5,7,14,0,26,punjab
6/28/10,https://reliefweb.int/node/359938,- ¬† ¬† ¬† ¬†3615 livestock have perished so far,agri,3,4,5,0,12,punjab
6/28/10,https://reliefweb.int/node/359938,"- ¬† ¬† ¬† ¬†56,224.59 ha cropped area are reported to have been affected",agri,3,4,5,0,12,punjab
8/18/09,https://reliefweb.int/node/320992,- 443 livestock have perished so far,agri,17,11,32,0,60,sas nagar
8/18/09,https://reliefweb.int/node/320992,- 19454 livestock have perished so far,agri,17,11,32,0,60,sas nagar
8/18/09,https://reliefweb.int/node/320992,"- 1,26,000 ha cropped area are reported to have been affected",agri,17,11,32,0,60,sas nagar
8/18/09,https://reliefweb.int/node/320992,- 164 cattle/livestock have perished,agri,17,11,32,0,60,sas nagar
8/18/09,https://reliefweb.int/node/320992,- 25906.24 ha cropped area are reported to have been affected,agri,17,11,32,0,60,sas nagar
8/18/09,https://reliefweb.int/node/320992,- 2926 ha cropped area have affected,agri,17,11,32,0,60,sas nagar
8/5/09,https://reliefweb.int/node/319788, - 19454 livestock have been perished so far,agri,19,14,43,0,76,punjab
8/5/09,https://reliefweb.int/node/319788,"- 1,26,000 ha cropped area have been affected",agri,19,14,43,0,76,punjab
8/5/09,https://reliefweb.int/node/319788, - 175 cattle/livestock have been perished,agri,19,14,43,0,76,punjab
8/5/09,https://reliefweb.int/node/319788,- 25906.24 ha cropped area have been affected,agri,19,14,43,0,76,punjab
8/5/09,https://reliefweb.int/node/319788, - 434 livestock have been perished,agri,19,14,43,0,76,punjab
8/5/09,https://reliefweb.int/node/319788,- 2926 ha cropped area have been affected,agri,19,14,43,0,76,punjab
8/5/09,https://reliefweb.int/node/319788,- 1161 cattle/livestock have been perished,agri,19,14,43,0,76,punjab
8/5/09,https://reliefweb.int/node/319788,- 137230 ha cropped area have been affected,agri,19,14,43,0,76,punjab
7/29/09,https://reliefweb.int/node/318915, - 19454 livestock have been perished so far,agri,15,17,38,0,70,punjab
7/29/09,https://reliefweb.int/node/318915," - 77,728 ha cropped area have been affected",agri,15,17,38,0,70,punjab
7/29/09,https://reliefweb.int/node/318915, - 1166 cattle/livestock have been perished,agri,15,17,38,0,70,punjab
7/29/09,https://reliefweb.int/node/318915, - 25689.38 ha cropped area have been affected,agri,15,17,38,0,70,punjab
7/29/09,https://reliefweb.int/node/318915, - 431 livestock have been perished,agri,15,17,38,0,70,punjab
7/29/09,https://reliefweb.int/node/318915, - 2926 ha cropped area have been affected,agri,15,17,38,0,70,punjab
7/29/09,https://reliefweb.int/node/318915, - 1161 cattle/livestock have been perished,agri,15,17,38,0,70,punjab
7/29/09,https://reliefweb.int/node/318915,- 1265 ha cropped area have been affected,agri,15,17,38,0,70,punjab
7/29/09,https://reliefweb.int/node/318915, - 155 cattle/livestock have been perished,agri,15,17,38,0,70,punjab
9/21/08,https://reliefweb.int/node/281535,- 1194 lakh ha crop area has also been damaged so far,agri,47,29,84,0,160,sas nagar
9/21/08,https://reliefweb.int/node/281535,- about 240 cattle livestock have been perished so far,agri,47,29,84,0,160,sas nagar
9/21/08,https://reliefweb.int/node/281535,- 787 cattle livestock have been perished so far,agri,47,29,84,0,160,sas nagar
9/21/08,https://reliefweb.int/node/281535,- 189 cattle camps are opened in the affected areas in which about 54230 animals accommodated,agri,47,29,84,0,160,sas nagar
9/21/08,https://reliefweb.int/node/281535,- 3490 cattle/livestock are reported to have been perished,agri,47,29,84,0,160,sas nagar
9/21/08,https://reliefweb.int/node/281535,- 119858 ha cropped areas has been damaged,agri,47,29,84,0,160,sas nagar
9/21/08,https://reliefweb.int/node/281535,- 3923 cattle livestock have been perished so far,agri,47,29,84,0,160,sas nagar
9/20/08,https://reliefweb.int/node/281294,- 1194 ha crop area has also been damaged so far,agri,46,21,89,0,156,punjab
9/20/08,https://reliefweb.int/node/281294,- about 240 cattle livestock have been perished so far,agri,46,21,89,0,156,punjab
9/20/08,https://reliefweb.int/node/281294,- 766 cattle livestock have been perished so far,agri,46,21,89,0,156,punjab
9/20/08,https://reliefweb.int/node/281294,- in 161 cattle camps about 54230 animals accommodated,agri,46,21,89,0,156,punjab
9/20/08,https://reliefweb.int/node/281294,- 3489 cattle/livestock are reported to have been perished,agri,46,21,89,0,156,punjab
9/20/08,https://reliefweb.int/node/281294,- 119858 ha cropped areas has been damaged,agri,46,21,89,0,156,punjab
9/20/08,https://reliefweb.int/node/281294,- 3923 cattle livestock have been perished so far,agri,46,21,89,0,156,punjab
9/9/08,https://reliefweb.int/node/279984,"consolidated report on india floods  situation according to the updated report of the disaster management division of the ministry of home affairs, so far, incessant rains and flash floods have engulfed 1906 human lives, affected a population of 199,69326, estimated livestock loss is 19940 and demolished/damaged 583255 houses in 13634 villages of 117 districts across the country",agri,30,8,38,7,83,punjab
9/7/08,https://reliefweb.int/node/279521,- in 100 cattle camps about 15180 animals accommodated,agri,25,11,42,0,78,punjab
9/7/08,https://reliefweb.int/node/279521,- 3312 cattle/livestock have been perished so far,agri,25,11,42,0,78,punjab
9/7/08,https://reliefweb.int/node/279521,- 119858 ha cropped areas has been damaged,agri,25,11,42,0,78,punjab
9/7/08,https://reliefweb.int/node/279521,- 3920 cattle livestock have been perished so far,agri,25,11,42,0,78,punjab
9/6/08,https://reliefweb.int/node/280844,- 100 cattle camps are opened in the affected areas in which about 15160 animals accommodated,agri,26,13,53,0,92,punjab
9/6/08,https://reliefweb.int/node/280844,- 3312 cattle/livestock are reported to have been perished,agri,26,13,53,0,92,punjab
9/6/08,https://reliefweb.int/node/280844,- 119858 ha cropped areas has been damaged,agri,26,13,53,0,92,punjab
9/6/08,https://reliefweb.int/node/280844,- 3920 cattle livestock have been perished so far,agri,26,13,53,0,92,punjab
9/3/08,https://reliefweb.int/node/278859,"according to government figures, vast areas of agricultural land have been inundated and a large number of houses have collapsed or been destroyed (597,000 houses have been fully damaged while 418,497 houses have been partially damaged)",agri,49,30,91,1,171,"amritsar, gurdaspur, hoshiarpur, jalandhar, kapurthala, moga, sas nagar"
9/3/08,https://reliefweb.int/node/278859,"a total of 223,446 houses (temporary and permanent) have been destroyed and 13,550 cattle have 2 been lost",agri,49,30,91,1,171,"amritsar, gurdaspur, hoshiarpur, jalandhar, kapurthala, moga, sas nagar"
9/3/08,https://reliefweb.int/node/278859,the total land under crops that has been damaged is 0.14 million hectares,agri,49,30,91,1,171,"amritsar, gurdaspur, hoshiarpur, jalandhar, kapurthala, moga, sas nagar"
9/3/08,https://reliefweb.int/node/278859,the government and other civil agencies have set up almost 20 animal camps for protecting cattle and 40 medical centres for providing immediate medical aid to the affected people,agri,49,30,91,1,171,"amritsar, gurdaspur, hoshiarpur, jalandhar, kapurthala, moga, sas nagar"
9/3/08,https://reliefweb.int/node/278859,"district authorities have so far distributed dry ration (including 38,100 kilograms of beaten rice, 8,000 kilograms of jaggery and 5,000 kilograms of gram powder) and 60,584 bed-sheets",agri,49,30,91,1,171,"amritsar, gurdaspur, hoshiarpur, jalandhar, kapurthala, moga, sas nagar"
9/3/08,https://reliefweb.int/node/278859,"in addition, 33 medical centres for the affected population and 33 cattle camps have been set up",agri,49,30,91,1,171,"amritsar, gurdaspur, hoshiarpur, jalandhar, kapurthala, moga, sas nagar"
9/3/08,https://reliefweb.int/node/278859,"a total of 184,132 hectares of cropped land has been affected",agri,49,30,91,1,171,"amritsar, gurdaspur, hoshiarpur, jalandhar, kapurthala, moga, sas nagar"
9/3/08,https://reliefweb.int/node/278859,"approximately 3.7 million people have been affected and 119,852 hectares of cropped land has been destroyed",agri,49,30,91,1,171,"amritsar, gurdaspur, hoshiarpur, jalandhar, kapurthala, moga, sas nagar"
9/1/08,https://reliefweb.int/node/278555,- in 98 cattle camps about 4000 animals accommodated and 8014 animals have been given treatment,agri,38,19,78,0,135,punjab
9/1/08,https://reliefweb.int/node/278555,- 903 cattle/livestock have been perished so far,agri,38,19,78,0,135,punjab
9/1/08,https://reliefweb.int/node/278555,"- 1,84,132 acres cropped area has been damaged",agri,38,19,78,0,135,punjab
9/1/08,https://reliefweb.int/node/278555,"- 86 cattle and 15,700 hens have been perished",agri,38,19,78,0,135,punjab
9/1/08,https://reliefweb.int/node/278555,- in 4 cattle camps about 1775 cattle have been accommodated west bengal - heavy to very heavy rainfall with isolated extremely heavy falls has been reported in some parts of the state - 07 human deaths reported by the state during last 24 hours,agri,38,19,78,0,135,punjab
9/1/08,https://reliefweb.int/node/278555,- 3920 cattle livestock have been perished so far,agri,38,19,78,0,135,punjab
8/27/08,https://reliefweb.int/node/278134,- 59 cattle camps have been opened in the affected areas in which 715 animals have been treated,agri,25,9,55,0,89,ferozepur
8/27/08,https://reliefweb.int/node/278134,- 3920 cattle livestock have been perished so far,agri,25,9,55,0,89,ferozepur
8/26/08,https://reliefweb.int/node/278299,"- in 23 cattle camps, 546 animals have been treated",agri,33,9,56,0,98,"ferozepur, jalandhar, kapurthala, moga"
8/26/08,https://reliefweb.int/node/278299,- 86 cattle and 15700 hens have been perished,agri,33,9,56,0,98,"ferozepur, jalandhar, kapurthala, moga"
8/26/08,https://reliefweb.int/node/278299,"- 4 cattle camps opened in which about 1775 cattle have been accommodated - all army columns and engineer task forces deployed for rescue and relief operations in the state have been derequisitioned on 25th august, 2008",agri,33,9,56,0,98,"ferozepur, jalandhar, kapurthala, moga"
8/25/08,https://reliefweb.int/node/278295,- 15 cattle camps have been opened in the affected areas,agri,21,4,42,0,67,"amritsar, kapurthala"
8/24/08,https://reliefweb.int/node/278337,- 57 cattle and 15700 hens have been perished,agri,23,11,51,0,85,punjab
8/24/08,https://reliefweb.int/node/278337,- 4 cattle camps opened in which about 1775 cattle have been accommodated - 04 army columns with 04 engineer task forces continued to be deployed for rescue and relief operations,agri,23,11,51,0,85,punjab
8/24/08,https://reliefweb.int/node/278337,- 652 cattle/livestock are reported to have been perished,agri,23,11,51,0,85,punjab
8/24/08,https://reliefweb.int/node/278337,- 15 cattle camps have been opened in the affected areas,agri,23,11,51,0,85,punjab
8/23/08,https://reliefweb.int/node/278317,- 57 cattle and 15700 hens have been perished,agri,23,6,48,0,77,kapurthala
8/22/08,https://reliefweb.int/node/278298,- 57 cattle and 15700 hens have been perished,agri,28,10,52,0,90,kapurthala
8/22/08,https://reliefweb.int/node/278298,- 4 cattle camps opened in which about 1775 cattle have been accommodated - 01 army column and 01 etf each have been derequisitioned on 21.08.08 from ferozpur district,agri,28,10,52,0,90,kapurthala
8/22/08,https://reliefweb.int/node/278298,- 05 cattle camps have also been opened in the affected areas,agri,28,10,52,0,90,kapurthala
8/21/08,https://reliefweb.int/node/277451,- 47 cattle and 15700 hen have been perished,agri,24,5,35,0,64,"ferozepur, jalandhar, kapurthala, moga, sas nagar"
8/21/08,https://reliefweb.int/node/277239,"the situation is worse in remote areas, where over 2,000 thatched houses and 320 roads have been damaged and over 5,000 hectares of crops destroyed in koraput and jeypore sub-division, orissa",agri,16,19,28,1,64,punjab
8/21/08,https://reliefweb.int/node/277239,"some 530,000 acres of land, including 200,000 cultivated acres, have been affected",agri,16,19,28,1,64,punjab
8/21/08,https://reliefweb.int/node/277239,"the package of assistance and relief per family is planned as follows: food items (10 kg rice, 2 kg dal, 1 litre oil, ¬Ω kg salt, ¬Ω kg red chilli); and non-food items (men's wear, women's wear and blankets)",agri,16,19,28,1,64,punjab
8/18/08,https://reliefweb.int/node/277023,- 23 cattle and 11700 hens have been perished and 50655 ha cropped area has been damaged,agri,33,6,50,0,89,"ferozepur, jalandhar, kapurthala, moga"
8/15/08,https://reliefweb.int/node/277055,- 188 cattle are reported to have been perished in the state so far,agri,29,5,41,0,75,punjab
8/15/08,https://reliefweb.int/node/277055,- 344 cattle/livestock are reported to have been perished,agri,29,5,41,0,75,punjab
6/16/08,https://reliefweb.int/node/270161,"india: assam reels under floods, orissa sounds alert  new delhi: as people, particularly farmers, cheered the early monsoons in north india, those in assam blamed it on the rain god as army was called out to rescue marooned people in the flood-hit state even as rain- related incidents claimed over 10 lives elsewhere",agri,15,16,10,0,41,jalandhar
8/18/07,https://reliefweb.int/node/240663,- 341 cattle camps continue to run in the affected districts of the state,agri,23,16,57,0,96,"roopnagar, sangrur, sas nagar"
8/17/07,https://reliefweb.int/node/240777, - several low lying areas and agricultural fields are reported to be inundated by 2 to 5 feet deep water,agri,24,11,61,0,96,"roopnagar, sangrur, sas nagar"
8/17/07,https://reliefweb.int/node/240777,- 341 cattle camps continue to run in the affected districts of the state,agri,24,11,61,0,96,"roopnagar, sangrur, sas nagar"
9/19/19,https://www.tribuneindia.com/news/punjab/flood-leaves-white-layer-in-fields-of-muktsar/834669.html,"similarly, the government will give a compensation of rs 95,000 against house damage",house,4,29,15,2,50,sri muktsar sahib
9/14/19,https://www.tribuneindia.com/news/punjab/jalandhar-kapurthala-losses-pegged-at-rs-526-cr/832145.html," in jalandhar, the divisional commissioner and deputy commissioner sought compensation of rs 224 crore for agricultural losses, rs 78.25 lakh for loss of animals and provision of fodder, rs 15 crore for damage to more than 3,000 houses in 29 villages, rs 20 crore for plugging breaches and for further strengthening embankments, rs 7 crore for repair of the 83-km link road, rs 1.50 crore for repair of 15 down feeders, 200 transformers and a 66-kv sub-station at mehrajwala besides rs 1 crore for the repair of water works in flood-affected villages",house,2,58,49,4,113,"jalandhar, kapurthala"
9/14/19,https://www.tribuneindia.com/news/punjab/jalandhar-kapurthala-losses-pegged-at-rs-526-cr/832145.html,"ush({ });  in kapurthala, crop losses have been pegged at rs 160 crore which includes rs 60 crore for bandh repairs and rs 85 lakh for damaged roads and houses, including 1,618 cattle deaths",house,2,58,49,4,113,"jalandhar, kapurthala"
9/14/19,https://www.tribuneindia.com/news/punjab/jalandhar-kapurthala-losses-pegged-at-rs-526-cr/832145.html," telling numbers  total loss¬† rs 526 crore¬† total land submerged¬†75,000 acres¬† total crop loss¬† rs 384 crore¬† breach/bandh repair¬†¬† rs 80 crore¬† animal, fodder loss¬† rs 78.25 lakh damage to houses in jalandhar¬† rs 15 crore¬† link road repair (jalandhar)¬† rs 7 crore¬† ",house,2,58,49,4,113,"jalandhar, kapurthala"
9/13/19,https://www.tribuneindia.com/news/punjab/state-pitches-for-aid-as-central-team-visits-flood-affected-areas/831669.html,"tribune news service chandigarh/ropar, sept 12  a seven-member inter-ministerial central team, led by anuj sharma, joint secretary (cis), union ministry of home affairs, met the top brass of punjab government at the isb, mohali, on thursday",house,9,21,32,0,62,"amritsar, ferozepur, gurdaspur, jalandhar, kapurthala, ludhiana, moga, pathankot, roopnagar, sas nagar, sbs nagar, tarn taran"
9/13/19,https://www.tribuneindia.com/news/punjab/state-pitches-for-aid-as-central-team-visits-flood-affected-areas/831669.html," according to a report submitted by the district administration, 46,300 residents in 182 villages were affected while standing crop on 11,580 acres and 313 houses were damaged completely",house,9,21,32,0,62,"amritsar, ferozepur, gurdaspur, jalandhar, kapurthala, ludhiana, moga, pathankot, roopnagar, sas nagar, sbs nagar, tarn taran"
9/13/19,https://www.tribuneindia.com/news/punjab/state-pitches-for-aid-as-central-team-visits-flood-affected-areas/831669.html,"other than this, 27 buildings of government schools, dispensaries and community centres and nine bridges have been damaged",house,9,21,32,0,62,"amritsar, ferozepur, gurdaspur, jalandhar, kapurthala, ludhiana, moga, pathankot, roopnagar, sas nagar, sbs nagar, tarn taran"
9/13/19,https://www.tribuneindia.com/news/punjab/state-pitches-for-aid-as-central-team-visits-flood-affected-areas/831669.html,"also, 366.60-km link roads and 91.77 km of plan roads have been washed away in the district",house,9,21,32,0,62,"amritsar, ferozepur, gurdaspur, jalandhar, kapurthala, ludhiana, moga, pathankot, roopnagar, sas nagar, sbs nagar, tarn taran"
9/12/19,https://www.tribuneindia.com/news/punjab/punjab-govt-centre-team-meet-to-discuss-flood-damage-in-11-districts/831226.html," about 900 houses were damaged, 630 completely washed away, causing a total loss of rs 6.26 crore",house,15,25,41,0,81,"amritsar, ferozepur, gurdaspur, jalandhar, kapurthala, ludhiana, moga, pathankot, sbs nagar, tarn taran"
9/12/19,https://www.tribuneindia.com/news/punjab/punjab-govt-centre-team-meet-to-discuss-flood-damage-in-11-districts/831226.html,"almost 2,871 km of link roads in villages, 417 km of highways and 75 bridges were washed away or damaged (loss rs 178.83 crore)",house,15,25,41,0,81,"amritsar, ferozepur, gurdaspur, jalandhar, kapurthala, ludhiana, moga, pathankot, sbs nagar, tarn taran"
9/9/19,https://www.tribuneindia.com/news/punjab/floods-hope-relations-washed-away/829761.html, the dreams of getting married and starting a new life had started taking shape on 19-year-old usha rani‚Äôs (name changed) mind when the family of the man she was getting married to came to their house and asked to finalise the date,house,14,14,23,2,53,jalandhar
9/6/19,https://www.tribuneindia.com/news/punjab/central-team-to-visit-flood-affected-areas/828361.html,"chandigarh, september 5acceding to the request of cm capt amarinder singh, the union home ministry has deputed an inter-ministerial central team for a two-day visit to the state for an assessment of the situation in the wake of the recent floods",house,1,3,6,0,10,"jalandhar, kapurthala"
9/6/19,https://www.tribuneindia.com/news/punjab/central-team-to-visit-flood-affected-areas/828361.html," a spokesperson of the cmo said the six-member team, led by ministry of home affairs joint secretary anuj sharma, would be visiting chandigarh on september 12",house,1,3,6,0,10,"jalandhar, kapurthala"
9/3/19,https://www.tribuneindia.com/news/punjab/rs-4-lakh-for-kin-of-victims/826745.html," the kin of leela devi, a resident of sardarpura village, who got buried as the roof of her house had collapsed during incessant rain, have also been paid rs 4 lakh",house,10,22,20,2,54,fazilka
9/3/19,https://www.tribuneindia.com/news/punjab/khalsa-aid-women-team-reaches-out-to-villagers/826742.html,"aparna banerji tribune news service malsian (jalandhar), september 2  among the 100 volunteers slugging it out day and night to prepare 25-kg relief kits for punjab‚Äôs flood hit at the khalsa aid warehouse in malsian, there is only one woman relentlessly putting in her bit",house,6,3,12,0,21,"jalandhar, patiala, sas nagar"
9/3/19,https://www.tribuneindia.com/news/punjab/khalsa-aid-women-team-reaches-out-to-villagers/826742.html,she is the lone woman in khalsa aid‚Äôs current warehouse team of 100 volunteers,house,6,3,12,0,21,"jalandhar, patiala, sas nagar"
9/2/19,https://www.tribuneindia.com/news/punjab/ahead-of-sc-hearing-on-syl-capt-amarinder-meets-union-jalshakti-minister/826710.html," he said that the flood had caused damage to 1.72 lakh acres of crop, and destroyed some 500 houses",house,1,6,10,0,17,punjab
9/2/19,https://www.tribuneindia.com/news/punjab/from-bundhs-villagers-keep-watch-on-homes/826301.html," raju, who shifted to mundi shehrian village three years ago, has lost his home and belongings in the flood",house,10,3,20,0,33,jalandhar
9/2/19,https://www.tribuneindia.com/news/punjab/from-bundhs-villagers-keep-watch-on-homes/826301.html,"while mandeep spent eight days at the relief camp in lohian, worries for her house and belongings still left to be salvaged from the roof caused her to return",house,10,3,20,0,33,jalandhar
9/1/19,https://www.tribuneindia.com/news/punjab/flood-fury-in-ropar-alone-46-300-hit-rs-152-cr-loss/825940.html," a report submitted by the district administration said 46,300 residents in 182 villages were affected, while standing crop on 11,580 acres and 313 houses were completely damaged",house,4,20,19,1,44,punjab
9/1/19,https://www.tribuneindia.com/news/punjab/flood-fury-in-ropar-alone-46-300-hit-rs-152-cr-loss/825940.html," besides standing crop, 366.60-km link roads and 91.77-km plan roads had been washed away",house,4,20,19,1,44,punjab
9/1/19,https://www.tribuneindia.com/news/punjab/flood-fury-in-ropar-alone-46-300-hit-rs-152-cr-loss/825940.html,"twenty-seven government buildings of schools, dispensaries and community centres, and nine bridges were damaged and rs 111 crore would be required to repair the infrastructure",house,4,20,19,1,44,punjab
8/31/19,https://www.tribuneindia.com/news/punjab/report-ready-on-damage-to-roads/825351.html,"chandigarh, august 30  the public works department has prepared a preliminary damage assessment report regarding the roads, bridges and buildings falling under jurisdiction of the department, said an official spokesman",house,0,5,10,1,16,sas nagar
8/31/19,https://www.tribuneindia.com/news/punjab/report-ready-on-damage-to-roads/825351.html," giving details, he said due to recent heavy rains and floods, approximately 1,450 km link roads, 420 km plan roads/national highways, 36 bridges and 36 buildings under jurisdiction of the department have been damaged",house,0,5,10,1,16,sas nagar
8/31/19,https://www.tribuneindia.com/news/punjab/report-ready-on-damage-to-roads/825351.html,"most damage to link and plan roads was observed in rupnagar district wherein it is to the extent of 693.96 km and 123.1 km, respectively",house,0,5,10,1,16,sas nagar
8/31/19,https://www.tribuneindia.com/news/punjab/report-ready-on-damage-to-roads/825351.html," around rs 95.50 crore is required for the repairs but the exact cost can be estimated only when the flood water recedes completely, he said, adding that the basic patchwork and repair of road breaches was underway",house,0,5,10,1,16,sas nagar
8/29/19,https://www.tribuneindia.com/news/punjab/water-from-pak-inundates-fazilka-village/824265.html,he said two kutcha houses had also collapsed in the village,house,2,11,15,0,28,fazilka
8/28/19,https://www.tribuneindia.com/news/punjab/inter-ministerial-central-team-to-visit-punjab-to-assess-damage-by-floods/824234.html," people in several punjab districts, including jalandhar, kapurthala, ferozepur, rupnagar, moga, ludhiana, have lost their houses, belongings, and standing crops in the recent floods, which are said to be the worst since 1988",house,1,16,27,0,44,"ferozepur, jalandhar, kapurthala, ludhiana, moga, sas nagar"
8/28/19,https://www.tribuneindia.com/news/punjab/nambardar-union-to-give-rs-14-cr-to-cm-fund/823788.html,tns sanitation workers seek payabohar: around 165 regular sanitation workers of the municipal council continued their strike for the 14th day and organised a march through the main roads here,house,7,36,19,2,64,"jalandhar, kapurthala, moga, sangrur"
8/28/19,https://www.tribuneindia.com/news/punjab/month-on-muktsar-farmers-await-special-girdawari/823774.html,"further, it has damaged nearly 225 houses in the district",house,1,31,18,1,51,sri muktsar sahib
8/27/19,https://www.tribuneindia.com/news/punjab/schools-shelter-flood-hit-kids-skip-classes/823368.html,"  her house inundated, kiranjot kaur (14), a class viii student at government high school, chak wadala, jalandhar, is lodged in a relief camp at lohian village",house,1,7,10,0,18,"jalandhar, kapurthala, ludhiana, tarn taran"
8/27/19,https://www.tribuneindia.com/news/punjab/out-of-job-daily-wagers-struggle-to-feed-family/823215.html,‚Äúi cannot even think of going back to my house for nearly two months,house,5,13,17,4,39,jalandhar
8/27/19,https://www.tribuneindia.com/news/punjab/distress-calls-turn-pcr-into-flood-helpline/823214.html,"  2.07 pm, august 22, mundi village, jalandhar: ‚Äúi am stuck on the rooftop of my house, which is surrounded by water",house,4,8,14,0,26,"jalandhar, kapurthala, ludhiana, sas nagar"
8/26/19,https://www.tribuneindia.com/news/punjab/jitters-post-review/822848.html,"he often climbs atop one of the security towers installed by the bsf at the international border (ib) and is pleased at the progress of the work on the pakistan side, but the same is not true back home",house,10,5,6,0,21,"amritsar, fazilka, ferozepur, jalandhar, patiala, sas nagar"
8/26/19,https://www.tribuneindia.com/news/punjab/jitters-post-review/822848.html,"municipal council president rakesh dhuria, association patron dr bhupinder singh, general secretary navdeep asija, environmentalist prem babbar and others felicitated residents of jattian mohalla and shakti nagar street number 2, baba namdev nagar, mr enclave and panchayat samiti green market",house,10,5,6,0,21,"amritsar, fazilka, ferozepur, jalandhar, patiala, sas nagar"
8/26/19,https://www.tribuneindia.com/news/punjab/punjab-seeks-rs-1-000-cr-special-aid-from-centre/822847.html,"it was on capt amarinder‚Äôs request that the union home ministry, which grants special assistance, had decided to send teams to assess the damage in punjab along with 11 other states, he said",house,11,11,42,0,64,"fazilka, ferozepur, jalandhar, kapurthala, ludhiana, patiala, sas nagar, sbs nagar"
8/26/19,https://www.tribuneindia.com/news/punjab/punjab-seeks-rs-1-000-cr-special-aid-from-centre/822847.html,"a person was feared drowned in the sutlej in fazilka while death of 176 cattle heads and damage to 161 houses had been reported from ropar, said officials",house,11,11,42,0,64,"fazilka, ferozepur, jalandhar, kapurthala, ludhiana, patiala, sas nagar, sbs nagar"
8/25/19,https://www.tribuneindia.com/news/punjab/capt-amarinder-seeks-joint-action-plan-with-army-to-strengthen-tendiwala-embankment/822677.html,"  union home secretary, mr ajay bhalla has informed the state give that a central team to assess damage on account of floods would also be sent to punjab, along with 11 other flood ravaged states",house,19,16,35,0,70,"ferozepur, jalandhar, kapurthala"
8/25/19,https://www.tribuneindia.com/news/punjab/amid-deluge-jalandhar-welcomes-flood-babies/822267.html,"her husband jaswinder singh, a marginal farmer, too thanked god but was yet to name his child as he was worried for his two-year-old daughter whom he had left with neighbours back home amid heavy rain and floods",house,2,6,13,0,21,jalandhar
8/24/19,https://www.tribuneindia.com/news/punjab/cm-surprised-over-non-inclusion-of-punjab-in-list-for-flood-situation-assessment/822239.html,the imct was constituted by the home ministry following a decision taken at a high-level committee meeting on august 19,house,4,30,25,0,59,"ferozepur, jalandhar, kapurthala, ludhiana, sas nagar"
8/23/19,https://www.tribuneindia.com/news/punjab/relief-camps-flooded/821455.html,"now, the administration plans to provide relief to the flood-hit at their houses through 18 relief teams",house,1,1,11,0,13,kapurthala
8/23/19,https://www.tribuneindia.com/news/punjab/cemeteries-flooded-villagers-cremate-body-along-highway/821302.html,"ush({ });  with their pyjamas folded up to knees, the villagers said they carried the youth's body for over three kilometre through flooded streets and fields to reach a safe place to cremate him",house,15,3,12,0,30,punjab
8/22/19,https://www.tribuneindia.com/news/punjab/water-continues-to-rise-so-do-fears/820859.html,"deepkamal kaur tribune news service janian chahal (jalandhar), august 21  marooned in their houses by the swollen sutlej, affected families at janian chahal, chak wadala and gatti peer baksh villages in the district today spent their fourth sleepless night stranded on rooftops, waiting for the water levels to recede",house,8,2,22,0,32,jalandhar
8/22/19,https://www.tribuneindia.com/news/punjab/2-new-breaches-worsen-situation-in-jalandhar-kapurthala/820673.html," jalandhar deputy commissioner varinder kumar sharma said, ‚Äúabout 18,000 villagers are expected to be staying put at their ‚Äòflooded‚Äô homes today too",house,8,12,21,0,41,"jalandhar, kapurthala"
8/21/19,https://www.tribuneindia.com/news/punjab/punjab-cm-writes-to-pm-for-rs-1000-crore-special-flood-relief-package/820655.html,"  he said though necessary assistance was given by the army authorities, the floods in river sutlej had severely damaged standing crops, houses and other rural and urban infrastructure at many places, especially in the districts of ropar, ludhiana, jalandhar and kapurthala covering over 100 villages",house,24,22,42,0,88,"ferozepur, jalandhar, kapurthala, ludhiana"
8/21/19,https://www.tribuneindia.com/news/punjab/300-punjab-villages-badly-affected-by-floods/820611.html,"chandigarh, august 21more than 300 villages, mainly in punjab's ropar, jalandhar and ferozepur districts, were badly affected in floods by the satluj river, damaging crops in thousands of acres and forcing thousands of villagers to spend nights on rooftops",house,8,8,22,0,38,"ferozepur, gurdaspur, jalandhar, pathankot, sas nagar"
8/21/19,https://www.tribuneindia.com/news/punjab/rainfall-subsides-rivers-still-swollen/820229.html,"tribune news service jalandhar, august 20  with three more breaches reported ‚Äî two in kapurthala at tibbi (gidderpindi) and sarwal villages and one in mandala, jalandhar ‚Äî the sutlej breaches have escalated to a point where thousands of villagers are forced to spend nights on rooftops",house,34,15,52,1,102,"jalandhar, kapurthala, sangrur"
8/21/19,https://www.tribuneindia.com/news/punjab/rainfall-subsides-rivers-still-swollen/820229.html,"villagers said in around 80-100 deras (field homes), residents had not been rescued",house,34,15,52,1,102,"jalandhar, kapurthala, sangrur"
8/21/19,https://www.tribuneindia.com/news/punjab/rainfall-subsides-rivers-still-swollen/820229.html," in lohian village alone, 700-800 persons had been stranded on rooftops with no tarpaulins or even clean drinking water",house,34,15,52,1,102,"jalandhar, kapurthala, sangrur"
8/21/19,https://www.tribuneindia.com/news/punjab/punjab-rain-loss-rs-1-700-crore/820174.html,"‚Äî tns  5,629 water supply schemes hit in hp  rains have claimed 63 lives in hp from june 1 to august 20 while the loss due to heavy rains and cloudbursts is estimated at rs 626 crore¬† as many as 5,629 water supply & irrigation schemes have been affected and 799 houses damaged",house,8,29,31,0,68,"fazilka, ferozepur, jalandhar, kapurthala, ludhiana, moga, sas nagar, tarn taran"
8/21/19,https://www.tribuneindia.com/news/punjab/punjab-rain-loss-rs-1-700-crore/820174.html,"as many as 824 roads still remain closed the met office has predicted rains and thunderstorm in lower, mid and higher hills in the next six days from august 21 to august 26  hry flood-hit shifted¬† sonepat & karnal: 25 families evacuated in the two districts 11,000 acres submerged karnal fields: 7,100 acres of paddy, 3,000 of sugarcane and¬†900 acres of maize submerged 35 villages affected yamunanagar: standing crops on 1,972 hectares, 35 villages affected, as per initial reports",house,8,29,31,0,68,"fazilka, ferozepur, jalandhar, kapurthala, ludhiana, moga, sas nagar, tarn taran"
8/21/19,https://www.tribuneindia.com/news/punjab/displaced-ferozepur-residents-demand-permanent-solution/820167.html," ndrf officials said they rescued and shifted more than 100 people to safer places, but at a few locations, the residents refused to come out of their houses and preferred to stay on rooftops",house,22,6,18,1,47,ferozepur
8/20/19,https://www.tribuneindia.com/news/punjab/standing-crops-hit-farmers-seek-damages/819846.html,"‚Äúwe had cultivated vegetables on 10 acres along the machhiwara-rattipur road, hoping to earn a livelihood for a year",house,8,66,38,2,114,"fatehgarh sahib, ludhiana, moga, sangrur, tarn taran"
8/20/19,https://www.tribuneindia.com/news/punjab/punjab-on-edge-rivers-in-spate/819828.html,"‚Äî tns  fields inundated, bundhs breached 81 villages¬†¬†flooded after bundhs breached at nine places¬†in jalandhar  army called out in ferozepur to assist in rescue and¬†relief operations 35 villages flooded in ropar; breaches¬†in river embankments in ludhiana  over 1,000 roads closed¬† shimla 459mandi 314 kangra 191hamirpur 91",house,4,14,14,0,32,"fazilka, ferozepur, jalandhar, ludhiana, pathankot, sbs nagar"
8/20/19,https://www.tribuneindia.com/news/punjab/army-roped-in-for-help-in-ferozepur/819827.html,"    7 trains cancelled, two diverted        several trains were cancelled after water level crossed the danger mark along bridge no",house,3,9,14,0,26,"bathinda, ferozepur, hoshiarpur, jalandhar, ludhiana, sas nagar"
8/20/19,https://www.tribuneindia.com/news/punjab/70-ft-breach-in-sutlej-adds-to-misery-rescue-ops-on/819818.html,the water level at ladhowal bridge was recorded at 237.37 m at 3 pm while the danger mark is at 237.58 m,house,12,11,31,0,54,"jalandhar, ludhiana"
8/20/19,https://www.tribuneindia.com/news/punjab/cm-orders-girdawari-rs-100-cr-relief/819814.html,"ush({ });  he also visited the indian institute of technology (iit), ropar, where the authorities have asked the students to go back to their homes for one week as three substations supplying power to the campus are submerged",house,10,6,19,0,35,punjab
8/19/19,https://www.tribuneindia.com/news/punjab/capt-amarinder-earmarks-rs-100-cr-for-flood-relief/819785.html,"  captain amarinder also expressed grief over the death of three people due to roof collapse in ludhiana district, the statement said",house,7,5,13,0,25,"ludhiana, sas nagar"
8/19/19,https://www.tribuneindia.com/news/punjab/ropar-dc-gives-his-number-to-distressed-elderly-woman-in-flood-affected-area/819784.html,"tribune web desk chandigarh, august 19  in flood-affected ropar, deputy commissioner sumeet jarangal went beyond the call of duty as he gave a distressed elderly woman‚Äîwhose ‚Äòkuccha‚Äô house was washed away in the flood‚Äîhis contact number",house,1,3,15,0,19,punjab
8/19/19,https://www.tribuneindia.com/news/punjab/naggal-dam-breach-causes-flash-flood/819444.html,"akash ghai  tribune news service  mohali, august 18  a major breach in naggal earthen dam, located in the forest area opposite new chandigarh, caused flash flood in the area, which resulted in washing away of at least 15 head of cattle, six houses and around four-five bridges at chotti naggal, badi naggal, parol, mirzapur and nearby villages",house,5,8,12,0,25,sas nagar
8/19/19,https://www.tribuneindia.com/news/punjab/jalandhar-villagers-caught-unawares-blame-authorities/819441.html," army rescues 2 men, cattle from sutlej  an army team deputed at nawanshahr saved two people, besides nine rearing animals, from the sutlej near mattewara bridge at begowal village of the district on sunday a migrant labourer living in a room in the fields of a farmer was stuck as the flow of river water increased suddenly",house,14,22,31,0,67,"jalandhar, sbs nagar"
8/18/19,https://www.tribuneindia.com/news/punjab/flood-alert-as-sutlej-water-enters-villages/819020.html,nearly 10 houses at dasgrain village were also inundated,house,0,10,27,0,37,jalandhar
8/17/19,https://www.tribuneindia.com/news/punjab/torrential-rain-lashes-northern-states-alert-sounded-in-punjab/818855.html," the body of a 17-year-old boy was found floating in the overflowing dam in himachal pradesh, where several roads were blocked following multiple landslides and flash floods",house,17,13,16,0,46,"amritsar, ludhiana, sas nagar"
8/17/19,https://www.tribuneindia.com/news/punjab/torrential-rain-lashes-northern-states-alert-sounded-in-punjab/818855.html, a district administration official said nearly 12 roads are disconnected due to heavy rains and 40 villages are facing a flood-like situation,house,17,13,16,0,46,"amritsar, ludhiana, sas nagar"
8/17/19,https://www.tribuneindia.com/news/punjab/torrential-rain-lashes-northern-states-alert-sounded-in-punjab/818855.html," people have started moving to their homes from relief camps in kerala, even as the toll climbed to 113, with authorities retrieving more bodies from landslide-hit malappuram and wayanad districts",house,17,13,16,0,46,"amritsar, ludhiana, sas nagar"
8/4/19,https://www.tribuneindia.com/news/punjab/rain-floods-abohar-village/812449.html,"residents said cracks had developed in some of the houses in mahindra colony, which is under 2-ft water",house,4,2,9,0,15,fazilka
7/29/19,https://www.tribuneindia.com/news/punjab/ludhiana-cycle-valley-to-be-operational-by-2022/809300.html, the minister said the cycle valley would be connected with the chandigarh-ludhiana national highway by constructing a 100-ft wide four-laned and 8.5-km long external road,house,0,11,5,1,17,ludhiana
7/29/19,https://www.tribuneindia.com/news/punjab/ludhiana-cycle-valley-to-be-operational-by-2022/809300.html," besides, two and four-laned roads would come up at the cycle valley with regard to which tenders have been opened for technical and financial bids and the allotment of work was under process",house,0,11,5,1,17,ludhiana
7/29/19,https://www.tribuneindia.com/news/punjab/ludhiana-cycle-valley-to-be-operational-by-2022/809300.html,spread over 383 acres¬†  the cycle valley is coming up over 383 acres at dhanansu village in ludhiana district as part of govt‚Äôs efforts to bolster the industrial sector¬†and create jobs the cycle valley will be connected with the chandigarh-ludhiana national highway by¬†constructing a 100-ft wide four-laned and 8.5-km long external road the project involves an investment of  rs 300 crore basic infrastructure is expected to be put in place by march 2021 ,house,0,11,5,1,17,ludhiana
7/24/19,https://www.tribuneindia.com/news/punjab/khalsa-aid-serves-ration-to-over-4-000-flood-victims-in-assam/807098.html,"at last count, 48.87 lakh people have been displaced from their homes.",house,12,1,6,0,19,punjab
7/23/19,https://www.tribuneindia.com/news/punjab/ghaggar-flood-capt-urges-haryana-to-join-hands-says-relief-after-survey/806555.html," in moonak, the cm ordered the dc to pay immediate compensation to the  28 houses damaged, three of them completely, as a result of the  flooding",house,3,30,40,3,76,"bathinda, patiala, sangrur"
7/23/19,https://www.tribuneindia.com/news/punjab/ghaggar-flood-capt-urges-haryana-to-join-hands-says-relief-after-survey/806555.html,he assured construction of 33 kucha houses that had been  damaged in the flooding,house,3,30,40,3,76,"bathinda, patiala, sangrur"
7/23/19,https://www.tribuneindia.com/news/punjab/ghaggar-flood-capt-urges-haryana-to-join-hands-says-relief-after-survey/806555.html, amarinder also announced rs 60 lakh for rebuilding the bridge that  had been damaged at sirkapda village of ghanaur,house,3,30,40,3,76,"bathinda, patiala, sangrur"
7/20/19,https://www.tribuneindia.com/news/punjab/cotton-on-6-500-hectares-inundated/804780.html," roofs of 4 more houses give way in abohar  abohar: after heavy rainfall for the past two days, roofs of four more houses collapsed here on thursday night",house,1,70,43,0,114,"bathinda, mansa"
7/19/19,https://www.tribuneindia.com/news/punjab/rain-water-enters-muktsar-villages-locals-blame-admn/804083.html," similarly, some residents of haraj village, said their village was the worst-hit in 2013 as the road link was snapped and they had remained isolated for days",house,8,9,22,0,39,sri muktsar sahib
7/15/19,https://www.tribuneindia.com/news/punjab/visa-free-travel-for-5-000-pilgrims-daily/802215.html,"ush({ }); also read: no flood threat as pak agrees to build bridge  sources said two or three more rounds of talks would be needed to clinch the final agreement, especially on the bridge over the ravi creek, essential to make the pilgrimage an all-weather affair",house,4,0,3,1,8,"amritsar, gurdaspur, sas nagar"
7/15/19,https://www.tribuneindia.com/news/punjab/visa-free-travel-for-5-000-pilgrims-daily/802215.html," pakistan has agreed in-principle to build the bridge at the earliest, said the ministry of external affairs, with india offering to make interim arrangements so that the corridor is operational when celebrations begin in november for the 550th birth anniversary of guru nanak",house,4,0,3,1,8,"amritsar, gurdaspur, sas nagar"
7/15/19,https://www.tribuneindia.com/news/punjab/visa-free-travel-for-5-000-pilgrims-daily/802215.html,"sources say the modalities regarding 5,000 pilgrims daily and 10,000 on special occasions, the fee (india wants it free) and the issue of a bridge will be negotiated in the subsequent meetings",house,4,0,3,1,8,"amritsar, gurdaspur, sas nagar"
7/15/19,https://www.tribuneindia.com/news/punjab/visa-free-travel-for-5-000-pilgrims-daily/802215.html,will meet deadlines: mha  october 31:  rs 500-cr passenger terminal complex at dera baba nanak to be completed september 30: four-lane road from gurdaspur-amritsar highway to zero point to be ready november: 550th birth anniversary of guru nanak dev is by when the govt wants infra to be in place ,house,4,0,3,1,8,"amritsar, gurdaspur, sas nagar"
7/15/19,https://www.tribuneindia.com/news/punjab/no-flood-threat-as-pak-agrees-to-build-bridge/802075.html,"ravi dhaliwal tribune news service  dera baba nanak, july 14  with pakistan finally agreeing to construct a 300-m-long bridge instead of a causeway till the international border (ib), the threat of floods in dera baba nanak town and its adjoining areas has subsided",house,2,0,4,0,6,ludhiana
7/15/19,https://www.tribuneindia.com/news/punjab/no-flood-threat-as-pak-agrees-to-build-bridge/802075.html,we informed them that the bridge coming up in our territory was 60 per cent complete,house,2,0,4,0,6,ludhiana
7/5/19,https://www.tribuneindia.com/news/punjab/pak-firm-on-causeway-likely-to-push-deadline/797199.html,"ravi dhaliwal  tribune news service  gurdaspur, july 4  the pakistan government‚Äôs insistence on constructing a causeway, instead of a bridge, on its side as a part of the kartarpur corridor project may indefinitely push back the october 31 deadline to complete the project",house,5,0,2,0,7,gurdaspur
7/5/19,https://www.tribuneindia.com/news/punjab/pak-firm-on-causeway-likely-to-push-deadline/797199.html," the pakistan government wants to build a 300-m-long causeway over a low-lying area till the border which, in turn, will join the 100-m-long bridge being constructed by india",house,5,0,2,0,7,gurdaspur
6/23/19,https://www.tribuneindia.com/news/punjab/pak-corridor-road-is-not-all-weather/791587.html," ‚Äúwe are confident of completing the road construction work by september 30, so the pilgrimage can begin by november,‚Äù said an official",house,2,0,3,1,6,gurdaspur
6/23/19,https://www.tribuneindia.com/news/punjab/pak-corridor-road-is-not-all-weather/791587.html,"ush({ });  since the gradient is towards the indian side and the ravi flood plain touched the border, ‚Äúwe have been making an elevated road on pillars up to the zero point‚Äù to avoid flooding of inhabited areas there and also to ensure that pilgrimage remained unhindered all through the year, the officials said",house,2,0,3,1,6,gurdaspur
6/23/19,https://www.tribuneindia.com/news/punjab/pak-corridor-road-is-not-all-weather/791587.html,"they, however, feel that despite indian efforts, the pilgrimage, as promised, may not be possible all through the year, as ‚Äúduring the last two interactions of technical teams, the pakistan side has so far not agreed to extend the bridge they are constructing¬† over the ravi up to the zero point and link it with the indian facility",house,2,0,3,1,6,gurdaspur
6/23/19,https://www.tribuneindia.com/news/punjab/pak-corridor-road-is-not-all-weather/791587.html," ‚Äúinstead, they propose to construct a 2.25-km causeway from the river to the international border, which will be lower than the elevation of the road on the indian side and will cause flooding in the inhabited areas, as it will obstruct free flow of river water,‚Äù said a senior official of the ministry of home affairs (mha), who was part of the technical negotiations",house,2,0,3,1,6,gurdaspur
6/23/19,https://www.tribuneindia.com/news/punjab/pak-corridor-road-is-not-all-weather/791587.html,matter raised: mha  we have been urging them to link their side of the road at zero point with ours at the same elevation,house,2,0,3,1,6,gurdaspur
4/16/19,https://www.tribuneindia.com/news/punjab/india-pak-officials-hold-technical-meeting-on-kartarpur-corridor/759230.html," during the previous meeting, both sides jointly surveyed the  coordinates of the zero point and discussed the technical details,  including finished road level, high flood level, etc",house,0,0,1,0,1,gurdaspur
3/20/19,https://www.tribuneindia.com/news/punjab/kartarpur-corridor-villagers-in-pak-demand-compensation-for-their-land/746196.html,"the entire population (600) of village kothay khurd, where gurdwara dera sahib kartarpur is located (some 125-km from lahore), has been ordered by the district administration to vacate their houses immediately for the development of the kartarpur corridor to facilitate the sikh pilgrims from india",house,17,16,19,7,59,gurdaspur
3/20/19,https://www.tribuneindia.com/news/punjab/kartarpur-corridor-villagers-in-pak-demand-compensation-for-their-land/746196.html,hussain said there has been consensus among the villagers to sacrifice their agricultural land but none of them is ready to leave their ancestral houses,house,17,16,19,7,59,gurdaspur
3/20/19,https://www.tribuneindia.com/news/punjab/kartarpur-corridor-villagers-in-pak-demand-compensation-for-their-land/746196.html,"both sides jointly surveyed the coordinates of the zero point and discussed technical aspects including finished road level, high flood level, etc",house,17,16,19,7,59,gurdaspur
1/2/19,https://www.tribuneindia.com/news/punjab/test-all-punjab-hand-pumps-for-arsenic-study/707473.html, the study found that 87 per cent of households that had hand pumps high in arsenic also had access to private hand pump with cleaner water within 100 m,house,2,1,8,1,12,"gurdaspur, tarn taran"
1/2/19,https://www.tribuneindia.com/news/punjab/test-all-punjab-hand-pumps-for-arsenic-study/707473.html,"normally, in a village of 90 to 100 households (on an average), there would be as many tube wells/hand pumps, but the government would be testing only eight to 10 installed by it",house,2,1,8,1,12,"gurdaspur, tarn taran"
11/25/18,https://www.tribuneindia.com/news/punjab/us-based-ngo-ready-with-design/688518.html, a decorative metal railing will also be provided on both sides of the bridges with light poles installed after every 100 ft,house,1,0,3,0,4,"amritsar, gurdaspur"
11/25/18,https://www.tribuneindia.com/news/punjab/us-based-ngo-ready-with-design/688518.html,"the design speaks of constructing a 400-ft-long bridge over the nullah, while the ravi bridge is sought to be 1,200 ft long",house,1,0,3,0,4,"amritsar, gurdaspur"
11/16/18,https://www.tribuneindia.com/news/punjab/two-hc-judges-to-be-sworn-in-today/683811.html, tns motorcyclist diesin road accidentmuktsar: a 40-year-old man died an accident on the jalalabad road here,house,5,2,3,1,11,"sangrur, sri muktsar sahib"
10/29/18,https://www.tribuneindia.com/news/punjab/r-sthan-dairy-products-flood-abohar-market/675249.html,"on a tip-off that a vehicle carrying hundreds of tins with sweets was offloaded on friday night, food security inspector gagandeep kaur on saturday raided a house in anand nagari here",house,0,0,2,0,2,sas nagar
9/27/18,https://www.tribuneindia.com/news/punjab/compensation-for-2017-still-due-fresh-girdawari-ordered/659578.html," subedar major satnam singh, who told the chief minister that ‚Äúhe helped him play polo in 1985‚Äù, raised the demand for a permanent bridge to connect majha and doaba near the site",house,6,30,25,5,66,"gurdaspur, hoshiarpur, kapurthala, tarn taran"
9/25/18,https://www.tribuneindia.com/news/punjab/red-alert-after-heavy-rain-schools-colleges-shut-today/658394.html, army on alert  the army has been asked to remain on alert to help the state deal with any eventuality the cm orders special girdawari to assess crop damage leave of irrigation and drainage staff cancelled¬† people advised to exercise restraint while moving out of their houses during the next 24 hours¬† ,house,6,4,13,0,23,punjab
6/25/18,https://www.tribuneindia.com/news/punjab/cisf-to-be-deployed-in-six-high-security-jails-in-punjab/610553.html,"  earlier, the additional chief secretary home informed the chief minister that out of the total 244 gangsters lodged in punjab prisons, 86 are ¬†a-category gangsters",house,5,1,4,0,10,punjab
4/1/18,https://www.tribuneindia.com/news/punjab/three-killed-as-bike-hits-tree/566939.html,"abohar, march 31  three youths were killed when the motorcycle they were riding, while returning to their native pakki tibbi village, hit a roadside tree on the highway, about 8 km from abohar, on friday night",house,7,6,5,0,18,faridkot
3/15/18,https://www.tribuneindia.com/news/punjab/more-fury-than-fire-image-takes-a-hit/557888.html,share of the government buses ‚Äî of prtc and punjab roadways ‚Äî has gone down in new transport policy ‚Äî from 75 to 50 per cent on national-highway routes and 60 to 40 per cent on state highways/district roads,house,30,76,15,11,132,"amritsar, bathinda, jalandhar, ludhiana, moga, pathankot, patiala, sas nagar, sbs nagar, tarn taran"
3/15/18,https://www.tribuneindia.com/news/punjab/more-fury-than-fire-image-takes-a-hit/557888.html,"‚Äî¬†capt amarinder singh, incharge, home  cityscape huge pile to clear what‚Äôs done  forensic audit currently under way by global consultant grant thorton of the infrastructure works carried out by the urban local bodies department of the state",house,30,76,15,11,132,"amritsar, bathinda, jalandhar, ludhiana, moga, pathankot, patiala, sas nagar, sbs nagar, tarn taran"
3/15/18,https://www.tribuneindia.com/news/punjab/more-fury-than-fire-image-takes-a-hit/557888.html,"to provide housing for poor, reservation for scheduled castes was increased from 15% to 30% in all schemes pertaining to allotment of plots/houses",house,30,76,15,11,132,"amritsar, bathinda, jalandhar, ludhiana, moga, pathankot, patiala, sas nagar, sbs nagar, tarn taran"
3/2/18,https://www.tribuneindia.com/news/punjab/pulanwala-baba-gifts-another-bridge/552088.html,"arun sharma tribune news service ropar, march 1  while the successive governments failed to provide proper connectivity to people in the state for long, sikh saint baba labh singh (kila anandgarh) at anandpur sahib has brought succour to lakhs of people by building seven bridges in punjab and haryana",house,17,1,16,1,35,punjab
3/2/18,https://www.tribuneindia.com/news/punjab/pulanwala-baba-gifts-another-bridge/552088.html," while six bridges built by the baba are already operational, the seventh such bridge, costing rs 10 crore, will be opened for public at shahpur bela village, near kiratpur sahib, on saturday",house,17,1,16,1,35,punjab
3/2/18,https://www.tribuneindia.com/news/punjab/pulanwala-baba-gifts-another-bridge/552088.html," the 600-ft-long and 18-ft-wide bridge will bring succour to 400 residents, who till now were using a boat provided by the irrigation department in the name of connectivity with the main road during rainy season",house,17,1,16,1,35,punjab
3/2/18,https://www.tribuneindia.com/news/punjab/pulanwala-baba-gifts-another-bridge/552088.html," foreman kamaldev, who look after all the construction work starting from the design of the bridge, said two years ago a 670 ft bridge at nearby burj village was opened for public on february 13, 2016, reducing the distance between several villages and anandpur sahib from 22 to a mere 7 km",house,17,1,16,1,35,punjab
3/2/18,https://www.tribuneindia.com/news/punjab/pulanwala-baba-gifts-another-bridge/552088.html, earlier five such bridges ‚Äî four on the sutlej in the surrounding areas of anandpur sahib and one over the ghaggar in fatehabad district of haryana ‚Äî were built by him without any help from the state governments,house,17,1,16,1,35,punjab
2/14/18,https://www.tribuneindia.com/news/punjab/roadmap-to-control-prices-of-veggies-soon-harsimrat/543722.html,"tribune news service  new delhi, february 13 food processing minister harsimrat kaur badal today said the centre would soon draw a roadmap to control the soaring prices of tomato, onions and potatoes (top)",house,0,9,1,0,10,punjab
1/5/18,https://www.tribuneindia.com/news/punjab/after-10-years-asafwala-bridge-repaired/523671.html,"after 10 years, asafwala bridge repaired",house,4,3,10,0,17,punjab
1/5/18,https://www.tribuneindia.com/news/punjab/after-10-years-asafwala-bridge-repaired/523671.html,"our correspondent  abohar, january 4 after a 10-year-long wait, the asafwala bridge was finally renovated giving relief to hundreds of villagers",house,4,3,10,0,17,punjab
1/5/18,https://www.tribuneindia.com/news/punjab/after-10-years-asafwala-bridge-repaired/523671.html,the bridge on the asafwala drain on the abohar-kandhwala amarkot road had been damaged for the last 10 years,house,4,3,10,0,17,punjab
1/5/18,https://www.tribuneindia.com/news/punjab/after-10-years-asafwala-bridge-repaired/523671.html,"about a month ago, when sdm poonam singh inspected some of the damaged bridges, she was told that hundreds of vehicles passed through 32 damaged bridges in the abohar subdivision",house,4,3,10,0,17,punjab
11/8/17,https://www.tribuneindia.com/news/punjab/govt-all-fogged-up-on-road-safety-measures/494182.html,"vishav bharti tribune news service chandigarh, november 7 more than 600 people lose lives in road accidents caused by fog every year in the state, but the government is sleeping over the standard protocol developed to ensure safe road transportation during foggy weather conditions",house,4,1,1,0,6,punjab
11/8/17,https://www.tribuneindia.com/news/punjab/govt-all-fogged-up-on-road-safety-measures/494182.html,"as per ‚Äúaccidents in india‚Äù, a report of the ministry of road transport & highways, on an average 825 accidents took place due to fog every year in the past three years",house,4,1,1,0,6,punjab
8/23/17,https://www.tribuneindia.com/news/punjab/no-mc-help-residents-pool-in-money-to-get-streets-repaired/455958.html,"sanjiv kumar bakshi hoshiarpur, august 22  irked over the municipal corporation ‚Äúinaction‚Äù in getting the streets and drains repaired, residents of sheikhan mohalla here have taken on the task of repairing these themselves by pooling in money",house,18,0,3,5,26,hoshiarpur
8/23/17,https://www.tribuneindia.com/news/punjab/no-mc-help-residents-pool-in-money-to-get-streets-repaired/455958.html,ush({ });  this became a turning point and the people of chhatti gali got the repair of the street and drains done on the same lines,house,18,0,3,5,26,hoshiarpur
8/23/17,https://www.tribuneindia.com/news/punjab/no-mc-help-residents-pool-in-money-to-get-streets-repaired/455958.html, ‚Äúi had got development works of rs 38 lakh passed in the house but they could not be started,house,18,0,3,5,26,hoshiarpur
8/21/17,https://www.tribuneindia.com/news/punjab/floods-push-biharis-to-punjab/455235.html,"‚Äúwe lost our house, two cows and a goat in the floods",house,7,11,14,0,32,"amritsar, bathinda, jalandhar, ludhiana, patiala"
7/31/17,https://www.tribuneindia.com/news/punjab/polls-probes-kept-officials-busy-flooding-may-be-the-price-to-pay/444763.html,"as a safeguard, we have raised the plinth of our houses by 10-15 feet,‚Äù he says",house,0,18,10,0,28,"fatehgarh sahib, hoshiarpur, jalandhar, kapurthala, ludhiana, patiala, sas nagar, sbs nagar"
7/14/17,https://www.tribuneindia.com/news/punjab/two-gurdaspur-girls-drown-while-attempting-to-click-selfie/436583.html,"ravi dhaliwal       tribune news service gurdaspur, july 14 two young girls from gurdaspur drowned while allegedly attempting to click a selfie from the edge of a bridge on friday morning",house,9,0,3,0,12,gurdaspur
7/14/17,https://www.tribuneindia.com/news/punjab/two-gurdaspur-girls-drown-while-attempting-to-click-selfie/436583.html," college student lovepreet kaur masih (21) and her friend nisha (18), a school girl, were clicking selfies when nisha, who was perched dangerously on the edge of the sathiali bridge, suddenly slipped and fell into the canal",house,9,0,3,0,12,gurdaspur
1/16/17,https://www.tribuneindia.com/news/politics/bjp-s-punjab-list-of-6-likely-today/350984.html," for the 403-member uttar pradesh assembly and the 70-member uttarakhand house, the bjp is facing a flood of applications",house,1,0,2,0,3,sbs nagar
12/17/16,https://www.tribuneindia.com/news/community/note-ban-nris-cancelling-trips/337887.html,"sanjeev singh bariana tribune news service chandigarh, december 16  affected by a flood of images of people queuing up outside banks and atm kiosks to withdraw money following demonetisation, nris are cancelling travel plans to their homeland punjab this winter",house,2,5,4,7,18,"hoshiarpur, jalandhar"
5/12/16,https://www.tribuneindia.com/news/community/youths-had-sent-selfies-to-kin-just-before-tragedy/235579.html,"the three injured boys have been discharged from the hospital there but they are yet to reach home,‚Äù she said.",house,5,1,7,0,13,"jalandhar, sbs nagar"
1/9/16,https://www.tribuneindia.com/news/community/fresh-alert-along-border-in-pathankot/180983.html," the army is using drone helicopters to locate possible terrorists and pressed into service bullet-proof vehicles, officials said",house,3,0,6,0,9,"gurdaspur, pathankot"
8/12/15,https://www.tribuneindia.com/news/community/sutlej-swells-moga-village-houses-flooded/118742.html," he demanded that the government should construct a ring road with a height of 7 to 8 feet around the village, which would work as a ‚Äòbundh‚Äô and keep the river water from entering residential areas",house,7,14,22,0,43,moga
7/29/15,https://www.tribuneindia.com/news/punjab/bundh-not-strengthened-50-villages-face-flood-threat/112650.html," deputy commissioner dps kharbanda along with officials from drainage, police, home guards, ndrf and revenue departments today visited the advance protection bundh along dhussi and flood-prone villages in zira tehsil",house,0,1,13,0,14,"ferozepur, jalandhar, moga"
7/29/15,https://www.tribuneindia.com/news/punjab/bundh-not-strengthened-50-villages-face-flood-threat/112650.html,he said the railways had been asked to expedite the work on the extension of embankment up to the rail track near gidarpindi-lohian rail bridge between ferozepur and jalandhar to plug 25-ft split,house,0,1,13,0,14,"ferozepur, jalandhar, moga"
7/29/15,https://www.tribuneindia.com/news/punjab/bundh-not-strengthened-50-villages-face-flood-threat/112650.html,the dc said rs 16 crore would be spent on the construction of bridge between kimewala and jogewala,house,0,1,13,0,14,"ferozepur, jalandhar, moga"
5/29/15,https://www.tribuneindia.com/news/governance/focus-on-key-pockets-not-on-all-round-development/86517.html,bathinda  harsimrat kaur badal (sad) questions asked: ---  mp lad funds utilised: rs 3.53 crore attendance: --- initiatives taken¬†  revival of new delhi-bathinda shatabdi express rs 136 crore food park at dabwala kalan in fazilka¬† participated in parlance for rs 5 lakh relief to 1984 riot victims played important role in getting an aiims for the state completion of ring road phase ii connecting bathinda-malout road with bathinda-badal road¬†  unkept promises(adsbygoogle = window,house,22,24,22,1,69,"amritsar, bathinda, fatehgarh sahib, fazilka, ferozepur, gurdaspur, jalandhar, pathankot, sangrur, sas nagar"
5/29/15,https://www.tribuneindia.com/news/governance/focus-on-key-pockets-not-on-all-round-development/86517.html,"during my last three terms as an mp, i had promised to get bridges constructed over the ravi, ujh and beas to improve road connectivity of gurdaspur with other cities and i delivered on that front",house,22,24,22,1,69,"amritsar, bathinda, fatehgarh sahib, fazilka, ferozepur, gurdaspur, jalandhar, pathankot, sangrur, sas nagar"
5/29/15,https://www.tribuneindia.com/news/governance/focus-on-key-pockets-not-on-all-round-development/86517.html,i got constructed nearly six bridges,house,22,24,22,1,69,"amritsar, bathinda, fatehgarh sahib, fazilka, ferozepur, gurdaspur, jalandhar, pathankot, sangrur, sas nagar"
5/29/15,https://www.tribuneindia.com/news/governance/focus-on-key-pockets-not-on-all-round-development/86517.html," jalandhar  chaudhary santokh singh (cong) questions asked: 18 attendance: 97%  mp lad funds utilised: rs 1.75 crore initiatives taken  sanctioned funds for construction of girls‚Äô toilets at government schools¬† adopted ganna village in phillaur under the centre‚Äôs village adoption programme took up the matter of levy of 12.36 per cent service tax on remittances by nris with the directorate general of service tax demanded construction of railway over-bridges at guru nanakpura, ram nagar, goraya-rurka road and phillaur-numahal stretch supported cantonment residents seeking abolition of octroi¬†  unkept promises  no steps taken to provide relief to the sports industry a cluster for hand tool industry still awaited dry port project in doaba region failed to take off did nothing for revival of punjab institute of medical sciences¬† no improvement in civic amenities in the city   representing jalandhar where the sc population is as high as 33 per cent, the mp has been consistently raising the matter pertaining to ‚Äúdiversion‚Äù of funds for dalits for other purposes by the state government",house,22,24,22,1,69,"amritsar, bathinda, fatehgarh sahib, fazilka, ferozepur, gurdaspur, jalandhar, pathankot, sangrur, sas nagar"
5/29/15,https://www.tribuneindia.com/news/governance/focus-on-key-pockets-not-on-all-round-development/86517.html," performance in parliament  the 18 questions chaudhary santokh singh has asked pertain to poor lifting of wheat from mandis, manned and unmanned railway crossings in the country, cases of accidents pending with the railway tribunal and their status, old-age persons in the country who are below poverty line, rewards for medal winner sportspersons in punjab and state-wise fund allocation for roads covered under the pradhan mantri gram sadak yojna",house,22,24,22,1,69,"amritsar, bathinda, fatehgarh sahib, fazilka, ferozepur, gurdaspur, jalandhar, pathankot, sangrur, sas nagar"
5/29/15,https://www.tribuneindia.com/news/governance/focus-on-key-pockets-not-on-all-round-development/86517.html, fatehgarh sahib  harinder singh khalsa (aap) questions asked: 23 attendance: 86%  mplad funds utilised: rs 1.23 crore initiatives taken  sanctioned rs 1.23 crore for the repair of roads and drainage in rural areas¬†unkept promises¬† failed to bring back industry that shifted out from mandi gobindgarh¬† failed to decrease unemployment couldn‚Äôt set up a technical training institute for youth   harinder singh khalsa served as a member of parliament (mp) from bathinda during 1996-98 as a member of the shiromani akali dal,house,22,24,22,1,69,"amritsar, bathinda, fatehgarh sahib, fazilka, ferozepur, gurdaspur, jalandhar, pathankot, sangrur, sas nagar"
5/29/15,https://www.tribuneindia.com/news/governance/focus-on-key-pockets-not-on-all-round-development/86517.html,"ferozepur¬†  sher singh ghubaya (sad) questions asked: 14 attendance: 78%  mp lad funds utilised: rs 3.75 crore initiatives taken  sanctioned money for ro plants and toilets in schools spent rs 1.40 crore on the purchase of water tankers for panchayats was instrumental in getting ferozepur-chandigarh express resumed adopted dhandi qadim village in jalalabad to bring about its development raised the issue of poor rail and road connectivity in the region¬†  unkept promises  failed to reopen the hussainiwala border for trade and transit couldn‚Äôt reduce unemployment in this border region failed to review outdated laws in the cantonment area couldn‚Äôt compensate border farmers with land holdings across the fence didn‚Äôt connect ferozepur with shatabadi express   from being an accountant at a brick kiln to a two-time parliamentarian, ferozepur mp sher singh ghubaya today is one of the tallest ‚Äúrai sikh‚Äù leaders in the state",house,22,24,22,1,69,"amritsar, bathinda, fatehgarh sahib, fazilka, ferozepur, gurdaspur, jalandhar, pathankot, sangrur, sas nagar"
5/29/15,https://www.tribuneindia.com/news/governance/focus-on-key-pockets-not-on-all-round-development/86517.html," --congress leader, sunil jakhar¬† sangrur¬†  bhagwant mann (aap) questions asked: 25  mp lad funds utilised: rs 2.61 crore attendance: 79% initiatives taken  sanctioned rs 56.30 lakh for government school buildings gave rs 46 lakh for setting up ro systems in government schools four ambulances provided to government hospitals, five to ngos street lights installed at several places gyms upgraded and sports equipment provided to clubs  unkept promises  failed to check corruption in a big way¬† despite taking on the ruling badals over the drug menace in the run up to the lok sabha elections, he failed to take concrete steps in this regard¬†   going through the works done for the welfare of common man by the mp and his performance in parliament in the past one year, he can be considered as an mp of the masses",house,22,24,22,1,69,"amritsar, bathinda, fatehgarh sahib, fazilka, ferozepur, gurdaspur, jalandhar, pathankot, sangrur, sas nagar"
3/18/15,https://www.tribuneindia.com/news/punjab/punjab-budget-speech-text/55244.html,"the complete text of punjab finance minister¬†parminder singh dhindsa's budget speech, presented in the state assembly on wednesday:  (there may be certain discrepancies in the formatting of the matter as reproduced from the text supplied by the punjab government) part a hon‚Äôble speaker sir, it is my privilege to present before this august house, the fourth consecutive budget of the re-elected shiromani akali dal and bhartiya janta party alliance government for the year 2015-16",house,#N/A,#N/A,#N/A,#N/A,#N/A,#N/A
3/18/15,https://www.tribuneindia.com/news/punjab/punjab-budget-speech-text/55244.html,before i present the fiscal indicators i am glad to inform the house that the 14th¬†finance commission (fc) in its recommendations has increased the share of¬†punjab¬†in central taxes from 1.389% to 1.577%,house,#N/A,#N/A,#N/A,#N/A,#N/A,#N/A
3/18/15,https://www.tribuneindia.com/news/punjab/punjab-budget-speech-text/55244.html,i am also happy to share with the august house that the 14th¬†finance commission has also recognised the fiscal turnaround of the state due to efforts made by our government and has therefore removed it from the list of states needing revenue deficit grant,house,#N/A,#N/A,#N/A,#N/A,#N/A,#N/A
3/18/15,https://www.tribuneindia.com/news/punjab/punjab-budget-speech-text/55244.html,"sir, i put forth yet another proposal to fulfil the dream of providing ‚Äúaffordable housing for all‚Äù, that 50,000 houses for ews will be constructed in next two years in collaboration with hudco and will be allotted to the beneficiaries under the scheme on emi payable in 20 years",house,#N/A,#N/A,#N/A,#N/A,#N/A,#N/A
3/18/15,https://www.tribuneindia.com/news/punjab/punjab-budget-speech-text/55244.html,"i am glad to announce the launch of the ‚Äòpunjab urban development mission‚Äô under which 100% water supply, sewerage, stp, road & streetlights will be provided in all the cities by the year 2017",house,#N/A,#N/A,#N/A,#N/A,#N/A,#N/A
3/18/15,https://www.tribuneindia.com/news/punjab/punjab-budget-speech-text/55244.html, i am pleased to share with the house that the world bank 11 has approved the 2nd¬†punjab rural water supply and sanitation project spread over six years (2015-16 to 2020-21) with a total cost of rs 2200 crore,house,#N/A,#N/A,#N/A,#N/A,#N/A,#N/A
3/18/15,https://www.tribuneindia.com/news/punjab/punjab-budget-speech-text/55244.html,the convergence of the project with swachh bharat mission (gramin) would ensure individual toilets for every household in the state by 2018,house,#N/A,#N/A,#N/A,#N/A,#N/A,#N/A
3/18/15,https://www.tribuneindia.com/news/punjab/punjab-budget-speech-text/55244.html,this scheme will provide protection to around 1.50 crore population of economically weaker households from financial liabilities arising out of health shocks that involve hospitalization,house,#N/A,#N/A,#N/A,#N/A,#N/A,#N/A
3/18/15,https://www.tribuneindia.com/news/punjab/punjab-budget-speech-text/55244.html,"¬∑¬†¬†¬†¬†¬†¬†¬†¬†¬†medicity phase-ii-160 acres of land acquired, of which 10 acres of land allotted to the max healthcare institute,chaitanya¬†hospital, jindal ivf nursing home and grewal eye institute",house,#N/A,#N/A,#N/A,#N/A,#N/A,#N/A
3/18/15,https://www.tribuneindia.com/news/punjab/punjab-budget-speech-text/55244.html,"india‚Äôs largest roof top solar power plant of capacity 7.50 mw has been commissioned at dera beas district amritsar and world‚Äôs largest cattle dung based bio cng plant is under implementation at haiboval dairy complex,¬†ludhiana",house,#N/A,#N/A,#N/A,#N/A,#N/A,#N/A
3/18/15,https://www.tribuneindia.com/news/punjab/punjab-budget-speech-text/55244.html,state government has notified net metering policy to give major thrust to the solar roof top programme in the state with a target to cover 1 lakh homes in next 3 years,house,#N/A,#N/A,#N/A,#N/A,#N/A,#N/A
3/18/15,https://www.tribuneindia.com/news/punjab/punjab-budget-speech-text/55244.html,a pilot project for roof top programme exclusively for sc population has been included with an outlay of rs 1.50 crore in annual plan 2015-16,house,#N/A,#N/A,#N/A,#N/A,#N/A,#N/A
3/18/15,https://www.tribuneindia.com/news/punjab/punjab-budget-speech-text/55244.html,i propose an allocation of rs 10 crore for focal points and rs 1 crore for northern india institute of fashion technology (nifft) scheme roads & bridges 61,house,#N/A,#N/A,#N/A,#N/A,#N/A,#N/A
3/18/15,https://www.tribuneindia.com/news/punjab/punjab-budget-speech-text/55244.html, a sum of rs 2018 crore is proposed to be spent on road infrastructure in the year 2015-16,house,#N/A,#N/A,#N/A,#N/A,#N/A,#N/A
3/18/15,https://www.tribuneindia.com/news/punjab/punjab-budget-speech-text/55244.html, the major scheme wise allocations for the year 2015-16 are: ¬∑¬†¬†¬†¬†¬†¬†¬†¬†¬†rs 700 crore ‚Äì strengthening of rural roads,house,#N/A,#N/A,#N/A,#N/A,#N/A,#N/A
3/18/15,https://www.tribuneindia.com/news/punjab/punjab-budget-speech-text/55244.html,¬∑¬†¬†¬†¬†¬†¬†¬†¬†¬†rs 100 crore under punjab state road sector project for strengthening of 150 km roads,house,#N/A,#N/A,#N/A,#N/A,#N/A,#N/A
3/18/15,https://www.tribuneindia.com/news/punjab/punjab-budget-speech-text/55244.html,¬∑¬†¬†¬†¬†¬†¬†¬†¬†¬†rs 100 crore ‚Äì nabard assisted projects for construction of widening of roads and construction of bridges,house,#N/A,#N/A,#N/A,#N/A,#N/A,#N/A
3/18/15,https://www.tribuneindia.com/news/punjab/punjab-budget-speech-text/55244.html,¬∑¬†¬†¬†¬†¬†¬†¬†¬†¬†rs 150 crore ‚Äì special repair of plan roads,house,#N/A,#N/A,#N/A,#N/A,#N/A,#N/A
3/18/15,https://www.tribuneindia.com/news/punjab/punjab-budget-speech-text/55244.html,¬∑¬†¬†¬†¬†¬†¬†¬†¬†¬†rs 66 crore high level bridges,house,#N/A,#N/A,#N/A,#N/A,#N/A,#N/A
3/18/15,https://www.tribuneindia.com/news/punjab/punjab-budget-speech-text/55244.html,¬∑¬†¬†¬†¬†¬†¬†¬†¬†¬†rs 70 crore towards centre road fund for upgradation of existing road infrastructure,house,#N/A,#N/A,#N/A,#N/A,#N/A,#N/A
3/18/15,https://www.tribuneindia.com/news/punjab/punjab-budget-speech-text/55244.html,is committed to provide safer and affordable travelling facilities to the people through operation of 1680 buses owned by punjab roadways/punbus,house,#N/A,#N/A,#N/A,#N/A,#N/A,#N/A
3/18/15,https://www.tribuneindia.com/news/punjab/punjab-budget-speech-text/55244.html,the proposals planned for 2015-16:- ¬∑¬†¬†¬†¬†¬†¬†¬†¬†¬†rs 42.75 crore ‚Äì introduction of 225 new buses in punjab roadways,house,#N/A,#N/A,#N/A,#N/A,#N/A,#N/A
3/18/15,https://www.tribuneindia.com/news/punjab/punjab-budget-speech-text/55244.html,¬∑¬†¬†¬†¬†¬†¬†¬†¬†¬†replacement of existing fleet of punjab roadways with 265 loan free buses from punbus,house,#N/A,#N/A,#N/A,#N/A,#N/A,#N/A
3/18/15,https://www.tribuneindia.com/news/punjab/punjab-budget-speech-text/55244.html," i am glad to share with the august house that children with special needs from the state participated in 11 national sports championships and won 6 gold, 17 silver and 13 bronze medals",house,#N/A,#N/A,#N/A,#N/A,#N/A,#N/A
3/18/15,https://www.tribuneindia.com/news/punjab/punjab-budget-speech-text/55244.html,¬∑¬†¬†¬†¬†¬†¬†¬†¬†¬†rs 4.21 crore- for construction of sainik rest houses for newly created districts,house,#N/A,#N/A,#N/A,#N/A,#N/A,#N/A
3/18/15,https://www.tribuneindia.com/news/punjab/punjab-budget-speech-text/55244.html,"¬∑¬†¬†¬†¬†¬†¬†¬†¬†¬†under national optical fibre network (nofn), broadband connectivity to more than 12000 gram panchayats of the state will be provided",house,#N/A,#N/A,#N/A,#N/A,#N/A,#N/A
3/18/15,https://www.tribuneindia.com/news/punjab/punjab-budget-speech-text/55244.html,an amount of rs 65 crore has been disbursed through¬†aadhaar¬†payment¬†bridge¬†to 1.56 lac beneficiaries under various schemes of the departments of welfare of scheduled castes and backward classes and social security and women & child development,house,#N/A,#N/A,#N/A,#N/A,#N/A,#N/A
3/18/15,https://www.tribuneindia.com/news/punjab/punjab-budget-speech-text/55244.html,"speaker, sir, i now present before this august house the budget estimates for the financial year 2015-16 which are as under: budget at a glance 105",house,#N/A,#N/A,#N/A,#N/A,#N/A,#N/A
3/18/15,https://www.tribuneindia.com/news/punjab/punjab-budget-speech-text/55244.html,"sir, with these words, i commend the budget proposals of rs79314 crore and the annual plan for rs 21174 crore for the year 2015-16 to this august house for approval",house,#N/A,#N/A,#N/A,#N/A,#N/A,#N/A
3/19/15,https://www.tribuneindia.com/news/punjab/dhindsa-takes-safe-route-shies-away-from-imposing-fresh-taxes/55207.html,"but he failed to specify a roadmap for additional resource mobilisation of rs 1,300 crore to fund these proposals",house,0,2,1,2,5,punjab
3/3/15,https://www.tribuneindia.com/news/community/3-of-family-die-in-roof-collapse/48956.html,3 of family die in roof collapse,house,11,2,8,0,21,"patiala, sas nagar"
3/3/15,https://www.tribuneindia.com/news/community/3-of-family-die-in-roof-collapse/48956.html,"tribune news service  patiala, march 2 three members of a family, including two children, were killed in bharat nagar, patiala, when the roof of their house collapsed because of heavy rainfall last night",house,11,2,8,0,21,"patiala, sas nagar"
10/27/19,https://www.tribuneindia.com/news/punjab/dengue-scare-in-ludhiana-10-year-old-girl-dies/852773.html," the area residents accused the municipal corporation, ludhiana, for ignoring water accumulation on roads and vacant plots in ward 28 as the sewers remained defunct for the past more than one year",house,18,0,2,0,20,ludhiana
9/1/19,https://www.tribuneindia.com/news/punjab/floods-take-toll-on-houses-villagers-staying-outdoors/825853.html,"mundi shehrian/mandala channa, august 31¬†  as many as 3,000 houses and other buildings have been damaged in the district due to floods in the past fortnight",house,10,9,60,0,79,punjab
9/1/19,https://www.tribuneindia.com/news/punjab/floods-take-toll-on-houses-villagers-staying-outdoors/825853.html,"  more than 50 buildings ‚Äîmany of them kutcha houses or huts ‚Äî have been damaged in dhakka basti in gatta mundi kasu village, which is one of the completely washed out and cut-off areas",house,10,9,60,0,79,punjab
9/1/19,https://www.tribuneindia.com/news/punjab/floods-take-toll-on-houses-villagers-staying-outdoors/825853.html,"  as per the administration, 50 villages (30 severely affected) in the district are inundated ‚Äî all have an average of 200 to 250 houses, many of which have developed cracks",house,10,9,60,0,79,punjab
9/1/19,https://www.tribuneindia.com/news/punjab/floods-take-toll-on-houses-villagers-staying-outdoors/825853.html,"  as per the norms, rs 95,100 shall be paid to fully damaged pucca/kutcha houses, for partial (15%) damage rs 5,200 for pucca and rs 3,200 for kutcha houses; and rs 4,100 shall be paid for damaged huts and rs 2,100 for cattle sheds",house,10,9,60,0,79,punjab
9/1/19,https://www.tribuneindia.com/news/punjab/floods-take-toll-on-houses-villagers-staying-outdoors/825853.html,"  sarwan singh of mundi shehrian village said, ‚Äúour 50-year-old house is full of sludge and though it‚Äôs standing, we don‚Äôt know when it might collapse",house,10,9,60,0,79,punjab
9/1/19,https://www.tribuneindia.com/news/punjab/floods-take-toll-on-houses-villagers-staying-outdoors/825853.html,"¬†¬†  dc varinder kumar sharma said, ‚Äúaround 3,000 houses and other buildings have been damaged",house,10,9,60,0,79,punjab
8/29/19,https://www.tribuneindia.com/news/punjab/villagers-stay-up-to-ward-off-mosquitoes-snakes/824266.html,the condition of the villagers who are spending 24 hours on their roofs can‚Äôt be explained in words,house,17,1,14,0,32,jalandhar
8/26/19,https://www.tribuneindia.com/news/punjab/inflow-from-pak-still-on-army-ndrf-on-alert/822775.html," jagjit kumar, who owns eight acres, said the state should either construct a pontoon bridge or at least provide them a new boat",house,16,10,27,1,54,ferozepur
8/23/19,https://www.tribuneindia.com/news/punjab/2-500-in-38-camps-enough-food-but-no-facilities/821304.html,"in jalandhar, 1,025 persons have been housed at eight camps in shahkot, of which one closed today after being flooded, 751 have been housed in 18 camps at phillaur and in kapurthala 600 were housed in six camps (all of which will be shut tomorrow onwards)",house,19,3,15,0,37,"jalandhar, kapurthala"
8/23/19,https://www.tribuneindia.com/news/punjab/2-500-in-38-camps-enough-food-but-no-facilities/821304.html,nearly 500 persons displaced in lohian have been housed at the relief camp at lohian khas alone,house,19,3,15,0,37,"jalandhar, kapurthala"
8/21/19,https://www.tribuneindia.com/news/punjab/one-month-on-muktsar-village-still-swamped/820165.html,"archit watts tribune news service udekaran (muktsar), august 20  over a month after the rain, which brought miseries to residents of udekaran village on the outskirts of muktsar town, nearly 45 families are yet to return to their houses",house,5,2,20,0,27,sri muktsar sahib
8/21/19,https://www.tribuneindia.com/news/punjab/one-month-on-muktsar-village-still-swamped/820165.html," rani, a resident of manga basti where she has a two-room kutcha house, said: ‚Äúwe are now living in a rented house in muktsar and paying rs 2,500 per month",house,5,2,20,0,27,sri muktsar sahib
8/20/19,https://www.tribuneindia.com/news/punjab/over-60-jalandhar-villages-inundated/819821.html,"in all, there were nine breaches in the rivers, inundating fields and some houses in villages",house,21,29,37,0,87,"jalandhar, kapurthala"
8/20/19,https://www.tribuneindia.com/news/punjab/over-60-jalandhar-villages-inundated/819821.html,we rescued at least 15 to 20 persons from deras (fields houses) before the administration stepped in,house,21,29,37,0,87,"jalandhar, kapurthala"
8/19/19,https://www.tribuneindia.com/news/punjab/rain-wreaks-havoc-4-die-in-roof-collapse/819437.html,"rain wreaks havoc, 4 die in roof collapse",house,18,3,16,3,40,"fatehgarh sahib, patiala, sbs nagar"
8/19/19,https://www.tribuneindia.com/news/punjab/rain-wreaks-havoc-4-die-in-roof-collapse/819437.html," three members of a family, including a minor boy, died when the roof of their house collapsed in hole village near khanna",house,18,3,16,3,40,"fatehgarh sahib, patiala, sbs nagar"
8/19/19,https://www.tribuneindia.com/news/punjab/rain-wreaks-havoc-4-die-in-roof-collapse/819437.html," toddler washed away  ropar: a three-year-old daughter of a watchman, identified as sundri, was feared drowned when water flooded their house situated in a low-lying area of ropar district on sunday",house,18,3,16,3,40,"fatehgarh sahib, patiala, sbs nagar"
8/18/19,https://www.tribuneindia.com/news/punjab/budhki-sarsa-rivers-in-spate-admn-orders-evacuation-of-dozens-of-villages/819303.html,"meanwhile, a three-year-old son of a watchman at a private school feared drowned when the water flooded his house situated in the low-lying area of the building.",house,12,2,23,0,37,punjab
8/3/19,https://www.tribuneindia.com/news/punjab/rain-leaves-trail-of-destruction-in-muktsar/812092.html,"ush({ });  meanwhile, some residents claimed that no official came to remove the trees from the muktsar-gidderbaha road till 9 am on friday",house,3,3,13,0,19,"bathinda, sri muktsar sahib"
7/24/19,https://www.tribuneindia.com/news/punjab/will-take-up-ghaggar-issue-with-centre-cm/806748.html,"we will try to complete it as soon as the water recedes and immediately release compensation after receiving the report,‚Äù he said, adding that he had ordered the dc to pay compensation for damage to 28 houses (three of them completely) as a result of flooding",house,3,28,14,4,49,"patiala, sangrur"
7/20/19,https://www.tribuneindia.com/news/punjab/ghaggar-breach-destroys-paddy/804677.html,"the nearly 100-foot-wide breach occurred on thursday morning, inundating salemarh, moonak, phullad and surrounding villages, forcing residents to move to rooftops",house,7,22,18,1,48,sangrur
7/18/19,https://www.tribuneindia.com/news/punjab/deluge-throws-life-out-of-gear-in-bathinda/803585.html,"tribune news service bathinda, july 17  it‚Äôs a double whammy for city residents as many roads and localities remained submerged in water for the second consecutive day, while some areas have not received power from the last more than 37 hours",house,7,1,21,0,29,"bathinda, mansa, sas nagar"
6/12/19,https://www.tribuneindia.com/news/punjab/35-km-from-capital-no-road-leads-to-ropar-s-tanda/786596.html,"35 km from capital, no road leads to ropar‚Äôs tanda",house,11,12,9,0,32,punjab
6/12/19,https://www.tribuneindia.com/news/punjab/35-km-from-capital-no-road-leads-to-ropar-s-tanda/786596.html,"arun sharma tribune news service ropar, june 11  tanda village in ropar block is hardly 35 km from the state capital, but has no road connectivity",house,11,12,9,0,32,punjab
6/12/19,https://www.tribuneindia.com/news/punjab/35-km-from-capital-no-road-leads-to-ropar-s-tanda/786596.html,"the 2-km dirt track that connects the village with the purkhali-bardar road remains inundated during the monsoon, leaving this sub-mountainous area inaccessible as two choes fall on the section",house,11,12,9,0,32,punjab
2/25/19,https://www.tribuneindia.com/news/punjab/coming-to-rescue-of-alma-mater/734242.html,"ravi dhaliwal tribune news service gurdaspur, february 24  there are numerous stories of punjabis making it big abroad but there are some who also pay back to their motherland",house,5,2,10,2,19,"gurdaspur, ludhiana"
6/18/18,https://www.tribuneindia.com/news/punjab/relief-from-dust-but-streets-flooded/607003.html,"our correspondent  abohar, june 17 rains that lashed abohar and neighbouring segments on sunday gave relief from dust, but disrupted power supply and left streets inundated",house,0,0,4,0,4,sas nagar
5/15/18,https://www.tribuneindia.com/news/punjab/minister-monitors-sampling-of-highway-material-in-abohar/589406.html,"ush({ });speaking to the media, singla said a rs 267-crore project was submitted to nabard for construction of roads in the first phase",house,2,1,1,1,5,punjab
5/15/18,https://www.tribuneindia.com/news/punjab/minister-monitors-sampling-of-highway-material-in-abohar/589406.html,‚Äúwe expect to get rs 425 crore from nabard to repair link roads in rural areas,house,2,1,1,1,5,punjab
5/15/18,https://www.tribuneindia.com/news/punjab/minister-monitors-sampling-of-highway-material-in-abohar/589406.html,"the work on the fourth phase of the pradhan mantri gramin sadak yojna is also expected to be launched soon to construct 3,000-km length of roads",house,2,1,1,1,5,punjab
2/15/18,https://www.tribuneindia.com/news/punjab/this-legislator-sets-example-keeps-his-wedding-low-key/544099.html,"some neighbours, who saw around four-five vehicles leaving the mla‚Äôs house at new friends colony here on tuesday morning, thought that the mla was going to attend some political function",house,3,0,3,0,6,"faridkot, sangrur"
11/27/17,https://www.tribuneindia.com/news/punjab/left-in-lurch-they-pine-for-bijli-paani/504049.html,"a 2,000-ft pipeline, which was laid to drain out water from the ponds, release water in 25 per cent of houses as no other outlet is available",house,28,11,66,4,109,"amritsar, fazilka, ferozepur, gurdaspur, tarn taran"
9/23/17,https://www.tribuneindia.com/news/punjab/heavy-rain-in-punjab-haryana-leaves-roads-flooded-disrupts-traffic/471747.html,"  chandigarh, september 23   there was rain in several parts of punjab and haryana, disrupting traffic and leaving many arterial roads flooded",house,0,0,1,0,1,"fatehgarh sahib, gurdaspur, hoshiarpur, ludhiana, patiala, sas nagar, sbs nagar"
7/14/17,https://www.tribuneindia.com/news/punjab/residents-block-traffic-over-sewage-mess/436232.html,"abohar, july 13 as several streets were flooded again with dirty water around ramdev temple in arya nagar here following rain on wednesday night, residents marched to the office of the punjab water supply and sewerage board (pwssb) and staged a dharna today",house,9,0,1,0,10,sas nagar
7/14/17,https://www.tribuneindia.com/news/punjab/residents-block-traffic-over-sewage-mess/436232.html,"as none of the officials came out to listen to protesters, they marched to the railway over bridge on the abohar-hanumangarh highway and staged a dharna disrupting movement of vehicles",house,9,0,1,0,10,sas nagar
7/1/17,https://www.tribuneindia.com/news/punjab/farmers-urge-govt-to-remove-hyacinth/429961.html, farmers in arayan village informed water users forum chairman baljinder singh pannu that hyacinth had accumulated at a dilapidated bridge near 3rd (burji) in f minor (sub canal) emanating from the gang canal and a breach was feared,house,0,17,2,0,19,"amritsar, ferozepur, sas nagar"
7/1/17,https://www.tribuneindia.com/news/punjab/heavy-rain-in-mansa-man-electrocuted/429959.html,the entry and exit points to the city were almost closed for traffic as the roads were flooded for at least two hours in the afternoon,house,10,0,7,0,17,mansa
6/30/17,https://www.tribuneindia.com/news/punjab/misery-for-traders-commuters/429525.html,"tribune news service  muktsar, june 29 the rain in the past 24 hours has brought misery for local shopkeepers as the streets remained flooded throughout the day",house,0,0,3,0,3,sri muktsar sahib
6/19/17,https://www.tribuneindia.com/news/punjab/canal-breach-leaves-cotton-fields-flooded/424382.html,"abohar, june 18  as trees continued to fall after the thunderstorm on saturday afternoon, a breach developed on the banks of a sub-canal between jandwala hanvanta and dhinganwali villages on the tail-end of the canal system near the abohar-sriganganagar road today",house,3,8,5,0,16,sas nagar
6/8/17,https://www.tribuneindia.com/news/punjab/nh-flooded-commuters-harassed/419260.html,"the rain damaged the newly constructed road at many points on the 78-km stretch, disrupting vehicular movement",house,2,2,5,0,9,"ludhiana, moga"
5/22/17,https://www.tribuneindia.com/news/punjab/mandi-board-has-no-funds-to-repair-roads-in-rural-areas/410721.html,"sarbjit dhaliwal tribune news service chandigarh, may 21  with no funds in its kitty, the punjab mandi board is worried over the repair of rural roads",house,1,0,14,0,15,punjab
5/22/17,https://www.tribuneindia.com/news/punjab/mandi-board-has-no-funds-to-repair-roads-in-rural-areas/410721.html,"as per rules, a rural road is to be repaired every six years",house,1,0,14,0,15,punjab
5/22/17,https://www.tribuneindia.com/news/punjab/mandi-board-has-no-funds-to-repair-roads-in-rural-areas/410721.html,but most stretches of the rural road network have not been repaired for the past eight to nine years,house,1,0,14,0,15,punjab
5/22/17,https://www.tribuneindia.com/news/punjab/mandi-board-has-no-funds-to-repair-roads-in-rural-areas/410721.html," about rs2,900 crore is required to repair 23,000-km-long road network in villages",house,1,0,14,0,15,punjab
5/22/17,https://www.tribuneindia.com/news/punjab/mandi-board-has-no-funds-to-repair-roads-in-rural-areas/410721.html, there are three types of rural roads,house,1,0,14,0,15,punjab
5/22/17,https://www.tribuneindia.com/news/punjab/mandi-board-has-no-funds-to-repair-roads-in-rural-areas/410721.html," lal singh said there was a 9,276-km network of roads which linked a town or a city with others through villages",house,1,0,14,0,15,punjab
5/22/17,https://www.tribuneindia.com/news/punjab/mandi-board-has-no-funds-to-repair-roads-in-rural-areas/410721.html," then, there is an 8,600-km road network that links two villages",house,1,0,14,0,15,punjab
5/22/17,https://www.tribuneindia.com/news/punjab/mandi-board-has-no-funds-to-repair-roads-in-rural-areas/410721.html,"one way out is to raise a loan for the repair of roads,‚Äù he said",house,1,0,14,0,15,punjab
5/3/17,https://www.tribuneindia.com/news/community/parliamentary-panel-rules-out-kartarpur-corridor/401167.html," tharoor, who served as a diplomat in the united nations for about three decades, said, ‚Äúa proposal was mooted in 1999 to construct a bridge over the ravi river as part of the corridor",house,1,1,1,0,3,amritsar
5/2/17,https://www.tribuneindia.com/news/community/-corridor-connecting-india-with-kartarpur-sahib-shrine-in-pak-ruled-out/400962.html,  ‚Äúa proposal was mooted in 1999 to construct a bridge over the ravi river which would have been a part of the corridor,house,1,2,1,0,4,amritsar
12/8/16,https://www.tribuneindia.com/news/community/can-t-take-jalandhar-cantt-lightly/333965.html,"locals have been fighting for access to the phirni road for the past many years, with over 100 rti applications being filed",house,22,13,23,0,58,"ferozepur, jalandhar"
12/8/16,https://www.tribuneindia.com/news/community/can-t-take-jalandhar-cantt-lightly/333965.html,"pargat did make efforts regarding the peripheral road, but he drew a blank over his 16-point manifesto",house,22,13,23,0,58,"ferozepur, jalandhar"
10/12/16,https://www.tribuneindia.com/news/community/no-new-vehicles-dept-heads-told-to-hire-cabs/308305.html," in one such letter to a government department in june, 2016, the home department told certain departments to ‚Äúensure the auction of condemned vehicles and later follow the new policy to take vehicles on a rent as per entitlement",house,0,3,2,0,5,patiala
9/4/16,https://www.tribuneindia.com/news/community/cong-to-move-privilege-motion-against-dy-cm/289931.html,"tribune news service jalandhar, september 3  punjab congress chief spokesperson sunil jakhar today said his party would move privilege motion against deputy cm sukhbir badal for ‚Äúmisleading‚Äù the house over the use of funds for urban development",house,2,3,2,0,7,"bathinda, jalandhar"
8/29/16,https://www.tribuneindia.com/news/community/canal-breach-leaves-fields-flooded-in-fazilka-abohar/286941.html," meanwhile in abohar, incessant rainfall since saturday evening has triggered a breach in the daulatpura minor (sub canal) near the abohar-sriganganagar highway, besides affecting hundreds of houses here",house,8,13,13,0,34,"fazilka, sas nagar"
7/1/16,https://www.tribuneindia.com/news/community/pathankot-residents-alertness-put-to-test/259496.html,he despatched two shos ‚Äî gurvinder singh and sukhwinder singh ‚Äî to the air base which houses the no,house,11,0,3,1,15,pathankot
6/27/16,https://www.tribuneindia.com/news/community/breach-in-fazilka-canal-floods-fields/257611.html,"agricultural plots spread over 50 acres were flooded due to a 65-foot-wide breach in a canal at theh kalandar village in fazilka district  farmers of the village said besides agricultural fields, the focal point of the village and a part of the state highway had been flooded due to the breach  the wild growth of water hyacinth has been choking a narrow bridge over the canal and causing breaches  ss dhaliwal, executive engineer, (irrigation), ferozepur division, said no damage had been caused to the standing crops and the breach was being plugged",house,0,17,5,0,22,"fazilka, ferozepur"
10/9/15,https://www.tribuneindia.com/news/governance/abohar-municipal-council-to-act-tough-against-defaulters/143560.html, he said the ruling alliance had done nothing in the past six months barring constructing a wall-sized divider on a road whose expenses were borne by some philanthropists,house,10,0,1,1,12,"sangrur, sas nagar"
8/12/15,https://www.tribuneindia.com/news/community/house-gets-flooded-ex-dig-sits-on-dharna/118756.html,"tribune news service  ropar, august 11 a retired deputy inspector general of police iqbal singh lalpura started a fast-unto-death outside the deputy commissioner‚Äôs residence when his pleas to remove water from his flooded house fell on deaf ears",house,3,14,11,0,28,punjab
8/12/15,https://www.tribuneindia.com/news/community/house-gets-flooded-ex-dig-sits-on-dharna/118756.html, the aggrieved former ips officer along with village residents reached here at 6.45 pm and sat on a dharna outside deputy commissioner tanu kashyap‚Äôs house,house,3,14,11,0,28,punjab
8/4/15,https://www.tribuneindia.com/news/community/abohar-roads-waterlogged/115223.html,"our correspondent abohar, august 3  the city witnessed several traffic jams as most roads got waterlogged after the area was lashed by rain",house,5,0,1,0,6,punjab
7/19/15,https://www.tribuneindia.com/news/punjab/400-houses-flooded-crop-submerged/108481.html,"400 houses flooded, crop submerged",house,6,11,17,0,34,"amritsar, tarn taran"
7/19/15,https://www.tribuneindia.com/news/punjab/400-houses-flooded-crop-submerged/108481.html,"our correspondent tarn taran, july 18  due to faulty drainage system, over 400 houses have been flooded while crops on more than 2,000 acres have been submerged in chabal township, 16 km from here, due to last night‚Äôs heavy rain",house,6,11,17,0,34,"amritsar, tarn taran"
7/13/15,https://www.tribuneindia.com/news/community/waterlogging-cripples-life-admn-says-no-big-deal/106013.html,"gagandeep singh tribune news service jalandhar, july 12  choked sewerage and potholed roads prove to be a curse for city residents during the monsoon, but the administration is of the opinion that the city is no different from london, mumbai or kolkata which too face waterlogging",house,2,2,1,0,5,"jalandhar, kapurthala"
7/6/15,https://www.tribuneindia.com/news/community/breach-in-canal-100-acres-flooded/102942.html,residents said scores of families in ward number 17 had to spend the night on rooftops as rainwater entered their houses,house,5,11,10,0,26,punjab
6/23/15,https://www.tribuneindia.com/news/community/breach-in-canal-100-acres-submerged/97302.html,baazigar basti that has 90 houses was submerged under five feet of water,house,2,16,18,0,36,bathinda
6/22/15,https://www.tribuneindia.com/news/punjab/breach-in-sirhind-canal-water-enters-fields-houses/97053.html," baazigar basti, with 90 houses, was logged with water till five feet",house,4,16,23,0,43,"bathinda, sas nagar"
6/22/15,https://www.tribuneindia.com/news/punjab/breach-in-sirhind-canal-water-enters-fields-houses/97053.html,"on november 8, a 30-foot wide breach in the embankment of the canal affected several persons as the water gushed into houses and hutments on the outskirts of the city",house,4,16,23,0,43,"bathinda, sas nagar"
2/27/15,https://www.tribuneindia.com/news/community/farmers-threaten-to-launch-stir-over-canal-leakage/47312.html,"our correspondent abohar, february 26  the leakage of water through pressure release valves fixed on the floor bed of the gang (bikaner) canal has triggered waterlogging in khuikhera and neighbouring villages on the abohar-fazilka road",house,0,36,13,0,49,"fazilka, ferozepur, sas nagar"
2/5/15,https://www.tribuneindia.com/news/punjab/vvip-visits-fail-to-provide-succour-to-cancer-village/38139.html," after over 60 persons died of cancer and hcv last year, the health department started a large-scale household survey in the village that has a population of 11,000 in the first week of december last year",house,33,0,17,0,50,"faridkot, moga"
2/5/15,https://www.tribuneindia.com/news/punjab/muktsar-residents-make-a-beeline-for-arms-licence/38125.html,"archit watts tribune news service muktsar, february 4  with the municipal elections round the corner and the possibility of model code of conduct coming to effect anytime, there is a rush of people seeking arms license in chief minister parkash singh badal‚Äôs home district ‚Äî muktsar",house,11,1,2,0,14,sri muktsar sahib
2/3/15,https://www.tribuneindia.com/news/courts/hc-sets-3-month-deadline-on-plea-for-flats-by-84-riot-victims/37255.html,"saurabh malik tribune news service chandigarh, february 2  more than 30 years after they were displaced, 1984 riot victims are still struggling for a roof of their own",house,18,0,5,0,23,sas nagar
8/31/19,https://www.tribuneindia.com/news/punjab/india-pak-technical-teams-discuss-kartarpur-corridor/825494.html,sources claimed pakistan was asked to speed up the construction of a 300-metre bridge on its side,house,0,0,1,0,1,punjab
8/31/19,https://www.tribuneindia.com/news/punjab/india-pak-technical-teams-discuss-kartarpur-corridor/825494.html, india has already completed 70 per cent of the work on the 100-metre bridge being built on its side,house,0,0,1,0,1,punjab
8/30/19,https://www.tribuneindia.com/news/punjab/amid-tension-india-pak-hold-technical-talks-on-kartarpur-corridor/825187.html,"islamabad/gurdaspur, august 30 officials from india and pakistan on friday discussed in a cordial atmosphere the technical modalities like the level of roads and the bridge of the proposed kartarpur corridor for sikh pilgrims, the first such meeting after new delhi revoked jammu and kashmir‚Äôs special status leading to fresh tensions between the two countries",house,2,1,2,0,5,gurdaspur
8/30/19,https://www.tribuneindia.com/news/punjab/amid-tension-india-pak-hold-technical-talks-on-kartarpur-corridor/825187.html,"in the meeting, which was held in makeshift tents at the zero point, both sides discussed timing of completion of the bridge, alignment of the roads and other engineering aspects of the proposed crossing points",house,2,1,2,0,5,gurdaspur
8/30/19,https://www.tribuneindia.com/news/punjab/amid-tension-india-pak-hold-technical-talks-on-kartarpur-corridor/825187.html,india is constructing a bridge at the zero point and has urged pakistan to build a similar bridge on its side that will provide safe and secure movement of pilgrims and address concerns regarding flooding,house,2,1,2,0,5,gurdaspur
7/13/19,https://www.tribuneindia.com/news/punjab/pak-drops-pro-khalistan-activist-gopal-chawla-others-from-psgpc/801600.html,"india wants a bridge over the seasonal flooding prone creek leading to kartarpur but, pakistan was insisting upon a causeway",house,3,3,1,0,7,"amritsar, gurdaspur, jalandhar"
7/13/19,https://www.tribuneindia.com/news/punjab/india-to-propose-interim-solution-on-bridge-row/801221.html,"sandeep dikshit  tribune news service  new delhi, june 12  india will impress on pakistan the need for a bridge over a creek in the path of the kartarpur corridor in order to make pilgrimage to gurdwara nankana sahib a round-the-year event",house,1,1,1,0,3,gurdaspur
7/13/19,https://www.tribuneindia.com/news/punjab/india-to-propose-interim-solution-on-bridge-row/801221.html," as the disagreement on crossing the 330-m creek of the ravi may delay the link, india is also set to propose an interim solution, of connecting the service roads on its bridge with the pakistani road just above the creek level",house,1,1,1,0,3,gurdaspur
7/13/19,https://www.tribuneindia.com/news/punjab/india-to-propose-interim-solution-on-bridge-row/801221.html,the final inspection of a passenger terminal with over 50 immigration counter will be held on october 31 while the road from the gurdaspur-dera baba nanak highway would have to be completed even earlier,house,1,1,1,0,3,gurdaspur
7/12/19,https://www.tribuneindia.com/news/punjab/india-wants-bridge-over-creek-in-kartarpur-corridor-path-while-pak-differs/801055.html,"sandeep dikshit  tribune news service  new delhi, june 12  india will impress on pakistan the need for a bridge over a creek in the path of the kartarpur corridor in order to make pilgrimage to gurdwara nankana sahib a round-the-year event",house,1,1,1,0,3,gurdaspur
7/12/19,https://www.tribuneindia.com/news/punjab/india-wants-bridge-over-creek-in-kartarpur-corridor-path-while-pak-differs/801055.html," as the disagreement over the crossing for the 330-m creek of the ravi may delay the connection, india is also set to propose an interim solution‚Äîof connecting the service roads on its bridge with the pakistani road just above the creek level in order to get the corridor going by the time celebrations for guru nanak‚Äôs 550th birth anniversary begin in november",house,1,1,1,0,3,gurdaspur
7/12/19,https://www.tribuneindia.com/news/punjab/india-wants-bridge-over-creek-in-kartarpur-corridor-path-while-pak-differs/801055.html,"  final inspection of an airport-like passenger terminal with over 50 immigration counter will be held on october 31, while the road from the gurdaspur-dera baba nanak highway would have to be completed even earlier",house,1,1,1,0,3,gurdaspur
6/27/19,https://www.tribuneindia.com/news/punjab/gurdaspur-village-in-troubled-waters-courtesy-caste-divide/793515.html,"situation worse, administration apathetic        sewage from households accumulates in narrow alleys and has no outlet, which has led to flooding of the entire khojepur village in gurdaspur        this has resulted in outbreak of a number of diseases in the area        the tribune in september last year had published the plight of the hamlet, following which gurdaspur dc vipul ujwal along with officials of 14 departments reached the spot and collected water samples, the results of which are not known to date   ",house,4,7,12,0,23,"gurdaspur, sas nagar"
5/28/19,https://www.tribuneindia.com/news/punjab/india-pak-corridor-talks-hit-a-bump/779230.html,"ravi dhaliwal  tribune news service  gurdaspur, may 27  the fourth ‚Äútechnical committee‚Äù meeting on the kartapur corridor between india and pakistan, which was held at zero line today, ended in a deadlock with india suggesting that a 800-metre bridge be built on the ravi while the pakistan delegation, fearing¬† flooding during monsoons could erode the bridge, suggested a causeway",house,2,1,2,0,5,gurdaspur
5/28/19,https://www.tribuneindia.com/news/punjab/india-pak-corridor-talks-hit-a-bump/779230.html," delhi wants bridge over ravi, pak causeway  i‚Äôm optimistic that the corridor will be completed by november when the 550th birth anniversary celebrations of guru nanak dev commence",house,2,1,2,0,5,gurdaspur
5/27/19,https://www.tribuneindia.com/news/punjab/causeway-or-bridge-kartarpur-corridor-hits-roadblock/779066.html,"ravi dhaliwal  tribune news service  dera baba nanak (gurdaspur), may 27  the 4th ‚Äòtechnical committee‚Äô meeting on the kartarpur corridor held between senior indian and pakistani officials at zero line on monday has hit the bridge-causeway roadblock",house,0,4,4,0,8,gurdaspur
5/27/19,https://www.tribuneindia.com/news/punjab/causeway-or-bridge-kartarpur-corridor-hits-roadblock/779066.html," while india suggested that an 800-metre bridge should be built on the ravi, the pakistani delegation, fearing flooding during the monsoon season which could erode the bridge, suggested the need to construct a causeway",house,0,4,4,0,8,gurdaspur
5/27/19,https://www.tribuneindia.com/news/punjab/causeway-or-bridge-kartarpur-corridor-hits-roadblock/779066.html, a causeway refers to a roadway supported mostly by earth or stone while a bridge supports a roadway between piers,house,0,4,4,0,8,gurdaspur
4/17/19,https://www.tribuneindia.com/news/punjab/kartarpur-corridor-on-course-india-pak-technical-meet-held/759421.html,  the focus was on construction of a 100-metre bridge over a sand dune on the indian side and measures to ensure no flooding during monsoon,house,2,5,2,0,9,amritsar
4/17/19,https://www.tribuneindia.com/news/punjab/kartarpur-corridor-on-course-india-pak-technical-meet-held/759421.html," ten officials from the pakistan frontier works organisation, ministry of religious affairs and foreign ministry participated in the meeting, while the indian side was represented by akhil saxena of the land ports authority of india, maneesh rastogi and yp jadon of the national highway authority of india and officials of the ministry of home affairs and the punjab drainage department",house,2,5,2,0,9,amritsar
4/17/19,https://www.tribuneindia.com/news/punjab/kartarpur-corridor-on-course-india-pak-technical-meet-held/759421.html, the coordinates of the place where two roads ‚Äî one leading from dera baba nanak to the international border (ib) and the other from the ib to the kartarpur shrine ‚Äî will meet and fencing of the corridor were also discussed at the meeting,house,2,5,2,0,9,amritsar
2/27/19,https://www.tribuneindia.com/news/punjab/they-fear-being-homeless-again/735270.html,"anirudh gupta ferozepur, february 26  thousands of residents belonging to villages situated along the zero line in punjab are apprehensive of being rendered homeless in the wake of escalating indo-pakistan tension",house,7,8,11,0,26,ferozepur
2/27/19,https://www.tribuneindia.com/news/punjab/they-fear-being-homeless-again/735270.html, cross-border tension is not their only woe; flooding of their lands due to the swollen sutlej also renders them homeless,house,7,8,11,0,26,ferozepur
9/25/18,https://www.tribuneindia.com/news/punjab/punjab-toll-3-many-towns-waterlogged/658361.html,"in amritsar, a man and his 12-year-old son drowned after their car fell off a bridge into an overflowing drain near khiyala village during heavy rain",house,10,6,5,0,21,"amritsar, gurdaspur, jalandhar, ludhiana, pathankot, patiala, sangrur"
7/5/18,https://www.tribuneindia.com/news/punjab/rain-pours-misery-in-malwa-5-dead/615378.html," in another incident at malout village, harjinder kaur (22), who was also pregnant, died after the roof of her house collapsed",house,20,27,30,0,77,"patiala, sas nagar, sri muktsar sahib"
7/5/18,https://www.tribuneindia.com/news/punjab/rain-pours-misery-in-malwa-5-dead/615378.html,"ush({ });  at mahuana village, tarsem singh (56), a truck driver from samana in patiala district, who had come here to attend a two-day refresher course at the state institute of automotive and driving skills (siads) died after the roof of a roadside eatery gave way",house,20,27,30,0,77,"patiala, sas nagar, sri muktsar sahib"
5/21/18,https://www.tribuneindia.com/news/punjab/shahkot-public-issues-take-a-backseat-amid-mud-slinging/592362.html,"muskmelon growers‚Äô plight  the constituency houses roopewal, one of the largest muskmelon markets in asia, which has lost almost all its fruit this year after the recent hailstorm",house,3,19,23,0,45,"jalandhar, ludhiana"
4/10/18,https://www.tribuneindia.com/news/punjab/streets-inundated-sewers-blocked-in-abohar-colony/571577.html,"raj sadosh  abohar, april 9  most of the streets in thakur abadi, a slum area, are stinking as dirty water stands accumulated and washrooms in residential buildings are blocked",house,7,0,2,0,9,punjab
4/10/18,https://www.tribuneindia.com/news/punjab/streets-inundated-sewers-blocked-in-abohar-colony/571577.html," on december 30, 2016, the then state bjp chief and union minister vijay sampla had unofficially ‚Äúinaugurated‚Äù the scheme during a road show  and promised to get the work done soon",house,7,0,2,0,9,punjab
1/15/18,https://www.tribuneindia.com/news/punjab/encroachments-over-ponds-despite-hc-order/528594.html,the water overflowing from the lone remaining pond is causing pollution with dirty water threatening to enter houses,house,3,8,14,0,25,punjab
3/21/17,https://www.tribuneindia.com/news/community/raze-encroachments-on-pond-land-villagers-to-officials/379920.html, the administration had on march 7 - 8 demolished dozens of houses and shops which had allegedly been constructed by encroaching upon such land in khuyiansarwer,house,11,10,13,0,34,punjab
3/8/17,https://www.tribuneindia.com/news/community/80-encroachments-on-pond-land-razed/374265.html,"our correspondent abohar, march 7  as many as 80 houses and shops which had allegedly been constructed by encroaching upon land for village ponds were demolished in a major drive in khuyiansarwer village today",house,3,11,7,0,21,punjab
1/30/16,https://www.tribuneindia.com/news/community/after-iit-m-mohali-turns-to-pec-to-check-waterlogging/189677.html," as per a senior official of punjab water supply and sewerage board, the problem occurred as the natural gradient of the city had been disrupted by the 200-ft-wide road leading to the mohali airport",house,3,0,6,0,9,sas nagar
5/28/15,https://www.tribuneindia.com/news/community/mps-allocate-funds-but-fail-to-lobby-for-state-s-interests/86280.html,amritsar amarinder singh (cong) questions asked: 13  mplad funds utilised: rs 5 crore  attendance: 35%  initiatives taken  equitable distribution of mplad funds in all nine assembly segments adopted dhaul kalan village¬† facilitated construction of roads and sewerage funds for drains in rural areas facilitated setting up of toilets in villages and in localities inhabited by urban poor  unkept promises(adsbygoogle = window,house,15,16,13,2,46,"amritsar, bathinda, faridkot, ferozepur, hoshiarpur, jalandhar, ludhiana, moga, patiala, sas nagar"
5/28/15,https://www.tribuneindia.com/news/community/mps-allocate-funds-but-fail-to-lobby-for-state-s-interests/86280.html,"  anandpur sahib ps chandumajra (sad)  questions asked: 113  mplad funds utilised: rs 4.5 crore attendance: 91% initiatives taken  anandpur sahib-amritsar train service started nfl expansion defence clearance for mohali international airport mohali drain construction started banga-anandpur sahib via garhshankar declared¬†national highway¬†  unkept promises  no protection to crops from wild animals¬† drinking water, irrigation facilities lacking in kandi areas bbmb workshop promising jobs to local youth yet to come up modern timber, cattle markets not materialised four-laning of kharar-kurali road pending   prem singh chandumajra is a seasoned politician",house,15,16,13,2,46,"amritsar, bathinda, faridkot, ferozepur, hoshiarpur, jalandhar, ludhiana, moga, patiala, sas nagar"
5/28/15,https://www.tribuneindia.com/news/community/mps-allocate-funds-but-fail-to-lobby-for-state-s-interests/86280.html,"  ¬†  unkept promises  railway over-bridge project at jandiala mandi yet to take off construction work not started on the beas bridge¬† no de-addiction centre set up multi-specialty sports stadium in zira lying defunt no employment opportunities generated     despite being the leader of sad‚Äôs parliamentary party in the lok sabha, the khadoor sahib mp never asked even a single question in parliament in the past one year",house,15,16,13,2,46,"amritsar, bathinda, faridkot, ferozepur, hoshiarpur, jalandhar, ludhiana, moga, patiala, sas nagar"
5/28/15,https://www.tribuneindia.com/news/community/mps-allocate-funds-but-fail-to-lobby-for-state-s-interests/86280.html,"  hoshiarpur  vijay sampla (bjp) questions asked: 1  mplad funds utilised: rs 2.49 crore attendance: 97% initiatives taken  survey for rail link extension projects approved¬† periodicity of hoshiarpur express increased hoshiarpur-phagwara road declared national highway punjab included in pilot project of pradhanmantri aadarsh gram yojna¬† rs 100 crore released for mukerian-nangal rail project  unkept promises  no major project approved¬†for kandi areas industrial package eludes hoshiarpur¬† tertiary cancer care centre yet to be completed hoshiarpur-ferozepur morning passenger not restored no relaxation or incentives to the ailing carbon industry   coming from a modest background, sampla rose to become minister of state for social justice and empowerment",house,15,16,13,2,46,"amritsar, bathinda, faridkot, ferozepur, hoshiarpur, jalandhar, ludhiana, moga, patiala, sas nagar"
5/28/15,https://www.tribuneindia.com/news/community/mps-allocate-funds-but-fail-to-lobby-for-state-s-interests/86280.html,"‚Äî¬†paramjit kaur gulshan, former akali mp  ludhiana ravneet singh bittu (cong) questions asked: 188¬†  mplad funds utilised: rs 2.5 crore attendance: 92% initiatives taken  he has sanctioned rs 3.5 crore for development of infrastructure in his constituency has released rs 1 crore for sarpanches has sanctioned rs 50 lakh for educational institutes has released another rs 50 lakh for the construction of solar street lights¬† has provided rs 70 lakh for the setting up of tube wells in¬†the city¬†  unkept promises  failed to set up pgimer in¬†ludhiana couldn‚Äôt start flights from¬†ludhiana to delhi didn‚Äôt release funds for pau couldn‚Äôt tackle pollution in¬†ludhiana¬† didn‚Äôt check pollution in¬†buddha nullah   ravneet singh bittu is an mp from ludhiana parliamentary constituency from where he won in spite of a nationwide anti-congress wave",house,15,16,13,2,46,"amritsar, bathinda, faridkot, ferozepur, hoshiarpur, jalandhar, ludhiana, moga, patiala, sas nagar"
9/5/19,https://www.tribuneindia.com/news/punjab/cong-mla-seeks-closure-of-toll-plaza-at-fazilka-ferozepur/827848.html,"stressing that many clauses of the agreement were being flouted, the mla said the 87-km stretch of the road did not have proper arrangements and facilities, including ambulance service and signboards",house,15,0,2,0,17,"fazilka, ferozepur"
9/2/19,https://www.tribuneindia.com/news/punjab/1-lakh-cattle-on-the-loose-claim-100-lives-a-year-in-punjab/826294.html," in patiala, the home district of chief minister capt amarinder singh and local bodies minister brahm mohindra, four people have died in the past one month in such incidents",house,18,26,4,2,50,"patiala, sangrur"
9/2/19,https://www.tribuneindia.com/news/punjab/1-lakh-cattle-on-the-loose-claim-100-lives-a-year-in-punjab/826294.html,"as per an estimate, nearly 1.1 lakh stray cattle are roaming freely on the roads in the state",house,18,26,4,2,50,"patiala, sangrur"
9/2/19,https://www.tribuneindia.com/news/punjab/1-lakh-cattle-on-the-loose-claim-100-lives-a-year-in-punjab/826294.html,"ush({ });  as per the record of the ministry of road transport, provided by the state police, 114 persons died and 11 were injured in accidents involving strays in 2018",house,18,26,4,2,50,"patiala, sangrur"
9/2/19,https://www.tribuneindia.com/news/punjab/1-lakh-cattle-on-the-loose-claim-100-lives-a-year-in-punjab/826294.html,"in the last three years, 370 people have died and another 167 have injured in road accidents",house,18,26,4,2,50,"patiala, sangrur"
9/2/19,https://www.tribuneindia.com/news/punjab/1-lakh-cattle-on-the-loose-claim-100-lives-a-year-in-punjab/826294.html,but the population of stray cattle on roads has touched nearly 1.1 lakh,house,18,26,4,2,50,"patiala, sangrur"
9/2/19,https://www.tribuneindia.com/news/punjab/1-lakh-cattle-on-the-loose-claim-100-lives-a-year-in-punjab/826294.html,"as per the record of the ministry of road transport, provided by the state police, 114 persons died and 11 were injured in accidents involving strays in 2018",house,18,26,4,2,50,"patiala, sangrur"
8/22/19,https://www.tribuneindia.com/news/punjab/panel-wants-ls-to-take-call-on-breach-of-privilege-by-sukhbir/820680.html,"rajmeet singh  tribune news service  chandigarh, august 21  the privileges committee of the punjab vidhan sabha wants the lok sabha to take a call in a case of breach of privilege by former deputy chief minister and sad chief sukhbir singh badal, who has been held guilty of misleading the house during the 2018 monsoon session",house,2,1,4,0,7,"faridkot, ferozepur"
8/8/19,https://www.tribuneindia.com/news/punjab/away-from-limelight-since-resigning-sidhu-inaugurates-streetlight-project/814970.html,"amritsar, august 8   having stayed away from the limelight after his resignation as punjab cabinet minister last month, congress leader navjot singh sidhu on thursday inaugurated a streetlight project in amritsar east, his assembly constituency",house,3,0,1,0,4,amritsar
8/6/19,https://www.tribuneindia.com/news/punjab/cbi-report-rocks-house-opposition-walks-out/813422.html," during the zero hour and subsequent call attention notices, chief minister capt amarinder singh had to ask parliamentary affairs minister brahm mohindra and party chief whip navtej cheema to call party mlas in the house",house,0,2,6,0,8,punjab
8/6/19,https://www.tribuneindia.com/news/punjab/cbi-report-rocks-house-opposition-walks-out/813422.html,they earlier sent a request for an adjournment motion to speaker rana kp singh‚Äôs house at 8 am as rules require such a request to be made at least two hours before the zero hour,house,0,2,6,0,8,punjab
8/3/19,https://www.tribuneindia.com/news/punjab/arora-won-t-accept-ta-da/812080.html,‚Äúhow can i accept the ta/da when i have done no work in the house today? refusing to accept any perks for today is my way of protest for not having a debate today,house,0,0,2,0,2,punjab
8/2/19,https://www.tribuneindia.com/news/punjab/punjab-assembly-adjourned-within-minutes-on-day-1/811894.html," ¬†  eighteen of the 20 aap mlas were present in the house, including nazar singh manshahia and amarjit singh sandhoa",house,2,3,2,0,7,sangrur
8/2/19,https://www.tribuneindia.com/news/punjab/session-begins-today-sad-yet-to-pick-leader/811369.html,"jupinderjit singh tribune news service chandigarh, august 1  even as the five-day monsoon session of the vidhan sabha begins on friday, the sad is yet to elect the leader of its legislative party in the house",house,3,0,2,0,5,ferozepur
7/30/19,https://www.tribuneindia.com/news/punjab/cabinet-meeting-today-to-discuss-draft-bills/809886.html,"‚Äî tns sodhi gets house vacated by sidhu¬†  days after former minister navjot singh sidhu vacated his official residence in sector 2 here, chief minister capt amarinder singh on monday allotted the house to sports minister rana gurmit sodhi",house,0,2,3,0,5,punjab
7/24/19,https://www.tribuneindia.com/news/punjab/5-day-monsoon-session-of-punjab-vidhan-sabha-from-august-2/807139.html,"the house would adjourn sine-die after the proposed legislative business on august 6, said the spokesperson",house,3,0,2,0,5,punjab
7/24/19,https://www.tribuneindia.com/news/punjab/monsoon-session-likely-from-aug-2/806759.html," meanwhile, in a move to enable uninterrupted water supply to nearly 20 lakh rural households, the cabinet will take up an agenda item of the water supply and sanitation department to allow the government to pay dues of rural water supply schemes, running up to nearly rs 300 crore",house,0,10,3,0,13,punjab
7/24/19,https://www.tribuneindia.com/news/punjab/monsoon-session-likely-from-aug-2/806759.html,"ush({ }); cabinet meet today¬†  to enable uninterrupted water supply to nearly 20 lakh rural households, the cabinet will take up an agenda item of the water supply and sanitation department to allow the government to pay dues of rural water supply schemes¬† the cabinet will also take up the issue of reducing minimum land requir-ement for private univer-sities from the existing¬†35 acres to 25 acres ",house,0,10,3,0,13,punjab
7/17/19,https://www.tribuneindia.com/news/punjab/gushing-ghaggar-floods-patiala-villages/803050.html,"a crack that developed in an overbridge in sanaur further widened to over 40 ft and disconnected malakpur, batti, batta and rathiyan villages",house,12,10,36,0,58,patiala
7/17/19,https://www.tribuneindia.com/news/punjab/gushing-ghaggar-floods-patiala-villages/803050.html,people were forced to leave their houses early morning as the water level rose over 4-ft above the ground,house,12,10,36,0,58,patiala
7/11/19,https://www.tribuneindia.com/news/punjab/rains-cast-shadow-on-corridor-work/800091.html," following the season‚Äôs first rainfall yesterday, work on the multi-storeyed integrated check post (icp), 100-m overbridge and water drainage system took a hit",house,5,1,1,0,7,punjab
7/11/19,https://www.tribuneindia.com/news/punjab/rains-cast-shadow-on-corridor-work/800091.html," the 4-km passage, across the wire fence, stretching from the international border till shakargarh road and arrival and langar halls, darshani deori and water supply and sewerage projects at the kartarpur shrine are almost complete",house,5,1,1,0,7,punjab
7/11/19,https://www.tribuneindia.com/news/punjab/rains-cast-shadow-on-corridor-work/800091.html," site waterlogged        following the season's first rainfall on tuesday, work on the multi-storeyed integrated check post, 100-m overbridge and water drainage system took a hit",house,5,1,1,0,7,punjab
6/13/19,https://www.tribuneindia.com/news/punjab/tanda-villagers-to-get-road-after-rains/787098.html,"tribune news service ropar, june 12  after the tribune highlighted the plight of residents of tanda village due to no road connectivity, deputy commissioner sumeet jarangal visited the village in the morning",house,11,4,11,0,26,punjab
6/13/19,https://www.tribuneindia.com/news/punjab/tanda-villagers-to-get-road-after-rains/787098.html, the tribune had highlighted in these columns that how the village having a population of nearly 125 residents remain disconnected during rainy season in the absence of any road connectivity,house,11,4,11,0,26,punjab
6/13/19,https://www.tribuneindia.com/news/punjab/tanda-villagers-to-get-road-after-rains/787098.html,people have to tread a 2-km-long kuthca track from the metalled road to reach the village,house,11,4,11,0,26,punjab
6/13/19,https://www.tribuneindia.com/news/punjab/tanda-villagers-to-get-road-after-rains/787098.html,ush({ });  the dc said the village panchayat had already constructed 300-m section of the road falling in the village with funds procured under different government schemes,house,11,4,11,0,26,punjab
6/13/19,https://www.tribuneindia.com/news/punjab/tanda-villagers-to-get-road-after-rains/787098.html,"the remaining 1.7-km section of the road, having a width of 10 feet, would be constructed by the state government to provide road connectivity to the village, he said",house,11,4,11,0,26,punjab
6/13/19,https://www.tribuneindia.com/news/punjab/tanda-villagers-to-get-road-after-rains/787098.html,"the process for acquisition of 1.3 acres of land required for the road will also be started immediately, added the deputy commissioner.",house,11,4,11,0,26,punjab
6/8/19,https://www.tribuneindia.com/news/punjab/villagers-claim-crop-damage-by-swelling-sutlej-admn-denies/784817.html,"tribune news service  sanghera (moga), june 7 though the district administration has claimed that there is no loss to crops and properties in villages, people of sanghera and its adjoining villages have alleged that their fields and houses located inside the dhusi bundh has been inundated",house,13,19,30,0,62,moga
6/8/19,https://www.tribuneindia.com/news/punjab/villagers-claim-crop-damage-by-swelling-sutlej-admn-denies/784817.html,"the residents of sanghera village demanded that the government should construct a ring road with a height of 7 to 8 ft around the village, which would work as a bundh and keep the river water from entering the residential areas",house,13,19,30,0,62,moga
6/6/19,https://www.tribuneindia.com/news/punjab/want-arms-licence-plant-10-saplings/783609.html," ‚Äúnow every arms licence applicant has to plant at least 10 saplings and take a selfie with the plantation as proof to submit with the application,‚Äù said the dc",house,0,2,2,0,4,ferozepur
2/16/19,https://www.tribuneindia.com/news/punjab/work-on-bridge-for-island-villages-to-begin-today/729611.html,"deepkamal kaur tribune news service jalandhar, february 15 set to provide a major relief to the residents of 16 island villages falling in the mand area of sultanpur lodhi, the work to construct a permanent bridge to connect them to the mainland is set to start on saturday",house,5,8,13,1,27,jalandhar
2/16/19,https://www.tribuneindia.com/news/punjab/work-on-bridge-for-island-villages-to-begin-today/729611.html,the bridge with a span of 180 m will be constructed from patti balubahadur village in the mainland to baupur in the mand area,house,5,8,13,1,27,jalandhar
2/16/19,https://www.tribuneindia.com/news/punjab/work-on-bridge-for-island-villages-to-begin-today/729611.html,the pwd will get the bridge constructed at a cost of rs 9.83 crore,house,5,8,13,1,27,jalandhar
2/16/19,https://www.tribuneindia.com/news/punjab/work-on-bridge-for-island-villages-to-begin-today/729611.html," as of now, the villages are connected by way of a pontoon bridge which cannot bear heavy-weight vehicle like tractors",house,5,8,13,1,27,jalandhar
2/16/19,https://www.tribuneindia.com/news/punjab/work-on-bridge-for-island-villages-to-begin-today/729611.html,"in the monsoon season, when the bridge is removed for three months for safety reasons, a single boat remains the lifeline of the residents of 16 villages spread in an area of 25,000 acre",house,5,8,13,1,27,jalandhar
1/21/19,https://www.tribuneindia.com/news/punjab/roads-in-chappar-chhiri-in-bad-shape/716794.html,"akash ghai tribune news service mohali, january 20  while tall claims of improvement of baba banda singh bahadur memorial site at chappar chhiri village are made every now and then, the condition of approach roads to the historic monument is pathetic",house,4,1,9,0,14,sas nagar
1/21/19,https://www.tribuneindia.com/news/punjab/roads-in-chappar-chhiri-in-bad-shape/716794.html, punjab cultural and tourism minister navjot singh sidhu had announced a grant of rs 12 lakh for repair and re-carpeting of roads in chappar chhiri village during his visit at the memorial in mid-january last year,house,4,1,9,0,14,sas nagar
1/21/19,https://www.tribuneindia.com/news/punjab/roads-in-chappar-chhiri-in-bad-shape/716794.html," ‚Äúit is risky to drive on such roads, especially for two-wheeler riders",house,4,1,9,0,14,sas nagar
1/21/19,https://www.tribuneindia.com/news/punjab/roads-in-chappar-chhiri-in-bad-shape/716794.html,"i fail to understand why the authorities are not interested in repair of an approach road to the memorial, which is one of the main attractions of this area and has historical significance,‚Äù said sanjiv punni, a resident of mohali",house,4,1,9,0,14,sas nagar
1/5/19,https://www.tribuneindia.com/news/punjab/panel-begins-process-to-summon-sukhbir/708723.html,"rajmeet singh tribune news service chandigarh, january 4  the privileges committee of the punjab vidhan sabha has initiated the process to summon former deputy chief minister sukhbir singh badal for alleged breach of privilege after the vidhan sabha panel held the akali dal president guilty of misleading the house during the last monsoon session",house,2,1,4,0,7,punjab
12/15/18,https://www.tribuneindia.com/news/punjab/sukhbir-guilty-of-misleading-house-report/698597.html,"tribune news service  chandigarh, december 14 a vidhan sabha committee has held akali dal president sukhbir singh badal guilty of misleading the house during the monsoon session",house,2,2,7,0,11,punjab
12/15/18,https://www.tribuneindia.com/news/punjab/sukhbir-guilty-of-misleading-house-report/698597.html,the report said the five-member committee took help of the home department and the police to check cctv footage as regards any entry of daduwal‚Äôs vehicle into the official residence of the chief minister,house,2,2,7,0,11,punjab
12/14/18,https://www.tribuneindia.com/news/punjab/2-day-session-day-1-11-minutes-at-rs-70-lakh/698206.html,"  on day i, as much as rs 70 lakh of taxpayers‚Äô money was gone in precisely 11 minutes that the 117 mlas spent in the house",house,2,1,4,4,11,punjab
12/14/18,https://www.tribuneindia.com/news/punjab/2-day-session-day-1-11-minutes-at-rs-70-lakh/698206.html, the per day cost of a house session works out at rs 70 lakh on an average,house,2,1,4,4,11,punjab
9/14/18,https://www.tribuneindia.com/news/punjab/outlet-blocked-village-turns-pond/652677.html,"for the past eight years, ever since some persons blocked the outlet of the pond by constructing houses, a person, on an average, has to be rushed to the hospital every day",house,11,6,20,0,37,"gurdaspur, sas nagar"
9/14/18,https://www.tribuneindia.com/news/punjab/outlet-blocked-village-turns-pond/652677.html,"ush({ });  nearly 60 per cent of the households are affected by the scourge of water which, in turn, leads to various vector-borne diseases",house,11,6,20,0,37,"gurdaspur, sas nagar"
9/14/18,https://www.tribuneindia.com/news/punjab/outlet-blocked-village-turns-pond/652677.html," irked with no response from the administration, the villagers collected rs 3,000 and drained out water from the streets with the help of a diesel pump",house,11,6,20,0,37,"gurdaspur, sas nagar"
9/3/18,https://www.tribuneindia.com/news/punjab/things-get-verse-in-vidhan-sabha/646983.html,"ush({ });  chandigarh: one has to pay toll five times while driving from chandigarh to pathankot, but the condition of the roads is a big consolation",house,10,1,8,0,19,"mansa, pathankot, sri muktsar sahib"
9/3/18,https://www.tribuneindia.com/news/punjab/things-get-verse-in-vidhan-sabha/646983.html,"when you take a 3-km detour from the main road, a little ahead of the mansar toll plaza (near mukerian), you reach the hp border at ulherian",house,10,1,8,0,19,"mansa, pathankot, sri muktsar sahib"
8/31/18,https://www.tribuneindia.com/news/punjab/chandumajra-questions-role-of-punjab-govt-and-speaker-in-conducting-assembly-session/645644.html,"ravi s singh  tribune news service  new delhi, august 31  shiromani akali dal (sad) vice president and chief whip in the lok sabha¬†prem singh chandumajra on friday here questioned the punjab government and state assembly speaker rana kp singh on their impartiality in conducting business of the house during the just concluded monsoon session",house,3,1,4,0,8,punjab
8/29/18,https://www.tribuneindia.com/news/punjab/after-tactical-retreat-akalis-trash-probe-report-during-own-session/644325.html,"ruchika m khanna tribune news service chandigarh, august 28  in a tactical retreat, the shiromani akali dal (sad) walked out of the house on the last day of the monsoon session on tuesday",house,2,2,7,0,11,punjab
8/29/18,https://www.tribuneindia.com/news/punjab/after-tactical-retreat-akalis-trash-probe-report-during-own-session/644325.html,"later, sukhbir said they had walked out of the house as speaker rana kp singh announced that they would get just 17 minutes to speak during the debate",house,2,2,7,0,11,punjab
8/27/18,https://www.tribuneindia.com/news/punjab/assembly-adopts-resolution-on-kartarpur-sahib-corridor/643562.html," all members of the house, cutting across party lines, were of the view that the opening of the corridor would enable millions of indian devotees to pay obeisance at the the historic sri kartarpur sahib gurdwara",house,0,0,3,0,3,gurdaspur
8/19/18,https://www.tribuneindia.com/news/punjab/pakistan-should-allow-access-to-kartapur-former-minister-ms-gill/639475.html,ush({ });  ‚Äúall it needs post-monsoon is a bailey bridge so that people can walk across the distance of four km to pay homage at the site guru nanak spent last two decades teaching results of his philosophical thinking,house,2,0,1,0,3,gurdaspur
8/2/18,https://www.tribuneindia.com/news/punjab/hyacinth-chokes-water-flow-in-canals-worries-farmers/630591.html,"local resident jagsir singh said, ‚Äúthe department had three days ago deployed some men to clear hyacinth from under the bridge, but they were unable to clear all of it",house,2,24,2,0,28,"bathinda, fazilka, sri muktsar sahib"
8/1/18,https://www.tribuneindia.com/news/punjab/lambi-residents-feel-neglected-as-projects-far-from-complete/629988.html,"archit watts tribune news service muktsar, july 31  after the congress coming to power in the state, a majority of residents of former chief minister parkash singh badal‚Äôs home constituency lambi are feeling neglected",house,7,15,13,2,37,sri muktsar sahib
6/27/18,https://www.tribuneindia.com/news/punjab/bhakra-reservoir-inflow-at-historic-low/611378.html," with the water level at 1,494 feet, 70 feet lower than june 26 last year, sources said the gap was unlikely to be bridged even if the monsoon was good",house,0,4,1,0,5,punjab
6/18/18,https://www.tribuneindia.com/news/punjab/water-level-in-dams-up-situation-still-grim/606983.html," demand-supply gap yet to be bridged  bhakra dam witnessed an increase of 4 per cent¬†in the water availability over the past week, but the water level is still 60 per cent below normal for this¬†time of the year at thein dam, which lies on the ravi in punjab, the current storage is 31 per cent, up from 25 per cent last week",house,0,0,1,0,1,punjab
11/28/17,https://www.tribuneindia.com/news/punjab/illegal-mining-free-as-sand-through-fingers/504761.html," these operators pay another rs 500 to rs 1,200 per vehicle to landowners and make multiple rounds for lifting sand on a single receipt, without crossing the weighbridge",house,12,23,31,1,67,"amritsar, faridkot, ferozepur, jalandhar, kapurthala, ludhiana, patiala, sri muktsar sahib"
10/25/17,https://www.tribuneindia.com/news/punjab/aap-seeks-40-sittings-live-telecast-of-house-session/486806.html,"aap seeks 40 sittings, live telecast of house session",house,0,0,3,0,3,punjab
6/20/17,https://www.tribuneindia.com/news/punjab/no-action-on-illegal-mining-near-chandbhan-drain/424955.html," a visit along the chandbhan drain from rupana to rahoorianwali village here revealed that at a number of places, its banks had gone lower than the level of bridges",house,5,6,3,0,14,"faridkot, fazilka, ferozepur, sri muktsar sahib"
6/12/17,https://www.tribuneindia.com/news/punjab/mining-mess-soaring-sand-prices-ground-claims/421039.html," ‚Äútill two years ago, if somebody wanted to construct a 250 sq yd two-storied house in patiala and ordered sand and gravel from pathankot, it cost him just rs 1.5 lakh for three tippers of gravel and four of sand (including transportation cost)",house,4,20,4,4,32,"ludhiana, moga, pathankot, patiala, sri muktsar sahib"
3/6/17,https://www.tribuneindia.com/news/community/in-absence-of-roads-hoshiarpur-villagers-wade-through-brook/373192.html,"sanjiv kumar bakshi  hoshiarpur, march 5 spread over 14 or 15 km in the hilly terrain of kandi area, kookanet village still has no road connectivity",house,13,1,14,0,28,hoshiarpur
3/6/17,https://www.tribuneindia.com/news/community/in-absence-of-roads-hoshiarpur-villagers-wade-through-brook/373192.html,"it is difficult to cover the whole area as houses are scattered over 14-15 km of area, that too in tough hilly terrain",house,13,1,14,0,28,hoshiarpur
2/23/17,https://www.tribuneindia.com/news/community/syl-camaraderie-disturbed-say-villagers/368171.html," roads and two bridges in ismailpur had no police presence in spite of an alert, and there was no restriction on the entry of vehicles as a team of the tribune visited the site today afternoon",house,12,13,9,0,34,patiala
2/13/17,https://www.tribuneindia.com/news/community/no-govt-help-nangal-villagers-collect-money-to-repair-bridge/363373.html,"arun sharma tribune news service bela ajouli (nangal), feb 12 four days after a wooden bridge on the sutlej connecting nearly two dozen villages with nangal town collapsed, dejected residents of the area have started collecting money for its repair",house,17,5,19,3,44,punjab
2/13/17,https://www.tribuneindia.com/news/community/no-govt-help-nangal-villagers-collect-money-to-repair-bridge/363373.html,"ironically, shiv sena candidate nitin nanda has contributed rs21,000 for the bridge repair",house,17,5,19,3,44,punjab
2/13/17,https://www.tribuneindia.com/news/community/no-govt-help-nangal-villagers-collect-money-to-repair-bridge/363373.html,"ush({ });as the bridge has been damaged badly, they will require at least rs5 lakh for its repair, say villagers",house,17,5,19,3,44,punjab
2/13/17,https://www.tribuneindia.com/news/community/no-govt-help-nangal-villagers-collect-money-to-repair-bridge/363373.html,"on february 8, the wooden bridge built by village residents 16 years ago in 2001 for rs5 lakh fell down, resulting in injuries to nine people",house,17,5,19,3,44,punjab
2/13/17,https://www.tribuneindia.com/news/community/no-govt-help-nangal-villagers-collect-money-to-repair-bridge/363373.html,"in the absence of the bridge, the residents of 20 villages, including bela ajouli, bela dhiani, mjara, bela dargahi, bela bahatian, passiwal, palasi, gohlian and bhalan, have to cover around 20-km distance to reach the nearest town of nangal",house,17,5,19,3,44,punjab
2/13/17,https://www.tribuneindia.com/news/community/no-govt-help-nangal-villagers-collect-money-to-repair-bridge/363373.html,"kamal singh of bela dhiani village said though all parties promised them a bridge every time during elections, nothing had been done till now",house,17,5,19,3,44,punjab
2/13/17,https://www.tribuneindia.com/news/community/no-govt-help-nangal-villagers-collect-money-to-repair-bridge/363373.html,"in the absence of the bridge, the students either have to miss their schools or college or cover a distance of 29 km to reach their institution, says mangal singh of bela dhiani",house,17,5,19,3,44,punjab
2/13/17,https://www.tribuneindia.com/news/community/no-govt-help-nangal-villagers-collect-money-to-repair-bridge/363373.html,"while mittal did not take calls, rana kp singh said it was apathy on part of the sad-bjp government who did not provide any bridge in this part of the state during their 10-year regime",house,17,5,19,3,44,punjab
2/6/17,https://www.tribuneindia.com/news/community/gurdaspur-villagers-left-at-nature-s-mercy/360115.html,"sanjeev singh bariana tribune news service  marara pattan (gurdaspur), feb 5  ‚Äúvottan vele keh ke jaande ne bridge banavange",house,9,0,14,0,23,gurdaspur
2/6/17,https://www.tribuneindia.com/news/community/gurdaspur-villagers-left-at-nature-s-mercy/360115.html,"saal de 2-3 mahine, barsaatan viccch, saanu 25-30 km ghumm ke jaana painda hai,‚Äù said kewal krishan of marara village referring to the pontoon bridge (floating bridge) he was crossing",house,9,0,14,0,23,gurdaspur
2/5/17,https://www.tribuneindia.com/news/community/month-after-boycott-call-four-villages-vote-under-protest/359620.html,"sanjeev singh bariana tribune news service kasauli (kharar), february 4  about 1,500 voters from four villages of majri block, located less than 15 km from chandigarh, exercised their franchise today, even as they registered a protest against lack of education for their children after class x, poor roads and no bridges",house,0,1,19,0,20,punjab
2/5/17,https://www.tribuneindia.com/news/community/month-after-boycott-call-four-villages-vote-under-protest/359620.html,  their main demands include the repair of a 12-km road from mullanpur (adjoining the pgi) to tanda village in haryana; a road in bangidi village; a senior secondary school in the area; and bridges on the rivulets which cut off the villages for months during the monsoon.,house,0,1,19,0,20,punjab
1/22/17,https://www.tribuneindia.com/news/politics/aap-candidates-taking-to-boats-climbing-hillocks-to-reach-voters/353631.html,"deepkamal kaur tribune news service jalandhar, january 21  who said campaigning was easy? when one segment has a river passing through it and another, non-motorable roads and hillocks, canvassing becomes a test of stamina and endurance",house,1,4,14,0,19,"hoshiarpur, jalandhar"
1/22/17,https://www.tribuneindia.com/news/politics/aap-candidates-taking-to-boats-climbing-hillocks-to-reach-voters/353631.html," ‚Äúin a day, i usually cover six to seven villages in plains, while only half a village is covered in kandi area where houses are 500 metres apart",house,1,4,14,0,19,"hoshiarpur, jalandhar"
12/29/16,https://www.tribuneindia.com/news/community/stones-damaged-in-ropar-probe-on/343145.html," on december 23, ropar mla and education minister daljit singh cheema had laid the foundation stone of a bridge on sagraon ‚Äúchoe‚Äù (rivulet) near purkhali village",house,5,5,16,0,26,punjab
12/29/16,https://www.tribuneindia.com/news/community/stones-damaged-in-ropar-probe-on/343145.html, the bridge is to be built for rs 6.5 crore,house,5,5,16,0,26,punjab
12/29/16,https://www.tribuneindia.com/news/community/stones-damaged-in-ropar-probe-on/343145.html," again on december 23, industry minister madan mohan mittal was to inaugurate newly laid roads at kahiwal village near his segment (anandpur sahib)",house,5,5,16,0,26,punjab
12/24/16,https://www.tribuneindia.com/news/community/cheema-lays-stone-for-bridge-on-choe/341170.html,cheema lays stone for bridge on choe,house,0,0,4,1,5,punjab
12/24/16,https://www.tribuneindia.com/news/community/cheema-lays-stone-for-bridge-on-choe/341170.html,ropar: local mla daljit singh cheema laid the foundation stone for a bridge on the sagroan choe between bindrakh and purkhali villages near here on friday,house,0,0,4,1,5,punjab
12/24/16,https://www.tribuneindia.com/news/community/cheema-lays-stone-for-bridge-on-choe/341170.html,"he said the tenders for the bridge, to be built at a cost of rs 6.5 crore, had been floated",house,0,0,4,1,5,punjab
12/24/16,https://www.tribuneindia.com/news/community/cheema-lays-stone-for-bridge-on-choe/341170.html,"in the absence of bridge, hundreds of villages remain cut off from khijrabad, mullanpur and chandigarh during the monsoon",house,0,0,4,1,5,punjab
12/7/16,https://www.tribuneindia.com/news/community/roads-fine-what-else-asks-ropar/333424.html," this sadaknama is enviably long: the widening of the 32-km ropar-nurpur bedi road up to jhajj chowk is in full swing, while the 10-km nurpur bedi-bunga sahib road has already been recarpeted",house,23,7,13,0,43,punjab
12/7/16,https://www.tribuneindia.com/news/community/roads-fine-what-else-asks-ropar/333424.html,work on two roads ‚Äî the 15-km brahmand and bhuriwale marg and 33-km brahm sagar bhuriwale marg ‚Äî is nearing completion,house,23,7,13,0,43,punjab
12/7/16,https://www.tribuneindia.com/news/community/roads-fine-what-else-asks-ropar/333424.html,"malkit singh, a postgraduate, works as a tipper driver with a stone crusher, while daljit singh, who has a degree in civil engineering, is looking after the cattle at home",house,23,7,13,0,43,punjab
12/7/16,https://www.tribuneindia.com/news/community/roads-fine-what-else-asks-ropar/333424.html,"one of them claims that most of the development works, including roads and a bridge, were initiated by the congress government a decade ago; the ruling alliance woke up only recently to maintain the same",house,23,7,13,0,43,punjab
12/7/16,https://www.tribuneindia.com/news/community/roads-fine-what-else-asks-ropar/333424.html,"  gurinder singh, a resident of singh village, feels that focusing on roads alone can‚Äôt bring about development",house,23,7,13,0,43,punjab
12/7/16,https://www.tribuneindia.com/news/community/village-adopted-by-sampla-cries-for-attention/333421.html,"ush({ });  of around 1,200 houses in the village, only 270 have a water connection",house,8,0,14,0,22,hoshiarpur
12/7/16,https://www.tribuneindia.com/news/community/village-adopted-by-sampla-cries-for-attention/333421.html,"only a street has been laid in concrete and the only project near completion is a 66-kv power station,‚Äù he said",house,8,0,14,0,22,hoshiarpur
11/30/16,https://www.tribuneindia.com/news/community/basically-it-s-about-basics-in-muktsar/330233.html,how many photos will you click? work on this road is being done in fits and starts,house,14,0,9,0,23,sri muktsar sahib
11/30/16,https://www.tribuneindia.com/news/community/basically-it-s-about-basics-in-muktsar/330233.html,"eager to talk about poll issues, one of them says, ‚Äúmany people from far-flung areas come to our town to pay obeisance at the historic gurdwara, but see the condition of the road leading to its entrance number 7",house,14,0,9,0,23,sri muktsar sahib
11/30/16,https://www.tribuneindia.com/news/community/basically-it-s-about-basics-in-muktsar/330233.html,"‚Äúfor the past 10 years, our street has been bearing the brunt of rainwater and sewage",house,14,0,9,0,23,sri muktsar sahib
11/30/16,https://www.tribuneindia.com/news/community/basically-it-s-about-basics-in-muktsar/330233.html,"  social activist sham lal goyal, who is leading a campaign for the construction of the town‚Äôs maiden railway overbridge, says deputy cm sukhbir singh badal had laid the foundation stone in february 2014, before the parliamentary elections, but the tenders have been floated only now",house,14,0,9,0,23,sri muktsar sahib
11/23/16,https://www.tribuneindia.com/news/community/faith-takes-a-hit-in-chamkaur-sahib/327061.html,"arun sharma  a ride on the 15-km road, smooth and wide, from ropar to chamkaur sahib gives the impression that all is well with this haloed land of sikh martyrs",house,11,12,5,0,28,"amritsar, fatehgarh sahib, jalandhar"
11/23/16,https://www.tribuneindia.com/news/community/faith-takes-a-hit-in-chamkaur-sahib/327061.html,"it takes at least 45 minutes to cover 15 km on the potholed, dusty road between chamkaur sahib and morinda",house,11,12,5,0,28,"amritsar, fatehgarh sahib, jalandhar"
11/23/16,https://www.tribuneindia.com/news/community/faith-takes-a-hit-in-chamkaur-sahib/327061.html," at morinda, the people reel off their complaints: there is no playground; the only government senior secondary school, located at sukhomajra village, is 3 km away from the town; and the three roads connecting the town to ropar, fatehgarh sahib and chamkaur sahib are in a dilapidated condition",house,11,12,5,0,28,"amritsar, fatehgarh sahib, jalandhar"
11/19/16,https://www.tribuneindia.com/news/community/mann-barred-from-lok-sabha-for-2-more-weeks/325355.html,"aditi tandon tribune news service new delhi, november 18 lok sabha speaker sumitra mahajan today barred aap mp bhagwant mann from attending the house proceedings for two more weeks, allowing another extension to the parliamentary panel investigating the alleged security breach by him",house,4,0,6,0,10,sangrur
11/19/16,https://www.tribuneindia.com/news/community/mann-barred-from-lok-sabha-for-2-more-weeks/325355.html,"it is my right to attend the house, but i have again been asked not to come for two weeks",house,4,0,6,0,10,sangrur
11/19/16,https://www.tribuneindia.com/news/community/mann-barred-from-lok-sabha-for-2-more-weeks/325355.html,"he video-recorded these details while travelling from his official residence to parliament house one morning, and then streamed it all live",house,4,0,6,0,10,sangrur
11/17/16,https://www.tribuneindia.com/news/politics/nothing-western-about-jalandhar-west/324441.html,"the sorry state of affairs is laid bare by the sewerage work in progress on the kapurthala road, used by tens of thousands of commuters every day",house,23,11,9,1,44,"jalandhar, kapurthala"
11/17/16,https://www.tribuneindia.com/news/politics/nothing-western-about-jalandhar-west/324441.html,"the 120-ft road, named after its width, is used by the residents of basti sheikh and basti danishmandan",house,23,11,9,1,44,"jalandhar, kapurthala"
11/17/16,https://www.tribuneindia.com/news/politics/nothing-western-about-jalandhar-west/324441.html,"people are free to say anything, but we invested rs 100 crore through the punjab infrastructure development board (pidb) recently on roads and sewerage",house,23,11,9,1,44,"jalandhar, kapurthala"
11/17/16,https://www.tribuneindia.com/news/politics/nothing-western-about-jalandhar-west/324441.html," the foundation stone of another skill centre, named after kabir, to train construction workers was laid on the 120-ft road earlier this year",house,23,11,9,1,44,"jalandhar, kapurthala"
11/17/16,https://www.tribuneindia.com/news/politics/nothing-western-about-jalandhar-west/324441.html,"  for him, the best thing that has happened in the past five years is a mini civil hospital coming up on the 120-ft road",house,23,11,9,1,44,"jalandhar, kapurthala"
10/14/16,https://www.tribuneindia.com/news/community/night-long-cong-protest-cm-s-house-under-siege/309360.html,ush({ });  over 10 mlas were camping outside the cm‚Äôs house,house,2,0,4,0,6,ludhiana
9/22/16,https://www.tribuneindia.com/news/politics/sampla-rejects-wearing-party-symbol-in-house/299008.html,"tribune news service chandigarh, september 21  bjp state president vijay sampla today said the bjp did not approve of its parliamentarians wearing the party symbol while attending house sessions and official meetings",house,1,0,4,0,5,pathankot
9/15/16,https://www.tribuneindia.com/news/politics/lost-trust--cong-mocks-at-govt/295422.html," taking credit for putting up a stormy show, the young leaders did not miss to mention in informal discussions that it was their idea to stay back in the house for two nights",house,1,2,6,0,9,amritsar
9/10/16,https://www.tribuneindia.com/news/community/not-happy-with-eviction-of-mla-brothers-pb-speaker/293285.html,"ropar, september 10  punjab assembly speaker charanjit singh atwal today said he was not happy with the eviction of the two independent mla brothers from the house, and was compelled to do so in order to run the proceedings without disruption",house,0,0,7,0,7,punjab
9/10/16,https://www.tribuneindia.com/news/community/not-happy-with-eviction-of-mla-brothers-pb-speaker/293285.html," both mla brothers disrupted the proceedings of the house yesterday over the water issue when tributes were to be paid to b r ambedkar on the occasion of his 125th birth anniversary celebrations in the ongoing monsoon session of the assembly, he said here",house,0,0,7,0,7,punjab
9/9/16,https://www.tribuneindia.com/news/community/tributes-paid-to-advani-s-wife-others/292461.html,"ush({ });  later, the assembly observed a two-minute silence following which the speaker adjourned the house for the day as a mark of respect to the departed souls.",house,3,4,2,0,9,punjab
9/2/16,https://www.tribuneindia.com/news/politics/capt-wants-full-house-in-house/289042.html,"if the government does not listen or fails to debate on the issues, our mlas will go to the well of the house to mark their protest,‚Äù said ppcc chief capt amarinder singh after presiding over the clp meeting attended by 34 mlas",house,1,5,7,0,13,punjab
8/25/16,https://www.tribuneindia.com/news/community/gurdaspur-residents-seek-road-repair/285186.html,"tribune news service  gurdaspur, august 24 hundreds of shopkeepers blocked the mandi bus stand road for about three hours forcing the police to divert traffic through alternate routs to clear the rush",house,8,0,1,0,9,gurdaspur
8/25/16,https://www.tribuneindia.com/news/community/gurdaspur-residents-seek-road-repair/285186.html,the 3-km stretch of the road has become a bone of contention between residents and the pwd authorities,house,8,0,1,0,9,gurdaspur
8/25/16,https://www.tribuneindia.com/news/community/gurdaspur-residents-seek-road-repair/285186.html,"for the last four months, the road has been in a dilapidated condition with pwd officials claiming that ‚Äúthey are helpless as they cannot spray tar due to the rainy season",house,8,0,1,0,9,gurdaspur
8/25/16,https://www.tribuneindia.com/news/community/gurdaspur-residents-seek-road-repair/285186.html,residents have given an ultimatum to the authorities to get the road repaired till august 28 or face a bandh on august 29,house,8,0,1,0,9,gurdaspur
8/24/16,https://www.tribuneindia.com/news/community/shopkeepers-block-road-in-gurdaspur-for-3-hours/284830.html,shopkeepers block road in gurdaspur for 3 hours,house,4,0,2,0,6,gurdaspur
8/24/16,https://www.tribuneindia.com/news/community/shopkeepers-block-road-in-gurdaspur-for-3-hours/284830.html,"ravi dhaliwal     tribune news service gurdaspur, august 24   shopkeepers blocked the mandi-bus stand road, considered lifeline of the city, for nearly three hours on wednesday protesting over its dilapidated condition",house,4,0,2,0,6,gurdaspur
8/24/16,https://www.tribuneindia.com/news/community/shopkeepers-block-road-in-gurdaspur-for-3-hours/284830.html,  a 3-km stretch of the road has become a bone of contention between the residents and the pwd authorities,house,4,0,2,0,6,gurdaspur
8/24/16,https://www.tribuneindia.com/news/community/shopkeepers-block-road-in-gurdaspur-for-3-hours/284830.html,for the last four months the road has been lying in a dilapidated condition with pwd officials claiming that ‚Äúthey are helpless as they cannot spray tar due to the rainy season,house,4,0,2,0,6,gurdaspur
8/24/16,https://www.tribuneindia.com/news/community/shopkeepers-block-road-in-gurdaspur-for-3-hours/284830.html, residents have given an ultimatum till august 28 to get the road repaired,house,4,0,2,0,6,gurdaspur
7/26/16,https://www.tribuneindia.com/news/community/mann-apologised-matter-should-have-ended-there-gandhi/271523.html,ush({ });  (follow¬†the tribune on¬†facebook;¬†and¬†twitter @thetribunechd)  mann has been barred from attending the house for 10 days by lok sabha speaker sumitra mahajan till a nine-member parliamentary panel decided appropriate action against him,house,0,0,2,0,2,"patiala, sangrur"
7/4/16,https://www.tribuneindia.com/news/community/paddy-on-450-acres-submerged/260794.html,"gagandeep singh tribune news service jalandhar, july 3  paddy transplanted on around 450 acres in four villages along the sultanpur lodhi-dhalla road has been submerged following recent showers",house,14,19,26,2,61,"jalandhar, sri muktsar sahib"
7/4/16,https://www.tribuneindia.com/news/community/paddy-on-450-acres-submerged/260794.html," villagers alleged that the state government had built only one drain along the road, whose level was raised around 12 years ago",house,14,19,26,2,61,"jalandhar, sri muktsar sahib"
7/4/16,https://www.tribuneindia.com/news/community/paddy-on-450-acres-submerged/260794.html,"they said the road needed at least five drains, especially during the monsoon",house,14,19,26,2,61,"jalandhar, sri muktsar sahib"
7/4/16,https://www.tribuneindia.com/news/community/paddy-on-450-acres-submerged/260794.html,"two killed, 5 hurt in roof collapse  muktsar: a man and his mother were killed when the roof of their house collapsed due to rain at dabwali malko ki village of lambi constituency on sunday",house,14,19,26,2,61,"jalandhar, sri muktsar sahib"
7/4/16,https://www.tribuneindia.com/news/community/paddy-on-450-acres-submerged/260794.html,"in another incident, five members of a family at badian village in gidderbaha subdivision sustained multiple injuries as their roof caved in due to rain",house,14,19,26,2,61,"jalandhar, sri muktsar sahib"
6/28/16,https://www.tribuneindia.com/news/governance/115-year-old-fazilka-building-now-a-protected-monument/258020.html,"raghuvar bhawan, raised in 1901 on 4 kanal and 18 marlas, is located on the freedom fighter road",house,4,0,1,0,5,fazilka
6/16/16,https://www.tribuneindia.com/news/community/paddy-growers-cheer-as-rain-deficit-narrows/252325.html,"not only is this rainfall healthy for all crops, important aspect is that it has significantly bridged the rainfall deficit the state was witnessing for the past 15 days,‚Äù said director, agriculture, dr js bains",house,0,14,3,0,17,"ferozepur, moga, sri muktsar sahib, tarn taran"
6/16/16,https://www.tribuneindia.com/news/community/paddy-growers-cheer-as-rain-deficit-narrows/252325.html," meanwhile, agriculture minister tota singh‚Äôs district moga received highest rainfall measuring 72 mm today morning, whereas muktsar district, which is home district of chief minister parkash singh badal, hardly recorded any rainfall",house,0,14,3,0,17,"ferozepur, moga, sri muktsar sahib, tarn taran"
3/19/16,https://www.tribuneindia.com/news/community/dhindsa-announces-more-sops/210768.html,"tribune news service  chandigarh march 18 concluding the debate on his budget proposals for 2016-17, punjab finance minister parminder singh dhindsa today announced three more incentives in the house: 50 per cent subsidy for fencing of fields in kandi areas to prevent damage of crops by wild animals; making turmeric vat-free and reducing vat (value-added tax) on other spices from 6.5 to 4 per cent; and setting aside rs 50-crore corpus for self-sustainable sewa kendras that the government proposes to set up this year",house,0,12,10,2,24,punjab
3/19/16,https://www.tribuneindia.com/news/community/dhindsa-announces-more-sops/210768.html,"addressing the house after the four congress mlas, including leader of the opposition charanjit singh channi, staged a walkout, dhindsa termed the budget for 2016-17 as a step towards boosting the state‚Äôs economy",house,0,12,10,2,24,punjab
2/14/16,https://www.tribuneindia.com/news/community/to-serve-people-he-bridges-gaps-in-development/196012.html,"tribune news service anandpur sahib, february 13  philanthropist and religious leader labh singh (kila anandgarh) today dedicated the sixth bridge built by his efforts with public participation at burj village near here to people",house,4,0,7,1,12,punjab
2/14/16,https://www.tribuneindia.com/news/community/to-serve-people-he-bridges-gaps-in-development/196012.html,"after the inauguration of the 670-feet bridge, built at a cost of over rs 7 crore, the distance between anandpur sahib and nurpur bedi has been reduced from 22 km to a just 7 km",house,4,0,7,1,12,punjab
1/17/16,https://www.tribuneindia.com/news/punjab/husband-2-sons-gave-up-66-yr-old-can-t-afford-to/184577.html,"praful chander nagpal tribune news service fazilka, january 16the dilapidated house has no door",house,9,27,22,1,59,"fazilka, sri muktsar sahib"
1/17/16,https://www.tribuneindia.com/news/punjab/husband-2-sons-gave-up-66-yr-old-can-t-afford-to/184577.html," ‚Äúi can‚Äôt even commit suicide, someone has to take care of my seven-year-old grandson and young daughter-in-law,‚Äù she says with a terse expression, as she sits on a broken cot in her dingy house situated along a stinking pond in pakkan village",house,9,27,22,1,59,"fazilka, sri muktsar sahib"
1/17/16,https://www.tribuneindia.com/news/punjab/husband-2-sons-gave-up-66-yr-old-can-t-afford-to/184577.html," pakkan village is home to nearly 4,000 people, majority of them marginal farmers and labourers",house,9,27,22,1,59,"fazilka, sri muktsar sahib"
9/25/15,https://www.tribuneindia.com/news/politics/akalis-relieved-as-cong-fights-cong-in-punjab-house/137677.html,"ruchika m khanna tribune news service chandigarh, september 24  the ruling akali-bjp government was spared an onslaught by the opposition congress on the last day of the monsoon session of punjab vidhan sabha today, with the congressmen choosing to fight among themselves in the house",house,2,4,12,0,18,"bathinda, ferozepur, tarn taran"
9/25/15,https://www.tribuneindia.com/news/politics/akalis-relieved-as-cong-fights-cong-in-punjab-house/137677.html, though congress mlas managed to create their share of noise in the house ‚Äî which led to one adjournment for 25 minutes and the session boycott later ‚Äî the case they had built against the government yesterday by targeting three akali ministers over ‚Äúirregularities‚Äù went crumbling amid infighting,house,2,4,12,0,18,"bathinda, ferozepur, tarn taran"
9/25/15,https://www.tribuneindia.com/news/politics/akalis-relieved-as-cong-fights-cong-in-punjab-house/137677.html,"this led to a slanging match between the two sides and raising of slogans, forcing the speaker to adjourn the house",house,2,4,12,0,18,"bathinda, ferozepur, tarn taran"
8/20/15,https://www.tribuneindia.com/news/community/burj-village-cut-off-as-swollen-sutlej-erodes-approach-road-to-bridge/121891.html,"tribune news service anandpur sahib, august 19  a bridge constructed by baba labh singh recently at burj village was damaged badly due to heavy flow of water in sutlej, leaving hundreds of people stranded here today",house,9,3,11,0,23,punjab
8/20/15,https://www.tribuneindia.com/news/community/burj-village-cut-off-as-swollen-sutlej-erodes-approach-road-to-bridge/121891.html, local residents said the 670-feet-long bridge was constructed by baba labh singh (pullanwala baba),house,9,3,11,0,23,punjab
8/20/15,https://www.tribuneindia.com/news/community/burj-village-cut-off-as-swollen-sutlej-erodes-approach-road-to-bridge/121891.html,"ush({ });  burj village used to remains cut off during monsoon and on request of local residents, baba labh singh took up the work of constructing the bridge eight years ago in 2007",house,9,3,11,0,23,punjab
8/14/15,https://www.tribuneindia.com/news/community/kotkapura-residents-protest-potholed-roads/119642.html,"tribune news service kotkapura (faridkot), aug 13  residents of kotkapura town took out a rally today to protest the failure of the state government and the local municipal committee in repairing potholed roads in the last five years",house,6,0,2,0,8,"faridkot, sas nagar, sri muktsar sahib"
7/27/15,https://www.tribuneindia.com/news/community/dug-up-roads-have-doubled-travel-time-to-kapurthala/111827.html,"deepkamal kaur tribune news service jalandhar, july 26  thousands of commuters between jalandhar and kapurthala are a harassed lot as the connecting road is not only potholed but also has been dug up in the monsoon to lay sewerage",house,1,2,1,0,4,"jalandhar, kapurthala"
7/27/15,https://www.tribuneindia.com/news/community/dug-up-roads-have-doubled-travel-time-to-kapurthala/111827.html,"even while the road till the basti bawa khel area is smooth, the drive through the 2-km stretch of the state highway is a nightmare, especially since this congested stretch is single and without any divider",house,1,2,1,0,4,"jalandhar, kapurthala"
7/27/15,https://www.tribuneindia.com/news/community/dug-up-roads-have-doubled-travel-time-to-kapurthala/111827.html,ush({ });  much more harrowing is crossing the next 1.5-km stretch as more than 70 per cent of the width of the road has been dug up to lay the sewer lines,house,1,2,1,0,4,"jalandhar, kapurthala"
7/27/15,https://www.tribuneindia.com/news/community/dug-up-roads-have-doubled-travel-time-to-kapurthala/111827.html,"  mc commissioner gs khehra said, ""the road near basti bawa khel used to get inundated with 1-2 ft water even after a mild shower",house,1,2,1,0,4,"jalandhar, kapurthala"
7/23/15,https://www.tribuneindia.com/news/community/denied-meeting-cps-sidhu-barges-into-cm-s-event/110217.html,"perneet singh tribune news service amritsar, july 22  chief parliamentary secretary dr navjot kaur sidhu, after being ‚Äúcold-shouldered‚Äù by the state government, today threatened to sit on fast-unto-death if a grant of rs10 crore for construction of roads in her amritsar east assembly segment is not released within a fortnight",house,5,1,2,1,9,"amritsar, bathinda"
7/13/15,https://www.tribuneindia.com/news/community/govt-aims-for-the-sky-but-can-t-provide-basic-amenities/106012.html,"ush({ });  due to the faulty drainage system in the city, water accumulates on the roads and it takes at least three hours for it to get drained",house,5,0,5,0,10,"ludhiana, sas nagar"
7/12/15,https://www.tribuneindia.com/news/community/bda-cash-strapped-residents-pool-funds-to-lay-water-pipes/105636.html," twenty-four households of phase iii, model town, pooled in rs 3,000 each to lay the pipes",house,12,0,6,1,19,bathinda
7/12/15,https://www.tribuneindia.com/news/community/bda-cash-strapped-residents-pool-funds-to-lay-water-pipes/105636.html,they laid 400-feet-long water pipes along the road to drain the rainwater,house,12,0,6,1,19,bathinda
7/9/15,https://www.tribuneindia.com/news/community/just-11-of-483-village-ponds-cleaned-in-muktsar-dist-this-year/104247.html," gurlabh singh, sarpanch, udekaran village, said, ‚Äúif there is one more spell of rain in the next two-three days, the water from the pond will overflow and inundate the houses nearby",house,4,1,15,0,20,sri muktsar sahib
6/26/15,https://www.tribuneindia.com/news/punjab/ludhiana-authorities-not-clear-about-project-goals/98762.html," badish k jindal, chairman of the federation of association of small industries of india (fasii), said, ‚Äúa smart city means 24-hour water supply, uninterrupted power, no heaps of garbage, pollution at a considerable low, well-carpeted roads, no traffic congestion, basic amenities to all residents, rehabilitation of slum dwellers, industry getting a boost, a state-of-the-art airport and, above all, the cleaning of the buddha nullah which is playing havoc with the lives of the residents",house,14,0,1,1,16,ludhiana
6/25/15,https://www.tribuneindia.com/news/community/waterlogged-railway-under-bridge-inconveniences-commuters/98405.html,"tribune news service  mansa, june 24 residents had a harrowing time today due to heavy rush of vehicles on the congested mansa railway crossing, while the railway under-bridge (rub) could not be used as it was waterlogged",house,5,0,1,0,6,mansa
5/27/15,https://www.tribuneindia.com/news/community/pond-not-cleaned-villagers-blame-govt/85856.html," situated at a distance of 13 km from abohar, the village was the first in the region to have brick-  lined streets, drains, streetlights, sports ground, water works and other amenities",house,10,2,14,1,27,punjab
5/14/15,https://www.tribuneindia.com/news/community/connecting-people-pulanwala-baba-builds-sixth-bridge-costing-rs-5-cr/80273.html,connecting people: ‚Äòpulanwala baba‚Äô builds sixth bridge costing rs 5 cr,house,5,0,9,4,18,punjab
5/14/15,https://www.tribuneindia.com/news/community/connecting-people-pulanwala-baba-builds-sixth-bridge-costing-rs-5-cr/80273.html,"arun sharma tribune news service ropar, may 13  while the state government has failed to provide even basic amenities in a major part of this district for long, sikh saint labh singh (kila anandgarh) at anandpur sahib has brought succour to lakhs of people by building six bridges over various rivers",house,5,0,9,4,18,punjab
5/14/15,https://www.tribuneindia.com/news/community/connecting-people-pulanwala-baba-builds-sixth-bridge-costing-rs-5-cr/80273.html," labh singh is all set to open a new 670-foot-long bridge at burj village, near anandpur sahib, over the next couple of months",house,5,0,9,4,18,punjab
5/14/15,https://www.tribuneindia.com/news/community/connecting-people-pulanwala-baba-builds-sixth-bridge-costing-rs-5-cr/80273.html, the construction of the bridge was started in 2007,house,5,0,9,4,18,punjab
4/28/15,https://www.tribuneindia.com/news/community/gurdaspur-roads-in-a-dilapidated-state/73174.html,"ravi dhaliwal tribune news service gurdaspur, april 27  roads, both within the gurdaspur city and outside, are in a dilapidated condition",house,6,1,2,0,9,gurdaspur
4/28/15,https://www.tribuneindia.com/news/community/gurdaspur-roads-in-a-dilapidated-state/73174.html, one example is the jail road-behrampur stretch along the mustafabad minor drain,house,6,1,2,0,9,gurdaspur
4/28/15,https://www.tribuneindia.com/news/community/gurdaspur-roads-in-a-dilapidated-state/73174.html,‚Äúthe tendering process for this road and other national and state highways connecting gurdaspur to other cities is in the final stage,house,6,1,2,0,9,gurdaspur
4/28/15,https://www.tribuneindia.com/news/community/gurdaspur-roads-in-a-dilapidated-state/73174.html,‚Äúthis is one of the busiest and strategically most important roads,house,6,1,2,0,9,gurdaspur
4/28/15,https://www.tribuneindia.com/news/community/gurdaspur-roads-in-a-dilapidated-state/73174.html,"the municipal committee should also take part of the blame as 80 per cent of the roads within the city limits, including the bsf road, sangalpura road and the dak khana chowk road, are in a bad condition",house,6,1,2,0,9,gurdaspur
3/3/15,https://www.tribuneindia.com/news/community/wheat-crop-in-moga-flattened/48955.html," muktsar: six months ago, monsoon rains flattened cotton and paddy crops in muktsar district and damaged houses",house,5,56,26,2,89,"bathinda, fatehgarh sahib, moga, sri muktsar sahib"
2/23/15,https://www.tribuneindia.com/news/politics/gurdaspur-focus-on-local-bodies-where-cong-mlas-rule-the-roost/45712.html,"ush({ });  key issues: about 80 per cent of the 7,050 streetlights in this industrial town are dysfunctional",house,4,4,2,0,10,"fatehgarh sahib, gurdaspur, pathankot, sas nagar"
2/23/15,https://www.tribuneindia.com/news/politics/gurdaspur-focus-on-local-bodies-where-cong-mlas-rule-the-roost/45712.html,"dera baba nanak  wards: 11; voters: 4,749; candidates: 25  key issues: the main problems here are poor roads, absence of a dumping site, stray dog menace and non-functional streetlights",house,4,4,2,0,10,"fatehgarh sahib, gurdaspur, pathankot, sas nagar"
2/23/15,https://www.tribuneindia.com/news/politics/gurdaspur-focus-on-local-bodies-where-cong-mlas-rule-the-roost/45712.html,"qadian  wards: 15; voters: 16,169; candidates: 33  key issues: despite the town housing the headquarters of the influential ahmadiya community, the streetlights here are non-functional for the last 10 years",house,4,4,2,0,10,"fatehgarh sahib, gurdaspur, pathankot, sas nagar"
2/23/15,https://www.tribuneindia.com/news/politics/gurdaspur-focus-on-local-bodies-where-cong-mlas-rule-the-roost/45712.html," sri hargobindpur  wards: 11; voters: 6,389; candidates: 29  key issues: the town faces the same problems of encroachments and decrepit link roads",house,4,4,2,0,10,"fatehgarh sahib, gurdaspur, pathankot, sas nagar"
2/23/15,https://www.tribuneindia.com/news/politics/gurdaspur-focus-on-local-bodies-where-cong-mlas-rule-the-roost/45712.html," dhariwal  wards: 13; candidates: 45; voters 13,337  key issues: the town is known more for its encroachments on the gt road leading to batala",house,4,4,2,0,10,"fatehgarh sahib, gurdaspur, pathankot, sas nagar"
12/19/14,https://www.tribuneindia.com/news/community/garbage-dumps-make-town-susceptible-to-diseases/19900.html, the mc has earmarked rs 28.82 lakh for contingency expenses and rs 75 lakh for the maintenance of roads,house,7,2,4,0,13,punjab
12/19/14,https://www.tribuneindia.com/news/community/garbage-dumps-make-town-susceptible-to-diseases/19900.html,"of students: 12,414  community health centre  annual intake of indoor patients: 15,733  annual intake of outdoor patients: 1,40,772 financial stats  budget: rs 11.25 crore  salaries: rs 5.43 crore   power bills: rs 2.88 crore   contingency expenses: rs 28.82 lakh  road maintenance: rs 75 lakh   the mc collects revenue from property tax and vat ",house,7,2,4,0,13,punjab
12/19/14,https://www.tribuneindia.com/news/community/garbage-dumps-make-town-susceptible-to-diseases/19457.html, the mc has earmarked rs 28.82 lakh for contingency expenses and rs 75 lakh for the maintenance of roads,house,4,2,4,0,10,punjab
12/9/14,https://www.tribuneindia.com/news/governance/encroachments-choke-roads-in-princely-town/15885.html,"gagan k teja tribune news service  patiala, november 8  nabha is one of the best cities in patiala district as far as the condition of roads is concerned",house,7,0,8,0,15,patiala
12/9/14,https://www.tribuneindia.com/news/governance/encroachments-choke-roads-in-princely-town/15885.html,"a sum of rs 8.78 crore is spent on development works, including maintenance of roads, water supply and sewerage",house,7,0,8,0,15,patiala
12/9/14,https://www.tribuneindia.com/news/governance/encroachments-choke-roads-in-princely-town/15885.html,the ruling sad-bjp had formed the house during the 2008 council elections,house,7,0,8,0,15,patiala
11/30/14,https://www.tribuneindia.com/news/punjab/poor-supply-forcing-residents-to-dig-deep-for-water/12507.html,"around rs 19.14 crore is spent on development works which  include maintenance of roads, operation and maintenance of water supply and  sewerage",house,13,1,5,0,19,punjab
7/29/19,https://www.tribuneindia.com/news/punjab/woman-killed-as-roof-collapses-due-to-rain/809305.html,"our correspondent abohar, july 28  a woman was killed, while her husband and grandson were injured as the roof of their house collapsed after heavy rain at sardarpura village, 16 km from abohar, on saturday night",house,7,4,16,2,29,"bathinda, sas nagar"
7/29/19,https://www.tribuneindia.com/news/punjab/woman-killed-as-roof-collapses-due-to-rain/809305.html, this was the second loss for the family in less than two weeks as another roof in their house had collapsed due to rain earlier,house,7,4,16,2,29,"bathinda, sas nagar"
7/29/19,https://www.tribuneindia.com/news/punjab/woman-killed-as-roof-collapses-due-to-rain/809305.html," neighbours said as the roof collapsed around 8 pm, they rushed to the house owned by darshan ram (47) and started removing debris",house,7,4,16,2,29,"bathinda, sas nagar"
7/29/19,https://www.tribuneindia.com/news/punjab/woman-killed-as-roof-collapses-due-to-rain/809305.html," roofs of two more houses, one owned by manjoor masih and other by jagga singh in waryam nagar near the state highway here, collapsed, but none was hurt as the families were sleeping outside the rooms.",house,7,4,16,2,29,"bathinda, sas nagar"
9/24/18,https://www.tribuneindia.com/news/punjab/section-of-mall-road-in-amritsar-caves-in-after-heavy-rain/657890.html,"till late in the evening, over 200 sq yards of the road had caved in",house,0,0,0,0,0,amritsar
8/10/18,https://www.tribuneindia.com/news/punjab/missing-forest-officer-s-body-found/634940.html," station house officer (sho), sadar police station, rajesh arora said in a statement given to the police, vijay‚Äôs wife rajni has questioned the appearance of body on thursday which could not be located even after five days of search",house,7,0,3,0,10,hoshiarpur
7/4/18,https://www.tribuneindia.com/news/punjab/two-girls-die-kin-hurt-as-roof-collapses-after-rain/614787.html,"our correspondent  ferozepur, july 3 two girls belonging to a migrant labourers‚Äô family died whereas three other family members got injured when the roof of their house collapsed following heavy rain at khai phemeke village on the ferozepur-fazilka road on tuesday",house,8,0,7,1,16,"fazilka, ferozepur"
6/29/18,https://www.tribuneindia.com/news/punjab/businessman-found-dead-in-nurpur-bedi/612224.html,"tribune news service ropar, june 28  a 44-year-old businessman was found dead on the roof of his cement store in nurpur bedi near here on thursday",house,4,0,6,0,10,punjab
7/19/17,https://www.tribuneindia.com/news/punjab/1-hour-rain-washes-away-heritage-street-splendour/438781.html,1-hour rain washes away heritage street splendour,house,0,0,1,0,1,amritsar
7/19/17,https://www.tribuneindia.com/news/punjab/1-hour-rain-washes-away-heritage-street-splendour/438781.html,"gs paul tribune news service amritsar, july 18  just over an hour of rain was enough to bare the true picture that hid behind the glitter of the newly-laid rs 250-crore golden temple heritage street ‚Äî a dream project of former deputy chief minister sukhbir singh badal",house,0,0,1,0,1,amritsar
7/17/17,https://www.tribuneindia.com/news/punjab/12-schoolchildren-injured-in-road-accident/438034.html,12 schoolchildren injured in road accident,house,0,0,1,0,1,hoshiarpur
7/4/17,https://www.tribuneindia.com/news/punjab/sewage-mess-abohar-mc-faces-music/431350.html,"raj sadosh abohar, july 3  hundreds of arya nagar residents today sat on a dharna near ramdev temple here in protest against accumulation of sewage water on the streets",house,9,1,3,0,13,sas nagar
6/22/17,https://www.tribuneindia.com/news/punjab/rain-exposes-shoddy-highway-work-in-moga/425804.html,a truck laden with sand overturned on the road while three other trucks and many other motor vehicles got stuck in the potholes yesterday,house,2,0,1,0,3,"ludhiana, moga"
6/22/17,https://www.tribuneindia.com/news/punjab/rain-exposes-shoddy-highway-work-in-moga/425804.html,"by that time, digging had been done and construction work had been undertaken only on certain segments of the road",house,2,0,1,0,3,"ludhiana, moga"
6/22/17,https://www.tribuneindia.com/news/punjab/rain-exposes-shoddy-highway-work-in-moga/425804.html," the company restarted the construction of flyovers at ludhiana, mullanpur, jagraon, moga and other cities on the directions of the punjab and haryana high court in 2014, but again stopped the work after digging up the existing roads",house,2,0,1,0,3,"ludhiana, moga"
6/22/17,https://www.tribuneindia.com/news/punjab/rain-exposes-shoddy-highway-work-in-moga/425804.html,"as most of the road work on the 78-km stretch is non-motorable, the congress leader has demanded that the punjab cm should mark a high-level probe into it",house,2,0,1,0,3,"ludhiana, moga"
6/13/17,https://www.tribuneindia.com/news/punjab/rain-fury-3-farmers-die-canal-breaches-submerge-cotton/421481.html,ush({ });  a 30-ft-wide breach in the panjawa minor (sub canal) near choohariwala dhanna village on the abohar-fazilka road submerged cotton crop spread over 60 acres,house,5,30,13,0,48,"fazilka, sas nagar"
6/8/17,https://www.tribuneindia.com/news/punjab/3-die-as-roof-collapses-in-moga/419159.html,3 die as roof collapses in moga,house,16,3,16,1,36,"faridkot, moga, sas nagar"
6/8/17,https://www.tribuneindia.com/news/punjab/3-die-as-roof-collapses-in-moga/419159.html,"tribune reporters moga, june 7  three members of a family were killed and one injured when the roof of their house collapsed due to heavy rain at patto hira singh village in moga district on wednesday",house,16,3,16,1,36,"faridkot, moga, sas nagar"
6/8/17,https://www.tribuneindia.com/news/punjab/3-die-as-roof-collapses-in-moga/419159.html," meanwhile, in another incident, a 15-year-old daughter of a migrant rickshaw puller was buried to death when the roof of their rented accommodation collapsed at bedi nagar",house,16,3,16,1,36,"faridkot, moga, sas nagar"
6/8/17,https://www.tribuneindia.com/news/punjab/3-die-as-roof-collapses-in-moga/419159.html,"moreover, hundreds of trees got uprooted and poles fell on roads",house,16,3,16,1,36,"faridkot, moga, sas nagar"
6/8/17,https://www.tribuneindia.com/news/punjab/3-die-as-roof-collapses-in-moga/419159.html, a woman named lalita (40) was hospitalised as the boundary wall of her house near basant chowk collapsed,house,16,3,16,1,36,"faridkot, moga, sas nagar"
6/8/17,https://www.tribuneindia.com/news/punjab/3-die-as-roof-collapses-in-moga/419159.html,elderly woman killed  abhohar: an elderly woman was killed while her husband and their three grandchildren were injured when the roof of their neighbour‚Äôs house collapsed in chak 3e village near sriganganagar,house,16,3,16,1,36,"faridkot, moga, sas nagar"
5/30/17,https://www.tribuneindia.com/news/punjab/storm-wreaks-havoc-2-dead/414744.html," in choohariwala dhanna village on the abohar-fazilka road, rajbir singh (50) died as a shed fell on him at his house",house,9,4,9,0,22,"fazilka, sas nagar"
8/29/16,https://www.tribuneindia.com/news/community/jakhar-calls-for-relief-measures/287087.html,"abohar, august 28  as rain trigerred a canal breach and damaged houses in abohar, congress state vice-president and local mla sunil jakhar slammed the bjp-ruled municipal council for not gearing up to meet the foreseen challenges of the heavy rainfall",house,6,2,17,0,25,punjab
8/29/16,https://www.tribuneindia.com/news/community/jakhar-calls-for-relief-measures/287087.html,chief minister parkash singh badal had organised his maiden sangat darshan here and sanctioned rs 2 crore to connect slum areas with the main sewerage line on the kandhwala road but the work had not been started so far,house,6,2,17,0,25,punjab
8/29/16,https://www.tribuneindia.com/news/community/jakhar-calls-for-relief-measures/287087.html,  jakhar said rs 1.52 crore was released in april for abohar subdivision to compensate people who had submitted claims against damage to their houses due to heavy rain last year but the eligible families were still waiting for the same,house,6,2,17,0,25,punjab
8/21/16,https://www.tribuneindia.com/news/community/four-killed-12-hurt-as-buses-collide-in-jalandhar-village/283192.html,"gagandeep singh tribune news service malsian (jalandhar), aug 20  four persons were killed and 12 sustained critical injuries when an orbit bus collided with another private bus on the nakodar-shahkot road near billi chuharmi village this afternoon",house,13,10,5,0,28,"jalandhar, ludhiana, moga, pathankot, sri muktsar sahib"
6/15/16,https://www.tribuneindia.com/news/community/three-women-die-in-roof-collapse/251792.html,"tribune news service  moga, june 14 three women were killed when the roof of a cow shelter shed collapsed at dhalleke village in the district this evening",house,8,3,6,0,17,moga
9/23/15,https://www.tribuneindia.com/news/punjab/rain-storm-leave-10-hurt-in-moga/136603.html,residents alleged hundreds of trees were uprooted and caused traffic jams on several roads,house,5,13,35,1,54,moga
9/23/15,https://www.tribuneindia.com/news/punjab/rain-storm-leave-10-hurt-in-moga/136603.html,balvir singh of basti diwan singh said the tin roofs of many houses were blown away and two women injured,house,5,13,35,1,54,moga
7/27/15,https://www.tribuneindia.com/news/community/danger-ahead-tied-in-red-tape-govt-in-deep-slumber/111831.html,"sanjeev singh bariana tribune news service bathinda, july 26  the railway under-bridge on the bathinda-mansa road is a blot on cm parkash singh badal‚Äôs home turf that has a rather enviable road infrastructure",house,2,0,8,0,10,"bathinda, mansa"
7/27/15,https://www.tribuneindia.com/news/community/danger-ahead-tied-in-red-tape-govt-in-deep-slumber/111831.html," the wall of the bridge, inaugurated in september 2012 by cabinet minister harsimrat kaur badal, had collapsed during rain in june 2013",house,2,0,8,0,10,"bathinda, mansa"
7/27/15,https://www.tribuneindia.com/news/community/danger-ahead-tied-in-red-tape-govt-in-deep-slumber/111831.html,"  besides faulty design and weak structure, the rs 24 crore under-bridge has no mechanism in place for disposal of rain water",house,2,0,8,0,10,"bathinda, mansa"
7/27/15,https://www.tribuneindia.com/news/community/danger-ahead-tied-in-red-tape-govt-in-deep-slumber/111831.html,"  sandeep kumar, a traveller from chandigarh, said, ""stretches of 5 km on both sides of the under-bridge have potholes",house,2,0,8,0,10,"bathinda, mansa"
7/27/15,https://www.tribuneindia.com/news/community/danger-ahead-tied-in-red-tape-govt-in-deep-slumber/111831.html," mansa roads being repaireddifferent roads in mansa ‚Äîthe bhavanigarh-bathinda, talwandi-mansa and dhanaula-bhikhi sections ‚Äîwhich are under repair, continue to be travellers‚Äô nightmare because they have been dug up as part of the rs 600 crore project being funded by the world bank",house,2,0,8,0,10,"bathinda, mansa"
7/27/15,https://www.tribuneindia.com/news/community/danger-ahead-tied-in-red-tape-govt-in-deep-slumber/111831.html," dinesh gulati, a senior manager with a private bank who travels regularly on this road, said, ""while travelling from bathinda towards bhavanigarh, one finds the road dug up for about 5 km at different points",house,2,0,8,0,10,"bathinda, mansa"
7/27/15,https://www.tribuneindia.com/news/community/rape-convict-gets-10-yr-jail/111821.html,"abohar  woman found hanging¬†  the body of a 21-year-old woman, preeti, was found hanging with a ceiling fan at her house in the border madera village near hindumalkot on saturday",house,1,1,6,0,8,punjab
7/27/15,https://www.tribuneindia.com/news/community/1-dies-3-injured-in-mishaps-due-to-rain/111819.html,"sudhish prasad (50) of purani abadi in sriganganagar, 40 km from here, died when he reportedly slipped from the roof of a house in vinoba bast",house,8,1,7,0,16,sas nagar
7/27/15,https://www.tribuneindia.com/news/community/1-dies-3-injured-in-mishaps-due-to-rain/111819.html,"ush({ });in another incident, three children were hurt when the roof of a house collapsed around 6.15 am at barkat colony in hanumangarh on sunday",house,8,1,7,0,16,sas nagar
6/28/15,https://www.tribuneindia.com/news/punjab/hundreds-of-hemkund-sahib-pilgrims-evacuated/99493.html, pilgrims were stranded as bridges on various rivers were washed away due to heavy rain that lashed the area between june 24 and june 26,house,17,10,13,0,40,"amritsar, sas nagar"
6/28/15,https://www.tribuneindia.com/news/punjab/hundreds-of-hemkund-sahib-pilgrims-evacuated/99493.html," when contacted on phone, sewa singh said by making a temporary bridge on a river near bhandra village, the army evacuated about 1,000 pilgrims from gurdwara gobind dham",house,17,10,13,0,40,"amritsar, sas nagar"
6/28/15,https://www.tribuneindia.com/news/punjab/hundreds-of-hemkund-sahib-pilgrims-evacuated/99493.html,two youths killed in mishap near rishikesh  amritsar: two amritsar youths were killed in a road mishap near rishikesh while they were returning from hemkund sahib in uttarakhand,house,17,10,13,0,40,"amritsar, sas nagar"
6/14/15,https://www.tribuneindia.com/news/community/victims-blame-govt-say-tragedy-was-avoidable/93599.html, the recommended height of a bridge is 18 feet,house,13,0,2,0,15,ludhiana
6/14/15,https://www.tribuneindia.com/news/community/victims-blame-govt-say-tragedy-was-avoidable/93599.html,the height calculations go awry if the road surface is high,house,13,0,2,0,15,ludhiana
4/7/15,https://www.tribuneindia.com/news/community/abohar-streets-get-waterlogged/63916.html,"  as the municipal council‚Äôs sanitation staff has been on strike for the past five days to protest the non-payment of salaries for two months, garbage heaps were dumped on streets",house,1,0,0,0,1,punjab
3/17/15,https://www.tribuneindia.com/news/community/6-killed-in-abohar-sriganganagar/54631.html,"ush({ });in another incident, indu (25), her 30-month-old son ujwal and niece tamanna (3) were buried under debris as roof of their house collapsed early this morning at chak 3rb in padampur segment of sriganganagar",house,9,12,11,0,32,sas nagar
3/17/15,https://www.tribuneindia.com/news/community/6-killed-in-abohar-sriganganagar/54631.html," thick carpet of hail covered the sriganganagar-srikaranpur road near mirzewala where at least 70 per cent of the wheat and mustard crop has been damaged, lal chand, sarpanch, told kailash chander sharma, sub divisional magistrate, who conducted a survey in the area today",house,9,12,11,0,32,sas nagar
3/4/15,https://www.tribuneindia.com/news/community/woman-dies-in-roof-collapse/49459.html,"an elderly woman, bhago devi (80), died and her brother lal chand and nephew jaskaran were injured as the roof of their house collapsed in munda village on the outskirts of hanumangarh last night",house,5,23,16,0,44,sas nagar
3/4/15,https://www.tribuneindia.com/news/community/woman-dies-in-roof-collapse/49459.html,"ush({ });residents of kandhwala amarkot, 13 km from here, submitted a memorandum to the sub-divisional administration to complain that rainwater had entered their houses",house,5,23,16,0,44,sas nagar
8/9/12,https://www.dainiktribuneonline.com/2012/08/‡§Æ‡§æ‡§®‡§∏‡§æ-‡§Æ‡•á‡§Ç-‡§¨‡§æ‡§∞‡§ø‡§∂-‡§ú‡§≤‡§Æ‡§ó‡•ç‡§®-‡§π‡•Å/,part from other areas of hara people of ward number 1 10 and 8 had a lot of trouble because in the absence of water drainage where there is always water on the roads,house,12,0,12,0,24,"mansa, sas nagar"
8/9/12,https://www.dainiktribuneonline.com/2012/08/‡§Æ‡§æ‡§®‡§∏‡§æ-‡§Æ‡•á‡§Ç-‡§¨‡§æ‡§∞‡§ø‡§∂-‡§ú‡§≤‡§Æ‡§ó‡•ç‡§®-‡§π‡•Å/,ue to several hours of rain water logging increased further number nine has also received reports of water logging in many houses; on the other hand three wheelers and rickshaw drivers have made a lot of profit due to the rain,house,12,0,12,0,24,"mansa, sas nagar"
8/1/10,https://www.dainiktribuneonline.com/2010/08/‡§¨‡§æ‡§∞‡§ø‡§∂-‡§∏‡•á-‡§Æ‡§ï‡§æ‡§®-‡§ï‡•Ä-‡§õ‡§§-‡§ó‡§ø‡§∞‡•Ä-‡§∏‡§≠/,hoshiarpur july 31 the roof of the house of a poor family collapsed due to heavy rains in nisak village sakrooli last night but the house has been damaged,house,3,2,17,0,22,hoshiarpur
8/1/10,https://www.dainiktribuneonline.com/2010/08/‡§¨‡§æ‡§∞‡§ø‡§∂-‡§∏‡•á-‡§Æ‡§ï‡§æ‡§®-‡§ï‡•Ä-‡§õ‡§§-‡§ó‡§ø‡§∞‡•Ä-‡§∏‡§≠/,hen the rain came at a high speed around 2 clock in the night suddenly the roof of the house fell,house,3,2,17,0,22,hoshiarpur
8/1/10,https://www.dainiktribuneonline.com/2010/08/%e0%a4%9d%e0%a4%ae%e0%a4%be%e0%a4%9d%e0%a4%ae-%e0%a4%ac%e0%a4%b0%e0%a4%b8%e0%a4%be%e0%a4%a4-%e0%a4%b8%e0%a5%87-%e0%a4%9c%e0%a4%a8%e0%a4%9c%e0%a5%80%e0%a4%b5%e0%a4%a8-%e0%a4%b9%e0%a5%81%e0%a4%86/,f 27 mm of rain got stuck in the jam there would be a situation of waterlogging on the roads then it rained continuously for two days then what would be the condition of the administration and the corporation,house,5,0,3,0,8,punjab
8/21/11,https://www.dainiktribuneonline.com/2011/08/40-%e0%a4%b9%e0%a4%9c%e0%a4%be%e0%a4%b0-%e0%a4%8f%e0%a4%95%e0%a4%a1%e0%a4%bc-%e0%a4%ad%e0%a5%82%e0%a4%ae%e0%a4%bf-%e0%a4%ac%e0%a4%be%e0%a4%a2%e0%a4%bc-%e0%a4%95%e0%a5%80-%e0%a4%9a%e0%a4%aa%e0%a5%87/,he camp has been encased at ussi dam flood water is passing over the roads from village baupur to pasan kadim water is visible in the 67 km wide area of the dam towards tarn taran 8 feet in many places along the dam,house,6,34,28,0,68,"kapurthala, tarn taran"
8/24/11,https://www.dainiktribuneonline.com/2011/08/%e0%a4%b8%e0%a4%a4%e0%a4%b2%e0%a5%81%e0%a4%9c-%e0%a4%a4%e0%a4%a5%e0%a4%be-%e0%a4%ac%e0%a5%8d%e0%a4%af%e0%a4%be%e0%a4%b8-%e0%a4%a8%e0%a5%87-%e0%a4%a4%e0%a4%ac%e0%a4%be%e0%a4%b9%e0%a5%80-%e0%a4%ae/,he manalileh road was blocked due to landslides on rohtang pass hundreds of tourists and local people are stranded near rahni nala border road,house,4,7,6,0,17,sas nagar
8/6/13,https://www.dainiktribuneonline.com/2013/08/%e0%a4%ac%e0%a4%be%e0%a4%8a%e0%a4%aa%e0%a5%81%e0%a4%b0-%e0%a4%ae%e0%a5%87%e0%a4%82-%e0%a4%ac%e0%a4%be%e0%a4%a2%e0%a4%bc-%e0%a4%b8%e0%a5%87-%e0%a4%aa%e0%a4%be%e0%a4%82%e0%a4%9a-%e0%a4%b9%e0%a4%9c/,he bridge built on the river from the river is also removed in such a situation hundreds of people are cut off from the world,house,4,28,13,0,45,kapurthala
8/6/13,https://www.dainiktribuneonline.com/2013/08/‡§µ‡§∞‡•ç‡§∑‡§æ-‡§∏‡•á-‡§≤‡•Å‡§ß‡§ø‡§Ø‡§æ‡§®‡§æ-‡§Æ‡•á‡§Ç-‡§¨‡§æ‡§¢/,ludhiana 6 august nine torrential rains for more than two hours today created flood situation in the largest city of punjab water was flooded on all the markets and roads of the city,house,6,1,3,0,10,ludhiana
8/6/13,https://www.dainiktribuneonline.com/2013/08/‡§µ‡§∞‡•ç‡§∑‡§æ-‡§∏‡•á-‡§≤‡•Å‡§ß‡§ø‡§Ø‡§æ‡§®‡§æ-‡§Æ‡•á‡§Ç-‡§¨‡§æ‡§¢/,he representative wandered in the rain and saw that the domoria bridge was old and the boundary of the new city was formed the flow of the sewer drainage water passing through it was so fast that at least three feet of water was stored under the bridge from the sewerage hole,house,6,1,3,0,10,ludhiana
8/6/13,https://www.dainiktribuneonline.com/2013/08/‡§µ‡§∞‡•ç‡§∑‡§æ-‡§∏‡•á-‡§≤‡•Å‡§ß‡§ø‡§Ø‡§æ‡§®‡§æ-‡§Æ‡•á‡§Ç-‡§¨‡§æ‡§¢/,nstead of stopping the water the water was being thrown out due to which dirt and smelly dirty water was seen roaming the streets as the rain was at full pub at around ten in the morning resulting in rain and sewerage choke hundreds of vehicles on the roads everywhere in water,house,6,1,3,0,10,ludhiana
8/6/13,https://www.dainiktribuneonline.com/2013/08/‡§µ‡§∞‡•ç‡§∑‡§æ-‡§∏‡•á-‡§≤‡•Å‡§ß‡§ø‡§Ø‡§æ‡§®‡§æ-‡§Æ‡•á‡§Ç-‡§¨‡§æ‡§¢/,udhiana 6 august nine torrential rains for more than two hours today created flood situation in the largest city of punjab water was flooded on all the markets and roads of the city,house,6,1,3,0,10,ludhiana
8/6/13,https://www.dainiktribuneonline.com/2013/08/‡§µ‡§∞‡•ç‡§∑‡§æ-‡§∏‡•á-‡§≤‡•Å‡§ß‡§ø‡§Ø‡§æ‡§®‡§æ-‡§Æ‡•á‡§Ç-‡§¨‡§æ‡§¢/, budha drove in his vehicles on the road built on the side of the drain but there was so much water standing under the railway bridge near new kundanpuri that no one was able to get the courage to cross it this road which came out of the outskirts of the city,house,6,1,3,0,10,ludhiana
8/6/13,https://www.dainiktribuneonline.com/2013/08/‡§µ‡§∞‡•ç‡§∑‡§æ-‡§∏‡•á-‡§≤‡•Å‡§ß‡§ø‡§Ø‡§æ‡§®‡§æ-‡§Æ‡•á‡§Ç-‡§¨‡§æ‡§¢/,he river was seen instead of the road from vishwakarma chowk to sherpur as it crossed less than four feet of water on this road,house,6,1,3,0,10,ludhiana
8/6/13,https://www.dainiktribuneonline.com/2013/08/‡§µ‡§∞‡•ç‡§∑‡§æ-‡§∏‡•á-‡§≤‡•Å‡§ß‡§ø‡§Ø‡§æ‡§®‡§æ-‡§Æ‡•á‡§Ç-‡§¨‡§æ‡§¢/,here were also flood scenes from samrala chowk to cheema chowk there was so much rain water that small buses coming from outside on one side were also deteriorated amidst the water there were long queues of vehicles on all the roads of the city,house,6,1,3,0,10,ludhiana
8/13/13,https://www.dainiktribuneonline.com/2013/08/%e0%a4%95%e0%a4%be%e0%a4%b2%e0%a5%80-%e0%a4%ac%e0%a5%87%e0%a4%88%e0%a4%82-%e0%a4%95%e0%a5%80-%e0%a4%ac%e0%a4%be%e0%a4%a2%e0%a4%bc-%e0%a4%b8%e0%a5%87-%e0%a4%aa%e0%a4%be%e0%a4%a8%e0%a5%80-%e0%a4%ae/,flood affected house of sultanpur lodhi manjar kapurthala 13 august floods in nis dariya beas caused havoc on dozens of villages including village rampur gora in mand area and now started moving towards sultanpur lodhi town in the ravaged in hyderabad,house,9,0,7,0,16,kapurthala
8/13/13,https://www.dainiktribuneonline.com/2013/08/%e0%a4%95%e0%a4%be%e0%a4%b2%e0%a5%80-%e0%a4%ac%e0%a5%87%e0%a4%88%e0%a4%82-%e0%a4%95%e0%a5%80-%e0%a4%ac%e0%a4%be%e0%a4%a2%e0%a4%bc-%e0%a4%b8%e0%a5%87-%e0%a4%aa%e0%a4%be%e0%a4%a8%e0%a5%80-%e0%a4%ae/,he flood water from the left reached the road and behind the kothi of former finance minister dopinderjit kaur in front of sultanpur lodhi main bus station at 10 pm on monday night,house,9,0,7,0,16,kapurthala
8/13/13,https://www.dainiktribuneonline.com/2013/08/%e0%a4%95%e0%a4%be%e0%a4%b2%e0%a5%80-%e0%a4%ac%e0%a5%87%e0%a4%88%e0%a4%82-%e0%a4%95%e0%a5%80-%e0%a4%ac%e0%a4%be%e0%a4%a2%e0%a4%bc-%e0%a4%b8%e0%a5%87-%e0%a4%aa%e0%a4%be%e0%a4%a8%e0%a5%80-%e0%a4%ae/,n tuesday morning the water from the black bayonet has come twotwo feet on the streets of the city in such a situation the residents of the city have started seeing fear,house,9,0,7,0,16,kapurthala
7/2/16,https://www.dainiktribuneonline.com/2016/07/%e0%a4%b2%e0%a5%81%e0%a4%a7%e0%a4%bf%e0%a4%af%e0%a4%be%e0%a4%a8%e0%a4%be-%e0%a4%ae%e0%a5%87%e0%a4%82-%e0%a4%aa%e0%a4%b9%e0%a4%b2%e0%a5%80-%e0%a4%b9%e0%a5%80-%e0%a4%ac%e0%a4%be%e0%a4%bf%e0%a4%b0/,ludhiana july 2 heavy rains in nis ludhiana on saturday the water accumulated on the ferozepur road,house,5,0,4,0,9,"ferozepur, ludhiana, sas nagar"
7/2/16,https://www.dainiktribuneonline.com/2016/07/%e0%a4%b2%e0%a5%81%e0%a4%a7%e0%a4%bf%e0%a4%af%e0%a4%be%e0%a4%a8%e0%a4%be-%e0%a4%ae%e0%a5%87%e0%a4%82-%e0%a4%aa%e0%a4%b9%e0%a4%b2%e0%a5%80-%e0%a4%b9%e0%a5%80-%e0%a4%ac%e0%a4%be%e0%a4%bf%e0%a4%b0/,ue to the torrential rains that took place for about five hours the streets and streets of most of the business and habitable areas of the city were two to three,house,5,0,4,0,9,"ferozepur, ludhiana, sas nagar"
5/27/17,https://www.amarujala.com/photo-gallery/chandigarh/flood-in-bathinda-due-to-canal-breaking?pageId=2,as many as 200 houses in sai nagar were flooded by two to three feet due to a 50foot crack in the rajwawa passing behind ganpati colony in bathinda city and several acres of farmers' bg cotton crop was destroyed.,house,0,7,3,0,10,"bathinda, sas nagar"
8/22/13,https://timesofindia.indiatimes.com/city/chandigarh/Satluj-continues-to-flood-villages-in-Ferozepur-Fazilka/articleshow/21969055.cms,standing crop in thousands of acres of land has been destroyed we request the administration to offer whatever compensation they can to people whose houses have collapsed said shinder singh,house,14,32,52,1,99,"fazilka, ferozepur"
8/22/13,https://timesofindia.indiatimes.com/city/chandigarh/Satluj-continues-to-flood-villages-in-Ferozepur-Fazilka/articleshow/21969055.cms,while hundreds of farmers have vacated their homes for safer places many others are reportedly trapped inside their houses surrounded by flood waters,house,14,32,52,1,99,"fazilka, ferozepur"
7/14/10,https://www.hindustantimes.com/chandigarh/rescue-work-on-in-flood-hit-mansa/story-m0YJTUQlvf57lbvPDH2hLP.html,Around 200 houses and standing crops on nearly 5000 acres have been damaged in the floods We have made all arrangements to provide packed food and water to the flood victims So far there has been no loss of life due to floods in Mansa he said,house,5,20,21,0,46,mansa
9/25/18, https://www.hindustantimes.com/punjab/flood-threat-looms-in-patiala-as-ghaggar-in-spate/story-YD1VnN3c8eKDBf6IET3zDM.html,aterlogging traffic chaos  heavy rain since over 72 hours has left almost all roads in the royal city inundated causing a floodlike situation on monday,house,17,25,25,0,67,"patiala, sangrur"
9/25/18, https://www.hindustantimes.com/punjab/flood-threat-looms-in-patiala-as-ghaggar-in-spate/story-YD1VnN3c8eKDBf6IET3zDM.html,arkets residential areas and city roads were flooded with around 3ft water,house,17,25,25,0,67,"patiala, sangrur"
9/25/18, https://www.hindustantimes.com/punjab/flood-threat-looms-in-patiala-as-ghaggar-in-spate/story-YD1VnN3c8eKDBf6IET3zDM.html,ven the garbage has not been cleared in the past three days it is floating in the rain water and is entering houses exposing people to diseases he added,house,17,25,25,0,67,"patiala, sangrur"
8/12/16,https://www.hindustantimes.com/punjab/cps-sidhu-rakes-up-flooding-in-amritsar-with-jibe-at-sukhbir/story-AtymU2THQJ4kLN8h3lr8NP.html,the two wheeler riders were spotted pushing their vehicles in kneedeep water many vehicles also broke down while plying on the waterfilled roads,house,8,0,1,0,9,amritsar
8/12/16,https://www.hindustantimes.com/punjab/cps-sidhu-rakes-up-flooding-in-amritsar-with-jibe-at-sukhbir/story-AtymU2THQJ4kLN8h3lr8NP.html,the mc has also not ensured that the desilting is done properly in every part of the city especially before the rainy season during the general house meeting the mc had passed the resolution of allocating rs 1210 crore for the project of sanitation and desilting sewerage and drains so that these drains could incorporate the rain water,house,8,0,1,0,9,amritsar
10/21/19,https://reliefweb.int/node/3365543,"situation report on flood/heavy rain fall as on 21st october, 2019 at 1800 hrs  ministry of home affairs disaster management division (national emergency response centre) [",house,10,10,39,0,59,punjab
10/21/19,https://reliefweb.int/node/3365543,"review of flood situation in the country by mha on the direction of hon‚Äôble home minister, minister of state (home) took a meeting on 09.08.2019 to review and take stock of the flood situation of affected state and rescue and relief operations being carried out by ndrf, army, air force, navy and icg",house,10,10,39,0,59,punjab
10/21/19,https://reliefweb.int/node/3365543,"‚û¢ union home minister, shri amit shah undertook an aerial survey of flood affected areas of belgavi district of karnataka and sangli& kolhapur of maharashtra on 11.08.2019",house,10,10,39,0,59,punjab
10/21/19,https://reliefweb.int/node/3365543,in the high level committee under the chairmanship of hon‚Äôble home minister in its meeting held on 19.08.2019 reviewed the existing practice of deputing imct after the receipt of memorandum from the state in the wake of any severe calamity,house,10,10,39,0,59,punjab
10/21/19,https://reliefweb.int/node/3365543,"accordingly, ministry of home affairs has constituted inter ministerial central teams (imcts) for thirteen states affected by flood viz",house,10,10,39,0,59,punjab
10/18/19,https://reliefweb.int/node/3354153,"an assessment made by the disaster management division of the union home ministry indicates that over 2.2 million people have been evacuated so far and 8,700 relief camps set up across these states to provide temporary shelter to the displaced population2 ",house,16,2,21,1,40,punjab
9/14/19,https://reliefweb.int/node/3303423,"approximately, 33,800 houses were reportedly destroyed in assam, kerala and rajasthan",house,31,3,15,0,49,punjab
8/29/19,https://reliefweb.int/node/3279863,"uttarakhand in uttarakhand, the number of dead rose to 12, cloudbursts have wreaked havoc in a dozen villages of uttarakhand's uttarkashi district, washing away houses and hectares of agricultural land",house,10,11,25,1,47,"ferozepur, sas nagar"
8/20/19,https://reliefweb.int/node/3267823,"in another high level meeting chaired by union home minister amit shah, an announcement was made to provide assistance of rs 4432 crore to odisha, karnataka and himachal pradesh",house,17,7,21,0,45,"jalandhar, ludhiana, sas nagar"
8/20/19,https://reliefweb.int/node/3267743,more than 800 roads are closed and hundreds of vehicles are stranded in lahaul spiti due to unexpected snowfall which triggered landslides,house,18,17,17,5,57,punjab
8/20/19,https://reliefweb.int/node/3267743,yamuna has crossed danger level in jalaun district and more than one dozens villages  have cut their road connect to the district headquarters and people are using boats,house,18,17,17,5,57,punjab
8/19/19,https://reliefweb.int/node/3263983,"over 670 roads, including 13 national highways are blocked across himachal pradesh, which received 1,065% higher than normal ‚Äòsingle day rainfall‚Äô on 18 august",house,6,1,3,0,10,punjab
8/4/19,https://reliefweb.int/node/3246694,"situation report on flood/heavy rain fall in maharashtra, gujarat, assam, bihar, karnataka and kerala as on 04th august 2019 at 1800 hrs  ministry of home affairs disaster management division (national emergency response centre) forecast i",house,0,2,3,0,5,punjab
8/1/19,https://reliefweb.int/node/3244394,"situation report on flood/heavy rain fall in gujarat, assam, bihar, maharashtra and kerala as on 01st august 2019 at 1800 hrs  ministry of home affairs disaster management division (national emergency response centre) 1",house,0,3,4,0,7,punjab
7/31/19,https://reliefweb.int/node/3244399,"situation report on flood/heavy rain fall in assam, bihar, maharashtra and kerala as on 31st july 2019 at 1800 hrs  ministry of home affairs disaster management division (national emergency response centre) 1",house,0,2,4,0,6,punjab
7/27/19,https://reliefweb.int/node/3238109,"situation report on flood/heavy rainfall in assam, bihar, maharashtra, kerala and rajasthan as on 27th july 2019 at 1800 hrs  ministry of home affairs disaster management division (national emergency response centre) 1",house,10,1,10,0,21,punjab
7/27/19,https://reliefweb.int/node/3238109,"‚Ä¢ on getting the information about this incident around 8.50 am, ministry of home affairs (mha) immediately deputed 02 team each of national disaster response force (ndrf) from mumbai and pune along with 09 boats and other necessary rescue equipment and ndrf teams reached the spot at about 0940 hrs",house,10,1,10,0,21,punjab
7/24/19,https://reliefweb.int/node/3233558,"situation report on flood/heavy rain fall in assam, bihar and tripura as on 24th july, 2019 at 1800 hrs  ministry of home affairs disaster management division (national emergency response centre) forecast i",house,0,0,4,0,4,punjab
9/25/18,https://reliefweb.int/node/2802759,the road till manali will be restored in next 3-4 days ,house,3,3,1,0,7,punjab
7/26/18,https://reliefweb.int/node/2716534,"in vasundhara, more than 50 houses were evacuated after a road caved in",house,8,3,8,0,19,sas nagar
6/15/18,https://reliefweb.int/node/2656989,"in tripura, the flood situation deteriorated with the rain-fed khowai river inundating fresh areas rendering thousands homeless and damaging roads and crops",house,9,12,11,0,32,punjab
6/15/18,https://reliefweb.int/node/2656989,"with thousands of houses damaged, several thousand people have been moved out of the area and provided shelter at relief camps",house,9,12,11,0,32,punjab
7/27/17,https://reliefweb.int/node/2143594,"as per the information of damage received from these states 508 persons have lost their lives, 24,811 cattle heads have perished, 63,215 houses/ huts have been damaged and about 2.8 lakh hectares of crop area have been reported affected due to heavy rains/ flood/ landslides etc",house,11,22,44,1,78,punjab
7/27/17,https://reliefweb.int/node/2143594,"assam has faced two waves of floods till 19th july 2017 affecting 29 districts out of 33 districts, resulting in loss of human lives, livestock and large scale damage to the dwelling houses",house,11,22,44,1,78,punjab
7/27/17,https://reliefweb.int/node/2143594,"the state government has mentioned that 1160 relief camps (357 relief camps + 803 relief distribution center) have been opened and 1,31,416 inmates are housed in these camps, so far",house,11,22,44,1,78,punjab
7/27/17,https://reliefweb.int/node/2143594,hon‚Äôble mos (home) has visited and reviewed the flood situation of assam and arunachal pradesh from 13th to 15th july 2017,house,11,22,44,1,78,punjab
3/22/17,https://reliefweb.int/node/1960219,managing competing demands for water the systems and technology introduced under the two hydrology projects have much broader applications too,house,10,12,11,2,35,punjab
3/22/17,https://reliefweb.int/node/1960219,"‚Äúoverall, the real and tangible benefits of the systems established under the two hydrology projects include people whose lives, homes, and crops are saved due to improved flood forecasting, farmers who benefit from improved irrigation supplies, and children who do not fall ill or worse from drinking contaminated water,‚Äù said halla maher qaddumi, senior water economist at the world bank in new delhi",house,10,12,11,2,35,punjab
7/13/16,https://reliefweb.int/node/1608486,"the safdarjung observatory recorded 16.3mm of rainfall between 8.30am and 5.30am while weather stations at palam, lodhi road, ayanagar and ridge recorded 10mm, 21.6mm, 38mm and traces of rain respectively during the same period",house,1,0,2,0,3,sas nagar
7/3/16,https://reliefweb.int/node/1595866,"however, 04 moderate flood sites have been reported in assam and bihar :- i) river jaibharali at nt road crossing jai-bharali, district- sonitpur, assam is flowing at 77.5 m against danger level 77.0 m with steady trend",house,0,5,1,0,6,punjab
12/15/15,https://reliefweb.int/node/1307226,"some 164,000 people have been housed in 460 camps in chennai, cuddalore, thiruvallur and kanchipuram districts while thousands have also been shifted to others' houses after water entered theirs",house,31,5,22,0,58,punjab
12/15/15,https://reliefweb.int/node/1307226,at least 269 people have been killed to due to rain and flood related incidents in tamil nadu where thousands have become homeless,house,31,5,22,0,58,punjab
12/15/15,https://reliefweb.int/node/1307226,"the floods have left over 269 dead in tamil nadu and 54 in andhra pradesh, said home minister rajnath singh in loksabha",house,31,5,22,0,58,punjab
11/18/14,https://reliefweb.int/node/728766,"help for recovery after south asia floods  by david tereshchuk* november 18, 2014‚Äîin september of this year, south asia‚Äôs worst monsoon season in 50 years caused torrential flooding and landslides that killed hundreds of people in india and pakistan, and displaced many thousands from their homes",house,14,4,15,0,33,sas nagar
11/18/14,https://reliefweb.int/node/728766,"in india-administered kashmir‚Äîa region that for decades has been disputed territory between the two countries, and where the rains were especially severe‚Äîat least 120 people died and 200,000 were left homeless",house,14,4,15,0,33,sas nagar
11/18/14,https://reliefweb.int/node/728766,"srinagar, indian kashmir‚Äôs largest city, was extensively damaged, with floodwaters running at a depth of 12 feet in many neighborhoods, often submerging entire homes",house,14,4,15,0,33,sas nagar
11/18/14,https://reliefweb.int/node/728766,globalmedic has installed public weather-purification systems and is also providing hundreds of families with the tools to purify water in their own homes,house,14,4,15,0,33,sas nagar
10/28/14,https://reliefweb.int/node/703828,"communities in india hit by new flooding some 1.2 million people in assam and meghalaya have been hit by new flooding, which has destroyed nearly 34,000 homes and damaged infrastructure such as schools, health facilities and transport structures",house,13,3,31,0,47,punjab
10/28/14,https://reliefweb.int/node/703828,"essential relief for flood-affected families in pakistan in pakistan, hundreds died and around 2.5 million people were affected as floodwaters destroyed homes, vital infrastructure, and livelihoods last month",house,13,3,31,0,47,punjab
9/15/14,https://reliefweb.int/node/691734,"to restore the road connectivity, five task forces of border roads organisation, which include 5700 personnel, have been deployed in srinagar, rajouri and akhnoor",house,16,7,11,0,34,"amritsar, sas nagar"
9/15/14,https://reliefweb.int/node/691734,"on the jammu ‚Äì srinagar highway, bro personnel have cleared the road up to km 172 (ramsu) and work is in progress to clear fresh landslides in areas that were cleared earlier",house,16,7,11,0,34,"amritsar, sas nagar"
9/15/14,https://reliefweb.int/node/691554,"to restore the road connectivity, five task forces of border roads organisation, which include 5700 personnel, have been deployed in srinagar, rajouri and akhnoor",house,15,7,11,0,33,"amritsar, sas nagar"
9/15/14,https://reliefweb.int/node/691554,"on the jammu ‚Äì srinagar highway, bro personnel have cleared the road up to km 172 (ramsu) and work is in progress to clear fresh landslides in areas that were cleared earlier",house,15,7,11,0,33,"amritsar, sas nagar"
9/13/14,https://reliefweb.int/node/691309,"migrant labourers trek mountainous highway to escape flood-hit kashmir  sameer arshad,tnn jammu: narinder kumar (30), a bihari mason, was working overtime when gushing waters menacingly flooded the construction site he was working at in srinagar, forcing him and his fellow workers to take refuge on the top floor of a nearby house",house,12,1,7,1,21,"amritsar, sas nagar"
9/13/14,https://reliefweb.int/node/691309,"kumar is among an estimated 12,000 people, who have trekked to ramban in sheer desperation as they received no help from administration, which was practically washed away in the flood waters that have killed over 200 people and marooned tens of thousands besides leaving as many homeless",house,12,1,7,1,21,"amritsar, sas nagar"
9/13/14,https://reliefweb.int/node/691309,"roshan singh from amritsar, who arrived in ramban on saturday, said the army rescued him after five days from a trapped house in srinagar",house,12,1,7,1,21,"amritsar, sas nagar"
9/12/14,https://reliefweb.int/node/691053,"thousands of villages have been inundated by the floods, with many people taking to their roofs to escape the fast-rising waters",house,11,8,12,0,31,punjab
9/10/14,https://reliefweb.int/node/690316,"hundreds of villages have been submerged, forcing hundreds of thousands of people from their homes and leaving hundreds of people dead",house,10,9,18,0,37,sas nagar
9/10/14,https://reliefweb.int/node/690316,"as many as 60 major and minor roads have been cut off and over 30 bridges washed away, hampering the relief and rescue operations",house,10,9,18,0,37,sas nagar
9/10/14,https://reliefweb.int/node/690316," caritas pakistan reaches survivors in punjab and azad jammu and kashmir in pakistan, hundreds of villages have been washed away, embankments broken, roads damaged and power lines downed",house,10,9,18,0,37,sas nagar
9/10/14,https://reliefweb.int/node/690209,"bsnl and around 5,700 personnel of border roads organization are working to restore communication links, the absence of which is hitting operations",house,16,5,22,0,43,sas nagar
8/12/13,https://reliefweb.int/node/594982,"rail, road traffic disrupted as rain continues in himachal pradesh  s gopal puri, tnn | aug 12, 2013, 05.36 am ist dharamshala: constant rainfall in himachal pradesh has caused massive destruction in the lower parts of the state, with rural areas and villages being the worst affected",house,5,16,22,0,43,"pathankot, sas nagar"
8/17/12,https://reliefweb.int/node/518712,"the chief amounts of rainfall (2 cm and above) recorded at 1730 hours ist of yesterday are : dehradun-6, bikaner, kota and kochi-3 each and pendra road-2",house,1,4,1,0,6,punjab
7/26/12,https://reliefweb.int/node/513569,"deployment of national disaster response force (ndrf) 31 teams consisting of 1041 personnel of ndrf have been deployed in assam ‚Äì16, andhra pradesh ‚Äì 01, jharkhand-01, north bengal-04, maharashtra-03, parliament house, new delhi-01, j&k-02 and bihar-03",house,1,4,2,0,7,punjab
7/24/12,https://reliefweb.int/node/513441,"deployment of national disaster response force (ndrf) 31 teams consisting of  1042 personnel of ndrf have been deployed in assam ‚Äì16,  andhra pradesh ‚Äì 01, jharkhand-01, north bengal-04, maharashtra-03, parliament house, new delhi-01, j&k-02 and bihar-03",house,1,4,2,0,7,punjab
7/21/12,https://reliefweb.int/node/513143,"deployment of national disaster response force (ndrf) ‚Ä¢   29 teams consisting of 997 personnel of ndrf have been deployed in assam ‚Äì14, andhra pradesh ‚Äì 01, jharkhand-01, north bengal-04, maharashtra-03, parliament house, new delhi-01, j&k-02 and bihar-03.",house,1,4,2,0,7,ludhiana
7/20/12,https://reliefweb.int/node/513140,"deployment of national disaster response force (ndrf) ‚Ä¢   29 teams consisting of 997 personnel of ndrf have been deployed in assam ‚Äì14, andhra pradesh ‚Äì 01, jharkhand-01, north bengal-04 (including 02 teams left today for darjeeling), maharashtra-03, parliament house, new delhi-01, j&k-02 and bihar-03.",house,1,4,2,0,7,sas nagar
7/11/12,https://reliefweb.int/node/510337,"southwest monsoon-2012: daily flood situation report summary of important events as on 11.07.2012  no.32-20/2012-ndm-i ministry of home affairs (disaster management division) rainfall/flood situation in the country rainfall occurred at many places over himachal pradesh, east rajasthan,gujarat region, west madhya pradesh, konkan & goa, coastal karnataka, kerala, lakshadeweep, andaman & nicobar islands, chhattisgarh, meghalaya, arunachal pradesh and mizoram, at a few places over punjab, east madhya pradesh, west uttar pradesh,bihar, orissa and assam and at one or two places over uttrakhand, haryana, west rajasthan, east uttar pradesh, interior maharashtra, tamilnadu, andhara pradesh, jharkhand, gangetic west bengal & sikkim and interior karnataka",house,1,5,2,0,8,patiala
9/10/11,https://reliefweb.int/node/445958,"the floods have so far claimed 310 lives, 6371 life stock is lost and 63190 houses are completely damaged",house,6,3,13,0,22,punjab
9/10/11,https://reliefweb.int/node/445958,"based on these field assessments, the society looks forward for an assistance of inr 176,280,000 to address the needs of 250,000 people (50,000 households) for a period of 6 months",house,6,3,13,0,22,punjab
9/6/11,https://reliefweb.int/node/446494,"deployment of national disaster response force (ndrf) 20 teams consisting of 590 personnel of ndrf have been deployed in assam - (5),andhra pradesh ‚Äì (2), kerala ‚Äì (1), parliament house new delhi- (1), punjab (2), uttar pradesh (2) & bihar (7)",house,1,2,2,0,5,punjab
9/4/11,https://reliefweb.int/node/446518,"deployment of national disaster response force (ndrf) 18 teams consisting of 521 personnel of ndrf have been deployed in assam - (5),andhra pradesh ‚Äì (2), kerala ‚Äì (1),  parliament house new delhi- (1),  punjab (2), uttar pradesh (2) & bihar (5)",house,1,2,2,0,5,punjab
9/3/11,https://reliefweb.int/node/451369,"deployment of national disaster response force (ndrf) 18 teams consisting of 521 personnel of ndrf have been deployed in assam - (5),andhra pradesh ‚Äì (2), kerala ‚Äì (1),  parliament house new delhi- (1),  punjab (2), uttar pradesh (2) & bihar (5)",house,1,0,2,0,3,punjab
9/2/11,https://reliefweb.int/node/452495,"deployment of national disaster response force (ndrf) 18 teams consisting of 518 personnel of ndrf have been deployed in assam - (5),andhra pradesh ‚Äì (2), kerala ‚Äì (1), parliament house new delhi- (1), punjab (2), uttar pradesh (2) & bihar (5)",house,1,2,2,0,5,punjab
9/1/11,https://reliefweb.int/node/452494,"deployment of national disaster response force (ndrf) 18 teams consisting of 518 personnel of ndrf have been deployed in assam - (5),andhra pradesh ‚Äì (2), kerala ‚Äì (1),  parliament house new delhi- (1),  punjab (2), uttar pradesh (2) & bihar (5)",house,1,4,2,0,7,punjab
8/29/11,https://reliefweb.int/node/454118,"deployment of national disaster response force (ndrf) 22 teams consisting of 637 personnel of ndrf have been deployed in assam - (6),andhra pradesh ‚Äì (2), kerala ‚Äì (1), gujarat(2), parliament house new delhi- (1),  punjab (1), uttar pradesh (3) & bihar (6).",house,1,0,2,0,3,punjab
8/28/11,https://reliefweb.int/node/454113,"deployment of national disaster response force (ndrf) 19 teams consisting of 597 personnel of ndrf have been deployed in assam - (6),andhra pradesh ‚Äì (2), kerala ‚Äì (1),  parliament house new delhi- (1),  punjab (1), uttar pradesh (3) & bihar (5).",house,1,0,2,0,3,punjab
8/27/11,https://reliefweb.int/node/452516,"deployment of national disaster response force (ndrf) 19 teams consisting of 554 personnel of ndrf have been deployed in assam - (6),andhra pradesh ‚Äì (2), kerala ‚Äì (1), parliament house new delhi- (1), punjab (1), uttar pradesh (3) & bihar (5).",house,1,2,2,0,5,punjab
8/26/11,https://reliefweb.int/node/452515,"deployment of national disaster response force (ndrf) ÔÉò   19 teams consisting of 542 personnel of ndrf have been deployed in assam - (6),andhra pradesh ‚Äì (2), kerala ‚Äì (1), parliament house new delhi- (1), punjab (1), uttar pradesh (3) & bihar (5).",house,1,4,2,0,7,punjab
8/18/11,https://reliefweb.int/node/441578,the 126 mw larjji power house on beas river and 60 mw project on rangri nallah were shut down due to heavy silt carried by flash-floods,house,19,8,5,0,32,punjab
8/9/11,https://reliefweb.int/node/440240,"deployment of national disaster response force (ndrf) 20 teams consisting of 644 personnel of ndrf have been deployed in assam - (6),  andhra pradesh ‚Äì (2), j&k ‚Äì (2), kerala ‚Äì (1), parliament house new delhi- (1), bihar (6) & uttar pradesh (2) ",house,1,0,2,0,3,punjab
8/5/11,https://reliefweb.int/node/440488,"deployment of national disaster response force (ndrf) 17 teams consisting of 546 personnel of ndrf have been deployed in assam - (6),  andhra pradesh ‚Äì (2), j&k ‚Äì (2), kerala ‚Äì (1), parliament house new delhi- (1) and bihar (5)",house,1,2,2,0,5,punjab
7/17/11,https://reliefweb.int/node/426580,"southwest monsoon-2011: daily flood situation report 17 jul 2011  sitrep no-47/2011 1700 hours no.32-20/2011-ndm-i ministry of home affairs (disaster management division) rainfall/flood situation in the country ‚Ä¢   moderate to heavy rainfall with isolated very heavy falls have been       reported in some parts of bihar, orissa, uttarakhand, sikkim, goa, madhya pradesh, rajasthan, west bengal, kerala, uttar pradesh, karnataka, maharashtra and  orissa",house,1,0,2,0,3,punjab
7/13/11,https://reliefweb.int/node/425753,"southwest monsoon-2011: daily flood situation report 13 jul 2011  sitrep no-43/2011 1700 hours no.32-20/2011-ndm-i ministry of home affairs (disaster management division) rainfall/flood situation in the country moderate to heavy rainfall with isolated very heavy falls have been reported in some parts of gujarat, maharashtra, karnataka and  jharkhand",house,1,2,2,0,5,punjab
7/12/11,https://reliefweb.int/node/425524,"southwest monsoon-2011: daily flood situation report 12 jul 2011  sitrep no-42/2011 1700 hours no.32-20/2011-ndm-i ministry of home affairs (disaster management division) summary of important events as on 12.07.2011 rainfall/flood situation in the country ‚Ä¢ moderate to heavy rainfall with isolated very heavy falls have been reported in some parts of gujarat, maharashtra, karnataka and jharkhand",house,0,2,2,0,4,punjab
7/9/11,https://reliefweb.int/node/426007,"southwest monsoon-2011: daily flood situation report 9 jul 2011  sitrep no-39/2011 1700 hours no.32-20/2011-ndm-i ministry of home affairs (disaster management division) rainfall/flood situation in the country moderate to heavy rainfall with isolated very heavy falls have been reported in some parts of gujarat, madhya pradesh, rajasthan, bangalore, maharashtra and himachal pradesh",house,1,2,2,0,5,punjab
9/23/10,https://reliefweb.int/node/382315,"32-20/2010-ndm-i ministry of home affairs (disaster management division) summary of important events as on 23.09.2010 rainfall/flood situation in the country - moderate to heavy rainfall with isolated very heavy falls have been reported in some parts of sikkim, west bengal, jharkhand, bihar, uttar pradesh, haryana, chandigarh, delhi, punjab, himachal pradesh, rajasthan, karnataka, kerala and lakshadweep",house,1,2,2,0,5,punjab
9/21/10,https://reliefweb.int/node/382328,"32-20/2010-ndm-i ministry of home affairs (disaster management division) summary of important events as on 21.09.2010 uttarakhand - today at about 1300 hrs an army expedition party to mount comet consisting of 43 personnel came under land slide probably glacier at gadhsoli, near joshi math, district chamoli (uttarakhand)",house,3,3,2,0,8,punjab
9/20/10,https://reliefweb.int/node/382327,"32-20/2010-ndm-i ministry of home affairs (disaster management division) summary of important events as on 22.09.2010 rainfall/flood situation in the country - moderate to heavy rainfall with isolated very heavy falls have been reported in some parts of meghalaya, sikkim, uttar pradesh, haryana, chandigarh, delhi, jammu & kashmir and rajasthan",house,1,2,2,0,5,punjab
9/13/10,https://reliefweb.int/node/381211,"32-20/2010-ndm-i ministry of home affairs (disaster management division) summary of important events as on 13.09.2010 rainfall/flood situation in the country - moderate to heavy rainfall with isolated very heavy falls have been reported in some parts of west bengal, jharkhand, uttar pradesh, uttarakhand, haryana, chandigarh, delhi, punjab, himachal pradesh, rajasthan, gujarat and andhra pradesh",house,1,0,2,0,3,punjab
9/11/10,https://reliefweb.int/node/380754,"32-20/2010-ndm-i ministry of home affairs (disaster management division) summary of important events as on 11.09.2010 rainfall/flood situation in the country -    moderate to heavy rainfall with isolated very heavy falls have been reported in some parts of assam, andhra pradesh, chhattisgarh, karnataka, kerala, madhya pradesh, orissa, rajasthan and tamil nadu",house,1,2,2,0,5,punjab
9/10/10,https://reliefweb.int/node/380872,"32-20/2010-ndm-i ministry of home affairs (disaster management division) summary of important events as on 10.09.2010 rainfall/flood situation in the country - moderate to heavy rainfall with isolated very heavy falls have been reported in some parts of arunachal pradesh, haryana, chandigarh, delhi, jammu & kashmir, rajasthan, madhya pradesh, gujarat region, konkan & goa, maharashtra, karnataka and lakshadweep",house,0,2,2,0,4,punjab
9/9/10,https://reliefweb.int/node/380443,"32-20/2010-ndm-i ministry of home affairs (disaster management division) summary of important events as on 09.09.2010 rainfall/flood situation in the country - moderate to heavy rainfall with isolated very heavy falls have been reported in some parts of arunachal pradesh, west bengal, uttarakhand, haryana, chandigarh, delhi, punjab, himachal pradesh, rajasthan, orissa, madhya pradesh, gujarat region, konkan & goa, maharashtra, chhattisgarh, karnataka and kerala",house,0,2,2,0,4,punjab
7/29/10,https://reliefweb.int/node/362397,- 157 houses fully and 1074 houses have been partially damaged,house,10,6,16,0,32,"mansa, patiala, sangrur, sas nagar"
7/28/10,https://reliefweb.int/node/362384,- 157 houses fully and 1072 houses have been partially damaged,house,10,6,16,0,32,"mansa, patiala, sangrur, sas nagar"
7/25/10,https://reliefweb.int/node/362192,- 137 houses fully and 745 houses have been partially damaged,house,10,8,16,0,34,"mansa, patiala, sangrur, sas nagar"
7/24/10,https://reliefweb.int/node/362106,- 137 houses fully and 745 houses have been partially damaged,house,10,5,17,0,32,"mansa, patiala, sangrur, sas nagar"
7/23/10,https://reliefweb.int/node/362190,- 137 houses fully and 745 houses have been partially damaged,house,10,5,16,0,31,"mansa, patiala, sangrur, sas nagar"
7/22/10,https://reliefweb.int/node/361876,- 137 houses fully and 745 houses have been partially damaged,house,8,5,15,0,28,"mansa, patiala, sangrur, sas nagar"
7/21/10,https://reliefweb.int/node/361685,- 137 houses fully and 742 houses have been partially damaged,house,8,5,15,0,28,"mansa, patiala, sangrur, sas nagar"
7/20/10,https://reliefweb.int/node/361587,- 137 houses fully and 742 houses have been partially damaged,house,8,3,15,0,26,"mansa, patiala, sangrur, sas nagar"
7/19/10,https://reliefweb.int/node/361653,- 137 houses fully and 742 houses have been partially damaged,house,8,3,15,0,26,"mansa, patiala, sangrur, sas nagar"
7/18/10,https://reliefweb.int/node/361463,-131 houses fully and 620 houses have been partially damaged,house,10,5,16,0,31,"mansa, patiala, sangrur, sas nagar"
7/17/10,https://reliefweb.int/node/361549,-131 houses fully and 620 houses have been partially damaged,house,7,5,15,0,27,"mansa, patiala, sangrur, sas nagar"
7/16/10,https://reliefweb.int/node/361436,-131 houses fully and 620 houses have been partially damaged,house,9,3,16,0,28,"mansa, patiala, sangrur, sas nagar"
7/15/10,https://reliefweb.int/node/361268,- 111 houses fully and 205 houses have been partially damaged,house,7,3,15,0,25,"mansa, patiala, sangrur, sas nagar"
7/14/10,https://reliefweb.int/node/361147,- 111 houses fully and 205 houses have been partially damaged,house,3,5,14,0,22,"mansa, patiala, sangrur"
7/14/10,https://reliefweb.int/node/360970,"in its advisory to the punjab and haryana governments, the home ministry said the balance available with punjab was rs 2,316 crore and haryana rs 1,151 crore",house,2,2,10,0,14,punjab
7/14/10,https://reliefweb.int/node/360970,"meanwhile, the home ministry has sent teams of the national disaster response force (ndrf) consisting of 206 personnel along with 32 boats to haryana",house,2,2,10,0,14,punjab
7/13/10,https://reliefweb.int/node/360982,"over 1,967 km of road network has been fully damaged or washed away in the floods in punjab alone.",house,9,9,15,0,33,"amritsar, fatehgarh sahib, ferozepur, gurdaspur, hoshiarpur, ludhiana, patiala, sangrur, sas nagar"
7/13/10,https://reliefweb.int/node/360959,- 111 houses fully and 205 houses have been partially damaged,house,7,7,18,0,32,"mansa, patiala, sangrur"
7/12/10,https://reliefweb.int/node/361003,- 91 houses fully and 146 houses have been partially damaged,house,7,7,13,0,27,"patiala, sangrur"
7/11/10,https://reliefweb.int/node/360767,india: southwest monsoon-2010 - daily flood situation report 11 jul 2010  sitrep no-41/2010 1700 hours no.32-20/2010-ndm-i ministry of home affairs (disaster management division) summary of important events as on 11.07.2010 rainfall/flood situation in the country haryana - no significant rainfall has been reported in the state,house,6,4,15,0,25,"patiala, sangrur"
7/11/10,https://reliefweb.int/node/360767,- 80 houses fully and 129 houses have been partially damaged,house,6,4,15,0,25,"patiala, sangrur"
7/11/10,https://reliefweb.int/node/360755,floods have damaged 190 link roads in patiala,house,8,12,25,0,45,"amritsar, patiala, sangrur"
7/10/10,https://reliefweb.int/node/360648,india: southwest monsoon-2010 - daily flood situation report 10 jul 2010  sitrep no-40/2010  1700 hours no.32-20/2010-ndm-i ministry of home affairs (disaster management division) summary of important events as on 10.07.2010 rainfall/flood situation in the country haryana - light rainfall has been reported in few parts of the state,house,8,5,21,0,34,"ludhiana, patiala, roopnagar, sangrur, sas nagar"
7/10/10,https://reliefweb.int/node/360648,- 80 fully and 129 partially houses have been damaged,house,8,5,21,0,34,"ludhiana, patiala, roopnagar, sangrur, sas nagar"
7/10/10,https://reliefweb.int/node/360648,- 763.26 km road have been damaged due to heavy and incessant rainfall.,house,8,5,21,0,34,"ludhiana, patiala, roopnagar, sangrur, sas nagar"
7/9/10,https://reliefweb.int/node/360499,32-20/2010-ndm-i ministry of home affairs (disaster management division) summary of important events as on 09.07.2010 rainfall/flood situation in the country haryana - light to moderate rainfall has been reported in few parts of the state,house,9,5,21,0,35,"ludhiana, patiala, roopnagar, sangrur, sas nagar"
7/9/10,https://reliefweb.int/node/360499,- 80 fully and 129 partially houses have been damaged,house,9,5,21,0,35,"ludhiana, patiala, roopnagar, sangrur, sas nagar"
7/9/10,https://reliefweb.int/node/360499,- 763.26 km road have been damaged due to heavy and incessant rainfall,house,9,5,21,0,35,"ludhiana, patiala, roopnagar, sangrur, sas nagar"
7/7/10,https://reliefweb.int/node/360299,"india: flood fears in punjab, haryana as rain pours  new delhi/chandigarh: with unrelenting rains over the past 36 hours, the three northern states of punjab, haryana and himachal pradesh have got all but cut off from the rest of the country, with most major roads and rail tracks flooded and unusable",house,3,0,2,0,5,punjab
7/6/10,https://reliefweb.int/node/360264,- ¬† ¬† ¬† ¬†163 fully and 3379 partially houses have been damaged so far,house,7,4,14,0,25,punjab
7/5/10,https://reliefweb.int/node/360195,- ¬† ¬† ¬† ¬†157 fully and 3340 partially houses have been damaged so far,house,7,4,14,0,25,punjab
7/4/10,https://reliefweb.int/node/360232,- ¬† ¬† ¬† ¬†142 fully and 3125 partially houses have been damaged so far,house,7,4,14,0,25,punjab
7/3/10,https://reliefweb.int/node/360255,- ¬† ¬† ¬† ¬†142 fully and 3125 partially houses have been damaged so far,house,7,6,15,0,28,punjab
7/2/10,https://reliefweb.int/node/360081,- 142 fully and 3125 partially houses have been damaged so far,house,7,6,15,0,28,punjab
7/1/10,https://reliefweb.int/node/359848,- ¬† ¬† ¬† ¬†142 fully and 3125 partially houses have been damaged so far,house,7,5,14,0,26,punjab
6/30/10,https://reliefweb.int/node/359918,- ¬† ¬† ¬† ¬†142 fully and 3125 partially houses have been damaged so far,house,7,7,14,0,28,punjab
6/29/10,https://reliefweb.int/node/359891,- ¬† ¬† ¬† ¬†133 fully and 2986 partially houses have been damaged so far,house,5,7,14,0,26,punjab
6/3/10,https://reliefweb.int/node/359948,- ¬† ¬† ¬† ¬†13 houses have been damaged,house,1,2,14,0,17,punjab
6/3/10,https://reliefweb.int/node/359948,- ¬† ¬† ¬† ¬†385 houses (13-fully & 372-partially) have been damaged,house,1,2,14,0,17,punjab
12/21/09,https://reliefweb.int/node/337810,"following an assessment, a disaster relief emergency fund (dref) of approximately chf 307,000 (usd 294,763 or eur 205,656) has been allocated for the distribution of non-food items to some 4,000 affected families and replenishment of emergency stocks during the cyclone aila operation, bangladesh red crescent society (bdrcs) and the international federation successfully completed the distribution of shelter kits and household items to 7,000 the affected families in satkhira and khulna districts",house,37,4,13,1,55,punjab
12/21/09,https://reliefweb.int/node/337810,latest figures on the displaced people suggest that more than 1.65 million (out of 2.7 million) displaced families have returned to their homes in malakand division,house,37,4,13,1,55,punjab
8/18/09,https://reliefweb.int/node/320992,- 12547 houses have been damaged,house,17,11,32,0,60,sas nagar
8/18/09,https://reliefweb.int/node/320992,- 22196 houses have been damaged,house,17,11,32,0,60,sas nagar
8/18/09,https://reliefweb.int/node/320992,- 6122 houses have been damaged,house,17,11,32,0,60,sas nagar
8/18/09,https://reliefweb.int/node/320992,- 10877 houses have been damaged,house,17,11,32,0,60,sas nagar
8/5/09,https://reliefweb.int/node/319788,- 7127 houses have been damaged,house,19,14,43,0,76,punjab
8/5/09,https://reliefweb.int/node/319788,- 22138 houses have been damaged,house,19,14,43,0,76,punjab
8/5/09,https://reliefweb.int/node/319788,- 5492 houses (fully-83 & partially-5409) have been damaged,house,19,14,43,0,76,punjab
8/5/09,https://reliefweb.int/node/319788,- 10877 houses have been damaged,house,19,14,43,0,76,punjab
7/29/09,https://reliefweb.int/node/318915,- 5926 houses have been damaged,house,15,17,38,0,70,punjab
7/29/09,https://reliefweb.int/node/318915, - 21580 houses have been damaged,house,15,17,38,0,70,punjab
7/29/09,https://reliefweb.int/node/318915,- 5382 houses have been damaged,house,15,17,38,0,70,punjab
7/29/09,https://reliefweb.int/node/318915,- 5914 houses have been damaged,house,15,17,38,0,70,punjab
9/21/08,https://reliefweb.int/node/281535,- 45190 houses have also been damaged so far,house,47,29,84,0,160,sas nagar
9/21/08,https://reliefweb.int/node/281535,- 332 state and 512 panchayat roads are reportedly damaged due to heavy rainfall in the state,house,47,29,84,0,160,sas nagar
9/21/08,https://reliefweb.int/node/281535,"- 3,19,669 houses are reported to have been damaged due to flood so far",house,47,29,84,0,160,sas nagar
9/21/08,https://reliefweb.int/node/281535,"- about 3,40,761 houses have been damaged so far",house,47,29,84,0,160,sas nagar
9/20/08,https://reliefweb.int/node/281294,- 45190 houses have also been damaged so far,house,46,21,89,0,156,punjab
9/20/08,https://reliefweb.int/node/281294,- 332 state and 512 panchayat roads are reportedly damaged due to heavy rainfall in the state,house,46,21,89,0,156,punjab
9/20/08,https://reliefweb.int/node/281294,"- 3,19,569 houses are reported to have been damaged due to flood so far",house,46,21,89,0,156,punjab
9/20/08,https://reliefweb.int/node/281294,"- about 3,31,265 houses have been damaged so far",house,46,21,89,0,156,punjab
9/20/08,https://reliefweb.int/node/281294,- 418099 houses have been damaged due to flood so far,house,46,21,89,0,156,punjab
9/9/08,https://reliefweb.int/node/279984,"consolidated report on india floods  situation according to the updated report of the disaster management division of the ministry of home affairs, so far, incessant rains and flash floods have engulfed 1906 human lives, affected a population of 199,69326, estimated livestock loss is 19940 and demolished/damaged 583255 houses in 13634 villages of 117 districts across the country",house,30,8,38,7,83,punjab
9/7/08,https://reliefweb.int/node/279521,"- 3,14,756 houses have been damaged due to flood so far",house,25,11,42,0,78,punjab
9/7/08,https://reliefweb.int/node/279521,"- about 1,53,484 houses have been damaged so far",house,25,11,42,0,78,punjab
9/7/08,https://reliefweb.int/node/279521,- 406511 houses have been damaged due to flood so far,house,25,11,42,0,78,punjab
9/6/08,https://reliefweb.int/node/280844,"- 3,04,745 houses are reported to have been damaged due to flood so far",house,26,13,53,0,92,punjab
9/6/08,https://reliefweb.int/node/280844,"- about 1,53,484 houses have been damaged so far",house,26,13,53,0,92,punjab
9/6/08,https://reliefweb.int/node/280844,- 406511 houses (240398 fully and 166113 partially) are reported to have been damaged due to flood so far,house,26,13,53,0,92,punjab
9/3/08,https://reliefweb.int/node/278859,"according to government figures, vast areas of agricultural land have been inundated and a large number of houses have collapsed or been destroyed (597,000 houses have been fully damaged while 418,497 houses have been partially damaged)",house,49,30,91,1,171,"amritsar, gurdaspur, hoshiarpur, jalandhar, kapurthala, moga, sas nagar"
9/3/08,https://reliefweb.int/node/278859,"latest reports from the ministry of home affairs indicate that over 3.3 million people from 1,849 villages in 16 districts of the state have been affected",house,49,30,91,1,171,"amritsar, gurdaspur, hoshiarpur, jalandhar, kapurthala, moga, sas nagar"
9/3/08,https://reliefweb.int/node/278859,"a total of 223,446 houses (temporary and permanent) have been destroyed and 13,550 cattle have 2 been lost",house,49,30,91,1,171,"amritsar, gurdaspur, hoshiarpur, jalandhar, kapurthala, moga, sas nagar"
9/3/08,https://reliefweb.int/node/278859,"over 0.15 million houses have been destroyed and more than 37,000 people are still taking shelter in 438 relief camps",house,49,30,91,1,171,"amritsar, gurdaspur, hoshiarpur, jalandhar, kapurthala, moga, sas nagar"
9/1/08,https://reliefweb.int/node/278555,"- 2,97,958 houses are reported to have been damaged so far",house,38,19,78,0,135,punjab
9/1/08,https://reliefweb.int/node/278555,"- 1,15,159 houses have been damaged so far",house,38,19,78,0,135,punjab
9/1/08,https://reliefweb.int/node/278555,"- 6,875 houses and 90 huts have been damaged so far",house,38,19,78,0,135,punjab
9/1/08,https://reliefweb.int/node/278555,- 406058 houses have been damaged so far,house,38,19,78,0,135,punjab
8/29/08,https://reliefweb.int/node/278448,"of houses destroyed 227,969 the 16 affected districts include muzaffarpur, supaul, patna, katihar, nalanda, araria, west champaran, shekhpura, saharsa, purnea, saran, begusarai, bhagalpur, madhepura, vaishall and khagaria",house,23,11,34,0,68,punjab
8/27/08,https://reliefweb.int/node/278134,- also two flood trained teams (77 personnel) are moving by road from ndrf bn kolkata with 02 medical vehicles to augment the flood rescue efforts,house,25,9,55,0,89,ferozepur
8/27/08,https://reliefweb.int/node/278134,- 6226 houses (3926-fully and 2300 -partially) and 90 huts have been damaged so far,house,25,9,55,0,89,ferozepur
8/27/08,https://reliefweb.int/node/278134,"- 84,693 houses have been damaged so far",house,25,9,55,0,89,ferozepur
8/27/08,https://reliefweb.int/node/278134,- 398899 houses (238880 fully and 160019 partially) are reported to have been damaged due to flood so far,house,25,9,55,0,89,ferozepur
8/26/08,https://reliefweb.int/node/278299,"- 2,27,081 houses are reported to have been damaged",house,33,9,56,0,98,"ferozepur, jalandhar, kapurthala, moga"
8/26/08,https://reliefweb.int/node/278299,"- in bellary district, a bridge between roopanagudi and chalagurki villages submerged under water due to which 12 persons who were traveling in 03 vehicles (02 cars and 01 canter) have taken shelter on the trees near the bridge",house,33,9,56,0,98,"ferozepur, jalandhar, kapurthala, moga"
8/26/08,https://reliefweb.int/node/278299,- 6226 houses and 90 huts have been damaged so far,house,33,9,56,0,98,"ferozepur, jalandhar, kapurthala, moga"
8/26/08,https://reliefweb.int/node/278299,"- 82,529 houses (3076 fully and 79453 partially) have been damaged so far",house,33,9,56,0,98,"ferozepur, jalandhar, kapurthala, moga"
8/26/08,https://reliefweb.int/node/278299,- 398899 houses (238880 fully and 160019 partially) are reported to have been damaged due to flood so far,house,33,9,56,0,98,"ferozepur, jalandhar, kapurthala, moga"
8/25/08,https://reliefweb.int/node/278295,- 6226 houses (3926-fully and 2300 -partially) and 90 huts have been damaged so far,house,21,4,42,0,67,"amritsar, kapurthala"
8/25/08,https://reliefweb.int/node/278295,- 398881 houses (238880 fully and 160001 partially) are reported to have been damaged due to flood so far,house,21,4,42,0,67,"amritsar, kapurthala"
8/24/08,https://reliefweb.int/node/278337,- 5414 houses and 90 huts have been damaged so far,house,23,11,51,0,85,punjab
8/24/08,https://reliefweb.int/node/278337,- 80540 houses have been damaged,house,23,11,51,0,85,punjab
8/24/08,https://reliefweb.int/node/278337,"- about 2,25,192 houses have been damaged",house,23,11,51,0,85,punjab
8/24/08,https://reliefweb.int/node/278337,- 398866 houses have been damaged due to flood,house,23,11,51,0,85,punjab
8/23/08,https://reliefweb.int/node/278317,- 4620 houses and 90 huts have been damaged so far,house,23,6,48,0,77,kapurthala
8/23/08,https://reliefweb.int/node/278317,- 80540 houses (2982 fully and 77558 partially) have been damaged so far,house,23,6,48,0,77,kapurthala
8/23/08,https://reliefweb.int/node/278317,- 398866 houses (238867 fully and 159999 partially) are reported to have been damaged due to flood so far,house,23,6,48,0,77,kapurthala
8/22/08,https://reliefweb.int/node/278298,- 4620 houses and 90 huts have been damaged so far,house,28,10,52,0,90,kapurthala
8/22/08,https://reliefweb.int/node/278298,- 77837 houses have been damaged so far,house,28,10,52,0,90,kapurthala
8/22/08,https://reliefweb.int/node/278298,- 2156 houses are reported to have been damaged so far,house,28,10,52,0,90,kapurthala
8/22/08,https://reliefweb.int/node/278298,- 398866 houses (238867 fully and 159999 partially) are reported to have been damaged due to flood so far,house,28,10,52,0,90,kapurthala
8/21/08,https://reliefweb.int/node/277239,"the situation is worse in remote areas, where over 2,000 thatched houses and 320 roads have been damaged and over 5,000 hectares of crops destroyed in koraput and jeypore sub-division, orissa",house,16,19,28,1,64,punjab
8/21/08,https://reliefweb.int/node/277239,thousand of families are homeless and have relocated to upland areas,house,16,19,28,1,64,punjab
8/19/08,https://reliefweb.int/node/277180,- 1857 houses (1274-fully and 583-partially) have been damaged so far,house,29,6,63,0,98,"ferozepur, jalandhar, kapurthala, moga"
8/19/08,https://reliefweb.int/node/277180,- 342 houses (38-fully and 304 partially) have been damaged so far,house,29,6,63,0,98,"ferozepur, jalandhar, kapurthala, moga"
8/19/08,https://reliefweb.int/node/277180,- 2589 houses (259 fully and 2330 partially) have been damaged so far,house,29,6,63,0,98,"ferozepur, jalandhar, kapurthala, moga"
8/19/08,https://reliefweb.int/node/277180,- 398454 houses (238570 fully and 159984 partially) are reported to have been damaged due to flood so far,house,29,6,63,0,98,"ferozepur, jalandhar, kapurthala, moga"
8/18/08,https://reliefweb.int/node/277200," about two kilometres of road between nangal and nurpur bedi on the outskirts of punjab have been washed away due to heavy rains, sources said",house,6,2,9,0,17,"ferozepur, gurdaspur, jalandhar, moga"
8/18/08,https://reliefweb.int/node/277023,"- 11 relief camps have been opened in the affected areas - train, road communications, power and water supply have also been affected in ropar, jalandhar, moga, kapurthala, tarantaran & ferozepur districts",house,33,6,50,0,89,"ferozepur, jalandhar, kapurthala, moga"
8/18/08,https://reliefweb.int/node/277023,- 1893 houses are reported to have been damaged due to flood so far,house,33,6,50,0,89,"ferozepur, jalandhar, kapurthala, moga"
8/15/08,https://reliefweb.int/node/277055,- 12 state and 57 panchayat roads are reportedly damaged due to heavy rainfall in the state,house,29,5,41,0,75,punjab
8/15/08,https://reliefweb.int/node/277055,- 1874 houses are reported to have been damaged due to flood so far,house,29,5,41,0,75,punjab
8/14/08,https://reliefweb.int/node/276931,"- 12 state, 57 panchayat roads, 5161 feeders, 477 transformers and 2853 electricity poles in 10469 villages have been damaged",house,33,3,38,0,74,mansa
8/9/08,https://reliefweb.int/node/275899,- 22294 houses have been damaged so far,house,21,3,33,0,57,punjab
8/9/08,https://reliefweb.int/node/275899,- 1874 houses are reported to have been damaged due to flood so far,house,21,3,33,0,57,punjab
8/9/08,https://reliefweb.int/node/275899,- 398401 houses have been damaged due to flood,house,21,3,33,0,57,punjab
6/16/08,https://reliefweb.int/node/270161,a woman drowned and five houses were damaged in doda and reasi districts of jammu and kashmir following heavy rains and flash floods,house,15,16,10,0,41,jalandhar
6/16/08,https://reliefweb.int/node/270161,a woman along with her son died in house collapse last night in jalandhar while three persons were killed and two injured when lightning struck them at a village in bihar's banka district.,house,15,16,10,0,41,jalandhar
6/1/08,https://reliefweb.int/node/270165,"subrahmanyam), 7, race course road, new delhi",house,0,0,1,0,1,punjab
10/2/07,https://reliefweb.int/node/245244,- 590772 (208805 fully & 381967 partially) houses are reported to have been damaged,house,6,3,20,0,29,punjab
8/18/07,https://reliefweb.int/node/240663,about 52 persons were reported to have been washed away and 17 houses destroyed,house,23,16,57,0,96,"roopnagar, sangrur, sas nagar"
8/18/07,https://reliefweb.int/node/240663, - 01 state and 36 panchayat roads were damaged in the state,house,23,16,57,0,96,"roopnagar, sangrur, sas nagar"
8/17/07,https://reliefweb.int/node/240777,about 52 persons are reported to have been washed away and 17 houses destroyed,house,24,11,61,0,96,"roopnagar, sangrur, sas nagar"
8/17/07,https://reliefweb.int/node/240777, - 01 state and 36 panchayat roads continue to be damaged in the state,house,24,11,61,0,96,"roopnagar, sangrur, sas nagar"
7/17/07,https://reliefweb.int/node/244592,- 26 panchayat and 06 state roads which were damaged are under repair,house,5,10,22,0,37,punjab
7/17/07,https://reliefweb.int/node/244592,- 01 landslide has also been reported in kodirathi village in kozikode district due to which the road links to this village has been cut off,house,5,10,22,0,37,punjab